120 1 4 1 1 1 2 3 6 3 5 4 2 5 5 
115 3 5 5 5 2 6 4 1 5 5 4 
105 2 4 2 3 1 4 4 5 5 1 3 4 5 2 
100 6 5 3 2 3 3 4 5 5 2 5 1 
80 3 6 2 4 5 6 3 3 6 5 4 
70 4 4 3 3 6 2 1 5 5 1 2 1 
70 4 5 2 4 6 6 6 3 4 2 
70 4 1 4 5 5 1 4 5 6 3 1 3 3 
70 3 6 2 2 6 2 6 4 1 
65 2 6 6 3 5 4 4 5 1 3 3 5 
65 2 5 5 5 3 6 4 4 5 6 
65 3 2 4 4 4 1 1 6 1 5 5 6 
60 3 5 6 5 6 3 2 1 2 4 
60 2 1 6 5 3 6 2 3 1 4 4 
60 6 6 4 4 4 6 1 6 3 5 
60 4 1 6 4 2 3 3 6 4 4 2 2 
55 6 2 3 1 2 5 5 6 6 
50 6 4 6 5 5 5 4 4 5 
50 5 3 3 6 6 6 4 2 1 6 
50 5 3 4 4 1 1 5 6 3 3 4 5 4 
45 6 2 2 3 5 6 6 2 
35 1 4 3 1 4 1 2 6 3 6 1 2 
25 3 3 1 5 3 3 3 3 4 3 4 4 4 6 4 1 2 
-75 2 2 2 4 5 3 6 
-75 5 5 1 3 5 2 5 
-75 2 2 4 3 2 5 4 
-75 5 3 1 5 5 2 3 
-80 5 2 1 5 5 4 
-80 2 1 1 4 1 1 5 1 
-80 2 2 1 4 4 5 6 
-80 1 4 1 2 5 1 1 1 
-80 1 4 5 2 2 4 2 
-85 3 4 4 6 2 2 5 
-85 6 5 4 4 3 5 5 
-85 6 5 3 2 5 1 
-85 3 2 5 6 5 1 
-85 3 2 4 1 6 2 6 
-85 6 1 4 2 3 1 4 4 
-85 1 1 3 2 5 6 6 
-85 6 4 2 4 3 4 4 5 
-85 2 6 4 3 2 4 1 
-90 6 4 2 1 1 1 2 
-90 1 5 5 3 5 3 1 3 2 
-90 5 2 2 6 1 
-90 5 6 4 4 5 1 
-90 5 4 6 4 1 1 4 
-95 4 6 3 1 1 6 1 
-95 1 6 1 3 4 6 6 
-95 1 6 6 5 3 2 
-95 1 1 2 3 2 1 3 4 2 
-95 3 5 2 2 4 4 3 4 
-95 1 6 6 3 2 2 
-95 6 6 3 4 1 4 2 
-100 3 2 1 5 2 1 5 
-100 2 5 3 4 1 2 5 
-100 4 1 4 6 3 3 1 3 4 3 
-100 2 5 3 1 1 5 5 
-100 1 2 4 3 2 2 6 
-100 2 6 6 4 4 
-100 6 4 3 3 2 4 1 3 5 
-100 3 3 4 3 6 2 5 4 
-100 5 2 1 3 6 3 3 4 
-100 1 6 6 1 4 2 
-100 4 5 4 4 3 3 6 3 4 
-100 1 2 2 3 1 5 4 
-100 2 1 2 1 2 3 5 
-100 5 1 3 1 2 5 2 
-100 4 4 2 1 4 3 2 2 
-100 6 3 3 5 2 1 3 3 
-105 5 5 2 2 6 
-105 4 5 3 6 3 5 6 
-105 4 2 1 2 2 2 
-105 4 1 3 6 5 3 1 1 
-105 5 6 1 3 5 3 1 
-105 1 4 2 5 5 2 
-105 2 2 1 2 4 2 
-105 3 3 6 2 4 5 1 
-105 4 1 1 2 5 1 6 
-105 4 1 1 2 2 1 2 
-105 5 2 2 4 1 5 
-105 2 3 4 2 6 3 5 
-110 3 4 6 5 4 4 5 
-110 1 3 1 5 6 4 5 
-110 1 4 6 1 2 3 1 
-110 2 1 6 3 4 4 2 
-110 3 5 5 1 6 2 
-110 6 6 6 5 
-115 5 2 1 6 2 
-115 6 2 3 3 3 3 4 1 3 6 
-115 5 6 2 1 5 
-115 2 4 1 1 6 5 
-115 3 3 6 1 6 1 2 
-115 4 6 5 1 1 6 
-115 2 6 4 2 2 
-115 1 2 6 5 5 
-115 1 5 6 2 6 
-115 5 1 6 5 2 
-115 2 1 1 6 4 2 
-115 4 1 1 5 6 6 
-120 6 3 6 2 2 
-120 2 4 2 3 4 1 3 5 
-120 5 2 1 1 3 1 3 2 
-125 6 3 3 3 2 5 2 
-125 6 4 6 1 6 
-125 2 6 6 5 
-125 2 2 3 4 1 4 2 
-125 1 4 1 1 1 3 2 5 
-125 3 1 4 5 4 2 5 
-125 4 2 3 1 5 1 5 
-125 2 4 3 4 4 4 4 2 
-125 3 2 5 4 2 6 
-130 3 2 6 3 5 2 
-130 2 6 3 3 2 5 
-130 2 5 5 1 6 
-130 1 3 6 4 3 5 5 
-130 4 1 1 4 4 1 4 6 
-130 1 4 3 2 3 6 6 
-130 4 1 4 2 2 6 
-130 5 2 1 1 4 6 
-135 6 3 5 2 6 
-140 4 4 6 2 6 
-140 4 3 3 4 5 1 4 3 6 
-150 6 1 6 6 
-150 6 4 3 4 4 3 3 6 
-155 6 3 5 3 1 6 
-155 2 3 6 3 1 6 
-160 3 3 3 1 3 6 3 3 4 2 
-165 6 6 3 3 6 
