999999 3 6 1 1 2 1 6 4 5 6 
-85 1 4 6 5 3 2 4 
-85 6 4 4 1 4 3 5 4 
-85 5 5 1 6 4 3 6 
-95 2 3 2 3 5 2 5 
-95 3 6 6 5 4 2 
-100 1 3 3 2 3 6 2 2 
-105 2 3 1 2 3 6 2 
-110 3 6 5 1 2 6 
-110 2 6 1 3 5 6 
-110 6 2 1 3 2 2 
-115 2 5 4 6 5 
-125 3 5 2 3 6 3 5 
-125 3 3 4 2 1 3 6 5 
-140 6 1 1 4 4 6 
-150 4 3 3 6 3 2 6 
