155 1 5 4 4 5 5 5 4 2 4 1 5 3 5 
155 1 2 4 4 4 2 1 5 3 5 5 1 5 5 
140 3 3 5 1 6 5 6 1 4 6 6 1 
85 6 3 1 1 5 5 6 1 3 5 4 1 
80 3 1 2 5 2 3 1 5 2 5 4 2 
65 6 4 4 4 1 2 6 1 6 6 
55 5 3 1 1 4 6 4 6 1 5 2 
-75 4 3 1 2 5 4 5 1 
-75 4 1 5 4 5 4 4 3 5 
-75 1 4 4 5 5 5 3 4 
-80 2 5 5 5 1 1 
-85 1 3 2 4 6 1 1 4 
-85 2 6 5 2 3 2 
-85 2 6 5 3 4 4 1 
-90 5 5 6 1 1 1 
-90 1 4 2 6 2 4 
-90 4 5 4 2 6 1 
-90 5 5 6 2 4 
-90 5 4 5 4 6 5 
-95 6 6 5 3 4 5 
-95 5 1 2 1 3 3 2 1 
-100 5 1 3 1 5 4 1 6 
-100 2 6 6 4 4 
-100 5 1 2 3 2 4 5 
-100 5 3 6 4 3 3 1 4 6 
-100 5 4 3 5 5 4 6 
-100 5 4 6 6 2 
-100 1 2 6 6 2 
-105 4 5 1 5 4 4 2 
-105 4 4 4 1 5 5 6 
-105 2 2 2 1 4 6 
-110 4 6 2 3 2 6 
-110 3 4 5 2 6 5 
-110 6 5 3 2 1 6 
-115 6 4 2 2 5 
-115 5 5 6 4 6 
-115 1 5 3 1 1 5 3 3 5 
-120 5 2 3 3 1 4 4 6 
-125 3 4 4 2 5 4 6 
-125 1 2 3 2 5 6 
-125 1 6 3 1 1 3 3 1 2 
-130 2 4 4 4 5 6 
-130 6 3 1 4 3 5 2 
-135 3 2 5 6 6 
-135 5 3 5 6 6 
-140 1 4 5 6 6 
-155 4 3 5 3 6 6 
-430 3 6 2 3 2 5 
