135 2 1 4 1 2 3 1 6 1 1 1 1 6 3 
130 5 4 5 2 5 6 3 4 4 1 6 3 
85 4 6 1 5 5 5 1 1 4 2 4 
80 2 3 1 4 2 2 4 6 3 4 3 4 4 4 
75 1 1 1 1 2 5 4 5 4 3 5 1 6 
50 6 6 4 5 6 3 4 5 3 2 
50 4 3 6 6 2 5 3 4 6 6 
45 4 1 4 6 5 1 3 6 6 2 
25 3 2 3 4 1 3 4 3 5 5 3 5 1 6 
-75 5 1 3 5 5 4 4 5 
-75 3 1 4 1 1 1 2 2 3 
-75 4 3 5 4 1 1 1 5 1 
-75 5 3 1 4 2 5 1 4 
-75 2 2 1 4 3 1 2 4 
-75 2 1 4 2 1 3 5 4 
-85 6 2 2 4 3 4 3 
-85 1 6 3 5 4 2 2 
-85 1 1 6 3 5 5 2 
-85 6 1 2 4 1 4 3 5 
-85 2 3 2 2 6 2 
-85 3 1 5 1 5 6 1 
-90 6 1 5 1 2 4 
-90 2 1 6 1 2 4 
-90 4 4 6 2 1 1 5 
-90 6 1 2 1 5 2 
-95 5 5 5 3 2 3 5 
-95 5 4 3 6 6 1 
-95 3 4 1 4 6 6 4 
-95 6 2 6 4 3 2 
-95 4 6 3 1 1 6 1 
-95 1 3 3 4 4 3 3 6 1 4 2 
-95 2 1 6 3 6 1 
-95 3 4 4 6 1 6 6 
-100 2 3 1 4 5 2 2 
-100 3 5 1 2 1 5 5 
-100 4 2 4 4 1 3 4 1 6 
-100 6 6 4 2 1 
-100 4 4 2 6 3 3 4 3 4 
-105 1 4 3 4 3 6 2 1 
-105 6 4 5 3 2 3 2 
-105 5 5 5 5 6 
-105 2 1 1 2 1 4 5 
-110 1 5 5 3 6 2 
-110 4 3 6 3 3 1 6 1 
-110 3 4 5 5 6 2 
-110 2 3 6 2 4 5 
-115 1 1 3 5 1 5 3 3 2 
-115 2 6 5 4 5 
-115 4 2 6 5 5 
-115 6 1 2 5 5 
-115 3 1 2 3 3 4 1 2 6 
-115 2 6 5 4 6 
-115 6 4 1 4 2 2 
-115 4 3 2 3 2 1 1 3 6 
-115 3 6 3 6 5 2 
-120 1 3 4 6 6 6 
-120 3 2 4 5 4 3 4 2 
-120 2 3 5 1 3 4 1 6 
-125 3 6 3 2 3 2 2 
-125 2 6 6 5 
-125 6 6 2 5 
-130 1 1 1 2 2 6 
-130 1 1 5 1 5 6 
-130 4 4 6 3 3 1 4 5 
-135 1 3 6 3 6 3 6 
-140 2 1 6 4 6 
-140 4 2 6 1 6 
-140 5 5 6 6 
-140 6 5 2 6 
-145 6 4 3 6 6 
-150 3 3 2 3 4 6 6 
-150 6 1 6 6 
