230 1 5 4 4 5 5 5 4 2 4 1 5 3 4 5 6 
215 1 5 4 4 5 5 5 4 2 4 1 5 3 6 6 
195 1 5 4 4 5 5 5 4 2 4 1 5 5 4 
195 1 5 4 4 5 5 5 4 2 4 1 5 5 3 
195 1 5 4 4 5 5 5 4 2 4 1 5 5 2 
185 1 5 4 4 5 5 5 4 2 4 1 5 3 4 3 3 
175 1 5 4 4 5 5 5 4 2 4 1 5 3 4 6 
175 1 5 4 4 5 5 5 4 2 4 1 5 3 4 6 
150 1 5 4 4 5 5 5 4 2 4 1 5 3 3 
150 1 5 4 4 5 5 5 4 2 4 1 5 3 3 
150 1 5 4 4 5 5 5 4 2 4 1 5 3 3 
150 1 5 4 4 5 5 5 4 2 4 1 5 3 3 
150 1 5 4 4 5 5 5 4 2 4 1 5 3 3 
150 6 3 1 1 5 5 6 1 3 5 6 4 1 
145 1 5 4 4 5 5 5 4 2 4 1 5 4 
145 1 5 4 4 5 5 5 4 2 4 1 5 6 
145 1 5 4 4 5 5 5 4 2 4 1 5 4 
145 1 5 4 4 5 5 5 4 2 4 1 5 6 
145 1 5 4 4 5 5 5 4 2 4 1 5 2 
140 5 5 2 6 5 5 5 3 4 5 1 
125 1 2 4 4 4 2 1 5 3 5 5 1 4 2 
105 5 1 2 1 3 5 6 6 5 4 2 
100 1 5 4 4 5 5 5 4 2 4 1 3 2 
100 1 5 4 4 5 5 5 4 2 4 1 3 1 
95 1 5 4 4 5 5 5 4 2 4 1 2 
95 1 5 4 4 5 5 5 4 2 4 1 1 
95 1 5 4 4 5 5 5 4 2 4 1 2 
95 1 5 4 4 5 5 5 4 2 4 1 1 
95 1 5 4 4 5 5 5 4 2 4 1 6 
85 4 5 4 2 2 1 6 2 5 1 
80 3 1 2 5 2 3 1 5 2 5 4 2 
80 5 3 1 1 4 6 4 6 1 4 5 3 
75 3 3 5 1 6 5 6 1 4 6 2 
65 6 4 4 4 1 2 6 1 6 1 
50 5 4 6 6 5 5 2 5 
50 5 4 3 5 5 4 6 3 1 5 3 2 
-75 4 1 5 4 5 4 4 3 2 
-80 1 4 4 5 5 5 2 
-80 2 5 5 4 5 1 
-85 2 6 5 3 4 1 5 
-85 5 4 5 4 6 3 6 
-85 1 3 2 4 6 1 4 3 
-90 4 3 1 2 5 2 3 3 5 
-100 6 6 5 4 1 
-115 2 6 5 4 5 
-115 1 2 6 5 2 
-115 1 4 2 4 6 2 
-115 5 5 6 1 5 
