160 4 1 4 6 5 1 3 6 1 3 5 5 5 4 
110 2 1 4 2 1 3 5 5 2 1 3 3 5 5 
95 5 4 5 2 5 6 3 4 4 1 4 3 3 
95 2 3 1 4 2 2 4 6 3 4 3 3 6 1 
90 4 6 1 5 5 5 1 1 5 3 1 6 
85 6 1 2 4 1 4 3 6 5 3 2 3 
75 1 3 3 4 4 3 3 6 1 5 1 1 1 6 1 
75 1 1 1 1 2 5 4 5 4 3 5 1 2 
75 3 1 5 1 5 1 2 5 1 3 6 3 2 
50 3 2 3 4 1 3 4 3 5 5 3 5 1 1 5 
35 4 3 6 6 2 5 3 4 2 5 
25 6 6 4 5 6 3 4 3 4 2 
-75 5 1 3 5 5 4 4 1 
-75 5 5 5 3 2 4 4 
-80 1 1 6 3 5 5 3 2 
-85 2 3 2 2 6 2 
-85 6 2 2 4 3 4 6 
-85 6 1 5 3 5 4 4 
-85 3 4 1 4 6 4 4 4 1 
-85 6 1 2 1 5 3 6 
-90 4 4 6 2 1 1 1 
-95 4 3 5 4 1 1 1 4 3 2 
-95 5 4 3 1 1 3 4 2 4 
-95 6 2 6 4 3 1 
-95 4 6 3 1 1 6 1 
-100 2 1 4 1 2 3 1 6 1 1 1 1 3 
-100 2 1 4 1 2 3 1 6 1 1 1 1 1 
-100 2 1 4 1 2 3 1 6 1 1 1 2 
-100 2 1 4 1 2 3 1 6 1 1 1 1 6 1 
-100 2 1 4 1 2 3 1 6 1 1 1 1 6 5 
-100 2 1 4 1 2 3 1 6 1 1 1 6 
-100 2 1 4 1 2 3 1 6 1 1 1 1 4 
-100 2 1 4 1 2 3 1 6 1 1 1 1 6 4 
-100 2 1 4 1 2 3 1 6 1 1 1 1 6 
-100 2 1 4 1 2 3 1 6 1 1 1 1 5 
-100 2 1 4 1 2 3 1 6 1 1 1 1 5 
-100 2 1 4 1 2 3 1 6 1 1 1 2 
-100 2 1 4 1 2 3 1 6 1 1 1 1 6 
-100 2 1 4 1 2 3 1 6 1 1 1 1 6 1 
-100 2 1 4 1 2 3 1 6 1 1 1 1 6 4 
-100 2 1 4 1 2 3 1 6 1 1 1 1 6 
-100 2 1 4 1 2 3 1 6 1 1 1 1 2 
-100 2 1 4 1 2 3 1 6 1 1 1 5 
-100 2 1 4 1 2 3 1 6 1 1 1 1 6 1 
-100 2 1 4 1 2 3 1 6 1 1 1 1 1 
-100 2 1 4 1 2 3 1 6 1 1 1 1 6 5 
-100 2 1 4 1 2 3 1 6 1 1 1 4 
-100 2 1 4 1 2 3 1 6 1 1 1 1 5 
-100 2 1 4 1 2 3 1 6 1 1 1 1 6 3 
-100 5 3 1 4 2 5 2 
-100 6 6 4 2 1 
-100 4 2 4 4 1 3 4 1 2 
-100 2 1 4 1 2 3 1 6 1 1 1 4 
-100 2 1 4 1 2 3 1 6 1 1 1 1 6 3 
-100 2 1 4 1 2 3 1 6 1 1 1 2 
-100 2 1 4 1 2 3 1 6 1 1 1 1 4 
-100 2 1 4 1 2 3 1 6 1 1 1 1 1 
-100 2 1 4 1 2 3 1 6 1 1 1 4 
-100 2 1 4 1 2 3 1 6 1 1 1 2 
-100 2 1 4 1 2 3 1 6 1 1 1 1 6 
-100 2 1 4 1 2 3 1 6 1 1 1 2 
-100 2 1 4 1 2 3 1 6 1 1 1 1 5 
-100 2 1 4 1 2 3 1 6 1 1 1 5 
-100 2 1 4 1 2 3 1 6 1 1 1 1 4 
-100 2 1 4 1 2 3 1 6 1 1 1 4 
-105 4 4 2 6 3 3 4 4 
-110 2 1 6 1 4 3 5 
-110 1 6 3 5 2 2 
-110 3 1 4 1 1 1 6 5 
-115 2 1 6 1 1 6 
-125 2 2 1 4 3 1 6 
-135 3 4 4 6 1 4 6 
