999999 1 3 3 2 3 6 5 5 5 2 3 1 
-85 6 4 4 1 4 3 5 2 
-90 5 5 1 6 4 1 
-95 2 3 2 3 5 5 5 
-95 2 3 1 2 3 2 4 2 
-105 3 6 1 1 2 1 6 4 5 
-105 3 6 1 1 2 1 6 
-105 3 6 1 1 2 1 6 
-105 3 6 1 1 2 1 6 
-105 3 6 1 1 2 1 6 4 5 
-105 3 6 1 1 2 1 6 4 5 
-105 3 6 1 1 2 1 6 
-105 3 6 1 1 2 1 6 
-105 3 6 1 1 2 1 6 
-130 1 4 6 5 3 3 2 
-140 3 6 6 3 4 2 
