90 5 6 6 3 6 6 4 5 1 
-60 5 6 5 2 3 4 5 
-180 5 3 6 3 5 
-180 5 5 4 1 
-185 6 2 4 6 
-190 5 6 2 
-200 2 2 5 5 6 1 1 4 4 1 
-200 2 2 5 5 6 1 1 4 4 1 
-200 2 2 5 5 6 1 1 4 
-200 2 2 5 5 6 1 1 4 4 1 
-200 2 2 5 5 6 1 1 4 
-200 2 2 5 5 6 1 1 4 4 
-200 2 2 5 5 6 1 1 4 
-200 2 2 5 5 6 1 1 4 
-200 2 2 5 5 6 1 1 4 
-200 2 2 5 5 6 1 1 4 
-200 2 2 5 5 6 1 1 4 4 
-200 2 2 5 5 6 1 1 4 4 
-200 1 3 1 5 1 
-200 4 4 2 4 3 
-200 2 2 5 5 6 1 1 4 4 
-210 4 6 5 1 4 
-220 3 5 1 5 
-225 3 4 5 2 
