255 1 5 4 4 5 5 5 4 2 4 1 5 3 4 5 4 5 
250 1 5 4 4 5 5 5 4 2 4 1 5 3 4 6 3 1 
240 1 5 4 4 5 5 5 4 2 4 1 5 3 4 6 2 
240 1 5 4 4 5 5 5 4 2 4 1 5 3 4 6 4 
240 1 5 4 4 5 5 5 4 2 4 1 5 3 4 6 2 
240 1 5 4 4 5 5 5 4 2 4 1 5 3 4 6 2 
240 1 5 4 4 5 5 5 4 2 4 1 5 3 4 6 5 
240 1 5 4 4 5 5 5 4 2 4 1 5 3 4 6 1 
225 1 5 4 4 5 5 5 4 2 4 1 5 3 4 5 6 
225 1 5 4 4 5 5 5 4 2 4 1 5 3 4 5 2 
225 1 5 4 4 5 5 5 4 2 4 1 5 3 4 5 3 
225 1 5 4 4 5 5 5 4 2 4 1 5 3 4 5 2 
225 1 5 4 4 5 5 5 4 2 4 3 5 5 5 6 
215 1 5 4 4 5 5 5 4 2 4 1 5 3 6 6 
215 1 5 4 4 5 5 5 4 2 4 1 5 3 6 5 
215 1 5 4 4 5 5 5 4 2 4 1 5 3 6 2 
215 1 5 4 4 5 5 5 4 2 4 1 5 3 6 2 
215 5 5 2 6 5 5 5 3 4 5 4 5 6 
195 1 5 4 4 5 5 5 4 2 4 1 5 5 3 
180 1 5 4 4 5 5 5 4 2 4 1 5 3 4 3 3 
175 1 5 4 4 5 5 5 4 2 4 1 5 3 4 4 
175 1 5 4 4 5 5 5 4 2 4 1 5 3 4 2 
175 1 5 4 4 5 5 5 4 2 4 1 5 3 4 1 
175 1 5 4 4 5 5 5 4 2 4 1 5 3 4 2 
175 1 5 4 4 5 5 5 4 2 4 1 5 3 4 1 
150 1 5 4 4 5 5 5 4 2 4 1 5 3 5 
150 1 5 4 4 5 5 5 4 2 4 1 5 3 1 
150 1 5 4 4 5 5 5 4 2 4 1 5 3 2 
150 1 5 4 4 5 5 5 4 2 4 1 5 3 5 
135 6 3 1 1 5 5 6 1 3 5 1 5 3 
105 1 5 4 4 5 5 5 4 2 4 1 3 3 3 
100 1 5 4 4 5 5 5 4 2 4 1 3 1 
100 1 5 4 4 5 5 5 4 2 4 1 3 1 
100 1 5 4 4 5 5 5 4 2 4 1 3 1 
95 1 5 4 4 5 5 5 4 2 4 1 6 
-75 1 2 4 4 4 2 1 5 3 5 5 1 4 
-95 5 1 2 1 3 5 6 6 5 
-150 1 5 4 4 5 5 5 4 2 4 1 5 3 4 
-150 1 5 4 4 5 5 5 4 2 4 1 5 3 4 
-150 1 5 4 4 5 5 5 4 2 4 1 5 3 4 
-150 1 5 4 4 5 5 5 4 2 4 1 5 3 4 
-225 1 5 4 4 5 5 5 4 2 4 1 5 
-225 1 5 4 4 5 5 5 4 2 4 1 5 
-225 1 5 4 4 5 5 5 4 2 4 1 5 
-230 1 5 4 4 5 5 5 4 2 4 1 
-280 1 5 4 4 5 5 5 4 2 4 
-280 1 5 4 4 5 5 5 4 2 4 
-305 1 5 4 4 5 5 5 4 2 
