220 2 1 4 2 1 3 5 5 2 1 3 5 5 6 2 
205 1 1 1 1 2 5 4 5 4 3 5 1 6 6 6 
105 5 4 3 1 1 3 4 2 5 1 4 1 4 2 1 
90 6 1 5 3 3 5 6 6 6 6 
75 3 2 3 4 1 3 4 3 5 5 3 5 1 4 4 4 
70 1 3 3 4 4 3 3 6 1 5 1 1 1 6 2 
55 6 6 4 5 6 3 4 3 3 2 6 
-75 3 1 5 1 5 1 2 5 1 3 6 1 
-75 2 3 1 4 2 2 4 6 3 4 3 3 6 5 
-75 5 5 5 3 2 4 5 
-75 4 3 5 4 1 1 1 2 3 
-80 5 4 5 2 5 6 3 4 4 1 4 3 2 
-85 4 1 4 6 5 1 3 6 1 3 5 5 6 
-85 4 1 4 6 5 1 3 6 1 3 5 2 
-85 4 1 4 6 5 1 3 6 1 3 5 5 5 3 
-85 4 1 4 6 5 1 3 6 1 3 5 1 
-85 4 1 4 6 5 1 3 6 1 3 5 1 
-85 4 1 4 6 5 1 3 6 1 3 5 1 
-85 4 1 4 6 5 1 3 6 1 3 5 5 5 
-85 4 1 4 6 5 1 3 6 1 3 5 6 
-85 6 1 2 4 1 4 3 6 5 6 
-90 4 6 1 5 5 5 1 1 5 3 1 
-90 6 1 2 1 5 1 
-95 4 3 6 6 2 5 3 4 3 
-105 3 4 1 4 6 4 1 3 1 
-120 4 6 3 1 6 5 
-120 4 2 4 4 1 3 4 3 6 
-130 1 1 6 3 5 3 2 
-135 2 3 2 6 6 
-145 6 6 4 3 6 
-450 5 1 3 5 5 4 
-460 4 1 4 6 5 1 3 6 1 3 
-460 4 1 4 6 5 1 3 6 1 3 5 
-460 4 1 4 6 5 1 3 6 1 3 5 5 
-460 4 1 4 6 5 1 3 6 1 3 5 
-460 4 1 4 6 5 1 3 6 1 3 5 
-460 4 1 4 6 5 1 3 6 1 3 5 5 
-460 4 1 4 6 5 1 3 6 1 3 
-460 4 1 4 6 5 1 3 6 1 3 
-460 4 1 4 6 5 1 3 6 1 3 
-460 4 1 4 6 5 1 3 6 1 3 
-460 4 1 4 6 5 1 3 6 1 3 5 5 
-460 4 1 4 6 5 1 3 6 1 3 5 
-460 4 1 4 6 5 1 3 6 1 3 5 5 
-460 4 1 4 6 5 1 3 6 1 3 
-460 4 1 4 6 5 1 3 6 1 3 5 5 
-460 4 1 4 6 5 1 3 6 1 3 5 5 
-460 4 1 4 6 5 1 3 6 1 3 5 
-460 6 2 2 4 3 
-460 4 1 4 6 5 1 3 6 1 3 5 5 
-460 4 1 4 6 5 1 3 6 1 3 5 
-460 4 1 4 6 5 1 3 6 1 3 5 
-460 4 1 4 6 5 1 3 6 1 3 
-460 4 1 4 6 5 1 3 6 1 3 5 
-460 4 1 4 6 5 1 3 6 1 3 5 5 
-460 4 1 4 6 5 1 3 6 1 3 
-460 4 1 4 6 5 1 3 6 1 3 
-460 4 1 4 6 5 1 3 6 1 3 5 5 
-460 4 1 4 6 5 1 3 6 1 3 5 5 
-460 4 1 4 6 5 1 3 6 1 3 5 
-460 4 1 4 6 5 1 3 6 1 3 5 5 
-475 6 2 6 
-475 2 1 4 1 2 3 1 6 1 1 1 
-475 2 1 4 1 2 3 1 6 1 
-475 2 1 4 1 2 3 1 6 1 1 1 
-475 2 1 4 1 2 3 1 6 1 1 1 
-475 5 3 1 4 2 
-475 2 1 4 1 2 3 1 6 1 1 
-475 2 1 4 1 2 3 1 6 1 1 1 
-475 2 1 4 1 2 3 1 6 
-475 2 1 4 1 2 3 1 6 1 1 1 
-490 4 4 6 2 
