315 1 5 4 4 5 5 5 4 2 4 1 5 3 4 3 6 6 6 
240 1 5 4 4 5 5 5 4 2 4 3 5 5 6 4 
230 1 5 4 4 5 5 5 4 2 4 1 5 3 4 5 4 
230 1 5 4 4 5 5 5 4 2 4 1 5 3 4 5 4 
230 1 5 4 4 5 5 5 4 2 4 1 5 3 4 5 4 
230 1 5 4 4 5 5 5 4 2 4 1 5 3 4 5 4 
230 1 5 4 4 5 5 5 4 2 4 1 5 3 4 5 4 
230 1 5 4 4 5 5 5 4 2 4 1 5 3 4 5 4 
230 1 5 4 4 5 5 5 4 2 4 1 5 3 4 5 4 
230 1 5 4 4 5 5 5 4 2 4 1 5 3 4 5 3 1 
230 1 5 4 4 5 5 5 4 2 4 1 5 3 4 5 4 
225 1 5 4 4 5 5 5 4 2 4 1 5 3 4 5 1 
225 1 5 4 4 5 5 5 4 2 4 1 5 3 4 5 2 
225 1 5 4 4 5 5 5 4 2 4 1 5 3 4 5 1 
225 1 5 4 4 5 5 5 4 2 4 1 5 3 4 5 1 
225 1 5 4 4 5 5 5 4 2 4 1 5 3 4 5 1 
225 1 5 4 4 5 5 5 4 2 4 1 5 3 4 5 5 
225 1 5 4 4 5 5 5 4 2 4 1 5 3 4 5 1 
225 1 5 4 4 5 5 5 4 2 4 1 5 3 4 5 1 
225 1 5 4 4 5 5 5 4 2 4 1 5 3 4 5 6 
225 1 5 4 4 5 5 5 4 2 4 1 5 3 4 5 5 
225 1 5 4 4 5 5 5 4 2 4 1 5 3 4 5 6 
215 1 5 4 4 5 5 5 4 2 4 1 5 3 6 4 
215 1 5 4 4 5 5 5 4 2 4 1 5 3 6 2 
215 1 5 4 4 5 5 5 4 2 4 1 5 3 6 5 
215 1 5 4 4 5 5 5 4 2 4 1 5 3 6 2 
195 1 5 4 4 5 5 5 4 2 4 1 5 5 1 
180 1 5 4 4 5 5 5 4 2 4 1 5 3 4 6 
180 1 5 4 4 5 5 5 4 2 4 1 5 3 4 3 2 
175 1 5 4 4 5 5 5 4 2 4 1 5 3 4 1 
175 1 5 4 4 5 5 5 4 2 4 1 5 3 4 2 
175 1 5 4 4 5 5 5 4 2 4 1 5 3 4 1 
175 1 5 4 4 5 5 5 4 2 4 1 5 3 4 2 
175 1 5 4 4 5 5 5 4 2 4 1 5 3 4 1 
175 1 5 4 4 5 5 5 4 2 4 1 5 3 4 6 
175 1 5 4 4 5 5 5 4 2 4 1 5 3 4 1 
175 1 5 4 4 5 5 5 4 2 4 1 5 3 4 6 
175 1 5 4 4 5 5 5 4 2 4 1 5 3 4 4 
165 5 5 2 6 5 5 5 3 4 5 4 1 
150 1 5 4 4 5 5 5 4 2 4 1 5 3 2 
150 1 5 4 4 5 5 5 4 2 4 1 5 3 3 
150 1 5 4 4 5 5 5 4 2 4 1 5 3 2 
-150 1 5 4 4 5 5 5 4 2 4 1 5 3 4 
-200 1 5 4 4 5 5 5 4 2 4 1 5 3 
-225 1 5 4 4 5 5 5 4 2 4 1 5 
-225 1 5 4 4 5 5 5 4 2 4 1 5 
-225 1 5 4 4 5 5 5 4 2 4 1 5 
-230 1 5 4 4 5 5 5 4 2 4 1 
