305 2 1 4 2 1 3 5 5 2 1 3 5 5 4 3 6 2 2 
260 2 1 4 2 1 3 5 5 2 1 3 5 5 4 3 3 6 2 
225 2 1 4 2 1 3 5 5 2 1 3 5 5 6 3 6 
225 2 1 4 2 1 3 5 5 2 1 3 5 5 6 3 2 
220 2 1 4 2 1 3 5 5 2 1 3 5 5 6 2 
220 2 1 4 2 1 3 5 5 2 1 3 5 5 6 2 
220 2 1 4 2 1 3 5 5 2 1 3 5 5 6 1 
220 2 1 4 2 1 3 5 5 2 1 3 5 5 6 4 
220 2 1 4 2 1 3 5 5 2 1 3 5 5 6 2 
220 2 1 4 2 1 3 5 5 2 1 3 5 5 6 6 
220 2 1 4 2 1 3 5 5 2 1 3 5 5 6 6 
220 2 1 4 2 1 3 5 5 2 1 3 5 5 6 5 
220 2 1 4 2 1 3 5 5 2 1 3 5 5 6 1 
220 2 1 4 2 1 3 5 5 2 1 3 5 5 6 6 
220 2 1 4 2 1 3 5 5 2 1 3 5 5 6 6 
180 2 1 4 2 1 3 5 5 2 1 3 5 5 4 4 
175 2 1 4 2 1 3 5 5 2 1 3 5 3 6 4 
155 2 1 4 2 1 3 5 5 2 1 3 5 4 1 3 
155 2 1 4 2 1 3 5 5 2 1 3 5 5 1 
155 2 1 4 2 1 3 5 5 2 1 3 5 5 3 
155 2 1 4 2 1 3 5 5 2 1 3 5 5 5 
155 2 1 4 2 1 3 5 5 2 1 3 5 5 2 
155 2 1 4 2 1 3 5 5 2 1 3 5 5 3 
140 1 1 1 1 2 5 4 5 4 3 5 1 6 1 
140 6 6 4 5 6 3 4 3 4 2 6 4 
135 2 1 4 2 1 3 5 5 2 1 3 5 4 3 2 
110 2 1 4 2 1 3 5 5 2 1 3 5 3 5 
110 2 1 4 2 1 3 5 5 2 1 3 5 3 2 
105 2 1 4 2 1 3 5 5 2 1 3 5 6 
105 2 1 4 2 1 3 5 5 2 1 3 5 2 
105 2 1 4 2 1 3 5 5 2 1 3 5 6 
105 2 1 4 2 1 3 5 5 2 1 3 5 6 
105 2 1 4 2 1 3 5 5 2 1 3 5 2 
105 2 1 4 2 1 3 5 5 2 1 3 5 6 
105 2 1 4 2 1 3 5 5 2 1 3 5 6 
105 2 1 4 2 1 3 5 5 2 1 3 5 2 
105 2 1 4 2 1 3 5 5 2 1 3 5 1 
105 2 1 4 2 1 3 5 5 2 1 3 5 6 
105 2 1 4 2 1 3 5 5 2 1 3 5 2 
90 6 1 5 3 3 5 6 6 6 4 
80 5 1 3 4 6 4 6 5 4 2 6 
55 5 4 3 1 1 3 4 2 5 1 4 1 4 2 6 
45 3 2 3 4 1 3 4 3 5 5 3 5 1 4 2 
-85 4 1 4 6 5 1 3 6 1 3 1 
-85 4 1 4 6 5 1 3 6 1 3 5 1 
-85 4 1 4 6 5 1 3 6 1 6 
-85 4 1 4 6 5 1 3 6 1 5 
-95 4 6 3 6 2 3 
-100 6 2 1 6 2 
-100 6 6 4 5 1 
-105 3 4 1 4 6 4 3 1 4 
-125 4 3 5 4 1 1 1 6 
-125 4 2 4 4 1 3 4 6 
-130 2 3 4 1 3 6 5 
-135 1 1 6 3 1 4 6 
-305 1 3 3 4 4 3 3 6 1 5 1 1 1 
-450 3 1 5 1 5 1 2 5 1 3 
-450 2 3 1 4 2 2 4 6 3 4 3 3 
-450 5 5 5 3 2 
-455 5 4 5 2 5 6 3 4 4 1 
-460 4 1 4 6 5 1 3 6 1 
-460 4 1 4 6 5 1 3 6 1 
-460 6 1 2 4 1 4 3 
-460 4 1 4 6 5 1 3 6 1 3 
-460 4 1 4 6 5 1 3 6 
-460 4 1 4 6 5 1 3 6 1 3 5 
-460 4 1 4 6 5 1 3 6 1 3 
-460 4 1 4 6 5 1 3 6 1 3 
-460 4 1 4 6 5 1 3 6 
-465 6 1 2 1 
-465 4 6 1 5 5 5 1 
-470 4 3 6 6 2 
