435 1 5 4 4 5 5 5 4 2 4 1 5 3 4 3 6 2 6 3 6 1 
365 1 5 4 4 5 5 5 4 2 4 1 5 3 4 3 6 2 6 3 5 
360 1 5 4 4 5 5 5 4 2 4 1 5 3 4 3 6 6 5 5 
360 1 5 4 4 5 5 5 4 2 4 1 5 3 4 3 6 2 6 2 
315 1 5 4 4 5 5 5 4 2 4 1 5 3 4 3 6 6 3 3 
310 1 5 4 4 5 5 5 4 2 4 1 5 3 4 3 6 6 2 
310 1 5 4 4 5 5 5 4 2 4 1 5 3 4 3 6 6 6 
310 1 5 4 4 5 5 5 4 2 4 1 5 3 4 3 6 6 4 
305 1 5 4 4 5 5 5 4 2 4 1 5 3 4 5 3 4 2 2 
300 1 5 4 4 5 5 5 4 2 4 1 5 3 4 3 6 2 3 2 
295 1 5 4 4 5 5 5 4 2 4 1 5 3 4 3 6 5 2 
295 1 5 4 4 5 5 5 4 2 4 1 5 3 4 3 6 5 2 
245 1 5 4 4 5 5 5 4 2 4 1 5 3 4 3 6 1 
245 1 5 4 4 5 5 5 4 2 4 1 5 3 4 3 6 1 
245 1 5 4 4 5 5 5 4 2 4 1 5 3 4 3 6 1 
230 1 5 4 4 5 5 5 4 2 4 1 5 3 4 5 3 1 
230 1 5 4 4 5 5 5 4 2 4 1 5 3 4 3 5 3 
230 1 5 4 4 5 5 5 4 2 4 1 5 3 4 5 3 5 
230 1 5 4 4 5 5 5 4 2 4 1 5 3 4 3 5 6 
225 1 5 4 4 5 5 5 4 2 4 1 5 3 4 5 4 
225 1 5 4 4 5 5 5 4 2 4 1 5 3 4 5 2 
225 1 5 4 4 5 5 5 4 2 4 1 5 3 4 5 4 
225 1 5 4 4 5 5 5 4 2 4 1 5 3 4 5 1 
225 1 5 4 4 5 5 5 4 2 4 1 5 3 4 5 4 
215 1 5 4 4 5 5 5 4 2 4 1 5 3 6 1 
195 1 5 4 4 5 5 5 4 2 4 1 5 5 1 
185 1 5 4 4 5 5 5 4 2 4 1 5 3 4 3 3 3 
180 1 5 4 4 5 5 5 4 2 4 1 5 3 4 3 2 
180 1 5 4 4 5 5 5 4 2 4 1 5 3 4 3 4 
175 1 5 4 4 5 5 5 4 2 4 1 5 3 4 1 
175 1 5 4 4 5 5 5 4 2 4 1 5 3 4 4 
175 1 5 4 4 5 5 5 4 2 4 1 5 3 4 1 
150 1 5 4 4 5 5 5 4 2 4 1 5 3 1 
150 1 5 4 4 5 5 5 4 2 4 1 5 3 2 
150 1 5 4 4 5 5 5 4 2 4 1 5 3 2 
80 1 5 4 4 5 5 5 4 2 4 3 5 
-65 1 5 4 4 5 5 5 4 2 4 1 5 3 4 3 6 
-65 1 5 4 4 5 5 5 4 2 4 1 5 3 4 3 6 
-65 1 5 4 4 5 5 5 4 2 4 1 5 3 4 3 6 
-65 1 5 4 4 5 5 5 4 2 4 1 5 3 4 3 6 
-150 1 5 4 4 5 5 5 4 2 4 1 5 3 4 
-195 1 5 4 4 5 5 5 4 2 4 1 5 3 4 
-195 1 5 4 4 5 5 5 4 2 4 1 5 3 4 
-195 1 5 4 4 5 5 5 4 2 4 1 5 3 4 
-200 1 5 4 4 5 5 5 4 2 4 1 5 3 
-225 1 5 4 4 5 5 5 4 2 4 1 5 
-225 1 5 4 4 5 5 5 4 2 4 1 5 
-225 1 5 4 4 5 5 5 4 2 4 1 5 
