375 2 1 4 2 1 3 5 5 2 1 3 5 5 4 3 6 2 3 6 2 
375 2 1 4 2 1 3 5 5 2 1 3 5 5 4 3 6 2 6 3 4 
365 2 1 4 2 1 3 5 5 2 1 3 5 5 4 3 6 2 6 4 
365 2 1 4 2 1 3 5 5 2 1 3 5 5 4 3 6 2 6 6 
365 2 1 4 2 1 3 5 5 2 1 3 5 5 4 3 6 2 6 6 
365 2 1 4 2 1 3 5 5 2 1 3 5 5 4 3 6 2 6 4 
365 2 1 4 2 1 3 5 5 2 1 3 5 5 4 3 6 2 6 2 
325 2 1 4 2 1 3 5 5 2 1 3 5 5 4 3 6 2 1 3 
325 2 1 4 2 1 3 5 5 2 1 3 5 5 4 3 6 2 1 1 
325 2 1 4 2 1 3 5 5 2 1 3 5 5 4 3 6 2 1 1 
325 2 1 4 2 1 3 5 5 2 1 3 5 5 4 3 6 2 1 3 
325 2 1 4 2 1 3 5 5 2 1 3 5 5 4 3 6 5 1 6 
325 2 1 4 2 1 3 5 5 2 1 3 5 5 4 3 6 2 4 6 
315 2 1 4 2 1 3 5 5 2 1 3 5 5 4 3 6 6 2 
315 2 1 4 2 1 3 5 5 2 1 3 5 5 4 3 6 6 1 
305 2 1 4 2 1 3 5 5 2 1 3 5 5 4 3 6 2 3 1 
300 2 1 4 2 1 3 5 5 2 1 3 5 5 4 3 6 2 5 
300 2 1 4 2 1 3 5 5 2 1 3 5 5 4 3 6 2 2 
300 2 1 4 2 1 3 5 5 2 1 3 5 5 4 3 6 2 2 
300 2 1 4 2 1 3 5 5 2 1 3 5 5 4 3 6 2 2 
300 2 1 4 2 1 3 5 5 2 1 3 5 5 4 3 6 2 5 
300 2 1 4 2 1 3 5 5 2 1 3 5 5 4 3 6 2 2 
250 2 1 4 2 1 3 5 5 2 1 3 5 5 4 3 6 1 
250 2 1 4 2 1 3 5 5 2 1 3 5 5 4 3 6 1 
250 2 1 4 2 1 3 5 5 2 1 3 5 5 4 3 6 3 
250 2 1 4 2 1 3 5 5 2 1 3 5 5 6 3 4 3 
245 2 1 4 2 1 3 5 5 2 1 3 5 5 6 4 5 
245 2 1 4 2 1 3 5 5 2 1 3 5 5 6 4 1 
235 2 1 4 2 1 3 5 5 2 1 3 5 5 4 3 5 1 
230 2 1 4 2 1 3 5 5 2 1 3 5 4 5 5 2 
225 2 1 4 2 1 3 5 5 2 1 3 5 5 6 3 5 
220 2 1 4 2 1 3 5 5 2 1 3 5 5 6 1 
220 2 1 4 2 1 3 5 5 2 1 3 5 5 6 1 
220 2 1 4 2 1 3 5 5 2 1 3 5 5 6 5 
220 2 1 4 2 1 3 5 5 2 1 3 5 5 6 5 
190 2 1 4 2 1 3 5 5 2 1 3 5 4 3 5 3 5 
185 2 1 4 2 1 3 5 5 2 1 3 5 5 4 3 3 
185 2 1 4 2 1 3 5 5 2 1 3 5 5 4 3 3 
185 2 1 4 2 1 3 5 5 2 1 3 5 5 4 3 2 
185 2 1 4 2 1 3 5 5 2 1 3 5 5 4 3 4 
185 2 1 4 2 1 3 5 5 2 1 3 5 5 4 3 4 
185 2 1 4 2 1 3 5 5 2 1 3 5 5 4 3 4 
185 2 1 4 2 1 3 5 5 2 1 3 5 5 4 3 2 
185 2 1 4 2 1 3 5 5 2 1 3 5 5 4 3 2 
185 2 1 4 2 1 3 5 5 2 1 3 5 5 4 3 2 
185 2 1 4 2 1 3 5 5 2 1 3 5 4 3 5 2 
165 1 1 1 1 2 5 4 5 4 3 5 1 6 4 4 
155 2 1 4 2 1 3 5 5 2 1 3 5 5 1 
155 2 1 4 2 1 3 5 5 2 1 3 5 5 1 
155 2 1 4 2 1 3 5 5 2 1 3 5 5 2 
155 2 1 4 2 1 3 5 5 2 1 3 5 5 1 
155 2 1 4 2 1 3 5 5 2 1 3 2 5 2 
155 2 1 4 2 1 3 5 5 2 1 3 5 5 1 
145 2 1 4 2 1 3 5 5 2 1 3 1 6 3 
140 6 6 4 5 6 3 4 3 4 2 6 2 
105 2 1 4 2 1 3 5 5 2 1 3 5 2 
105 2 1 4 2 1 3 5 5 2 1 3 5 2 
105 2 1 4 2 1 3 5 5 2 1 3 5 2 
105 2 1 4 2 1 3 5 5 2 1 3 5 2 
105 2 1 4 2 1 3 5 5 2 1 3 5 6 
105 2 1 4 2 1 3 5 5 2 1 3 5 1 
105 2 1 4 2 1 3 5 5 2 1 3 5 2 
105 2 1 4 2 1 3 5 5 2 1 3 5 1 
105 2 1 4 2 1 3 5 5 2 1 3 5 6 
100 2 1 4 2 1 3 5 5 2 1 5 4 
100 2 1 4 2 1 3 5 5 2 1 5 2 
75 2 1 4 2 1 3 5 5 2 1 4 5 
55 2 1 4 2 1 3 5 5 2 1 3 6 
55 2 1 4 2 1 3 5 5 2 1 3 6 
-75 2 1 4 2 1 3 5 5 2 1 3 5 5 4 3 6 
-125 2 1 4 2 1 3 5 5 2 1 3 5 5 4 3 
-190 2 1 4 2 1 3 5 5 2 1 3 5 5 4 
