575 1 5 4 4 5 5 5 4 2 4 1 5 3 4 3 6 2 6 3 6 5 1 6 2 
495 1 5 4 4 5 5 5 4 2 4 1 5 3 4 3 6 2 6 3 6 6 3 
485 1 5 4 4 5 5 5 4 2 4 1 5 3 4 3 6 2 6 3 6 3 5 3 
480 1 5 4 4 5 5 5 4 2 4 1 5 3 4 3 6 2 6 3 6 5 2 
435 1 5 4 4 5 5 5 4 2 4 1 5 3 4 3 6 2 6 3 6 3 3 
435 1 5 4 4 5 5 5 4 2 4 1 5 3 4 3 6 2 6 3 6 3 3 
435 1 5 4 4 5 5 5 4 2 4 1 5 3 4 3 6 2 6 3 6 3 3 
435 1 5 4 4 5 5 5 4 2 4 1 5 3 4 3 6 2 6 3 6 3 3 
430 1 5 4 4 5 5 5 4 2 4 1 5 3 4 3 6 2 6 3 6 4 
370 1 5 4 4 5 5 5 4 2 4 1 5 3 4 3 6 2 6 3 3 6 
365 1 5 4 4 5 5 5 4 2 4 1 5 3 4 3 6 2 6 3 4 
365 1 5 4 4 5 5 5 4 2 4 1 5 3 4 3 6 2 6 3 5 
365 1 5 4 4 5 5 5 4 2 4 1 5 3 4 3 6 2 6 3 5 
365 1 5 4 4 5 5 5 4 2 4 1 5 3 4 3 6 2 6 3 2 
365 1 5 4 4 5 5 5 4 2 4 1 5 3 4 3 6 2 6 3 4 
360 1 5 4 4 5 5 5 4 2 4 1 5 3 4 3 6 2 6 4 
360 1 5 4 4 5 5 5 4 2 4 1 5 3 4 3 6 2 6 2 
360 1 5 4 4 5 5 5 4 2 4 1 5 3 4 3 6 2 6 6 
360 1 5 4 4 5 5 5 4 2 4 1 5 3 4 3 6 2 6 1 
360 1 5 4 4 5 5 5 4 2 4 1 5 3 4 3 6 2 6 5 
360 1 5 4 4 5 5 5 4 2 4 1 5 3 4 3 6 2 6 4 
360 1 5 4 4 5 5 5 4 2 4 1 5 3 4 3 6 2 6 5 
360 1 5 4 4 5 5 5 4 2 4 1 5 3 4 3 6 2 6 1 
360 1 5 4 4 5 5 5 4 2 4 1 5 3 4 3 6 2 6 2 
325 1 5 4 4 5 5 5 4 2 4 1 5 3 4 3 6 2 3 4 3 
310 1 5 4 4 5 5 5 4 2 4 1 5 3 4 3 6 6 4 
310 1 5 4 4 5 5 5 4 2 4 1 5 3 4 3 6 6 1 
310 1 5 4 4 5 5 5 4 2 4 1 5 3 4 5 3 4 5 3 2 
310 1 5 4 4 5 5 5 4 2 4 1 5 3 4 3 6 6 4 
295 1 5 4 4 5 5 5 4 2 4 1 5 3 4 3 6 2 2 
250 1 5 4 4 5 5 5 4 2 4 1 5 3 4 3 6 3 6 
250 1 5 4 4 5 5 5 4 2 4 1 5 3 4 3 6 3 1 
230 1 5 4 4 5 5 5 4 2 4 1 5 3 4 3 5 2 
225 1 5 4 4 5 5 5 4 2 4 1 5 3 4 5 5 
225 1 5 4 4 5 5 5 4 2 4 1 5 3 4 5 1 
225 1 5 4 4 5 5 5 4 2 4 1 5 3 4 5 6 
225 1 5 4 4 5 5 5 4 2 4 1 5 3 4 5 1 
185 1 5 4 4 5 5 5 4 2 4 1 5 3 4 3 3 1 
180 1 5 4 4 5 5 5 4 2 4 1 5 3 4 3 2 
175 1 5 4 4 5 5 5 4 2 4 1 5 3 4 1 
175 1 5 4 4 5 5 5 4 2 4 1 5 3 4 2 
175 1 5 4 4 5 5 5 4 2 4 1 5 3 4 4 
150 1 5 4 4 5 5 5 4 2 4 1 5 3 5 
-10 1 5 4 4 5 5 5 4 2 4 1 5 3 4 3 6 2 6 
-15 1 5 4 4 5 5 5 4 2 4 1 5 3 4 3 6 2 
-200 1 5 4 4 5 5 5 4 2 4 1 5 3 
-200 1 5 4 4 5 5 5 4 2 4 1 5 3 
-200 1 5 4 4 5 5 5 4 2 4 1 5 3 
