570 2 1 4 2 1 3 5 5 2 1 3 5 5 4 3 6 2 3 6 6 3 5 4 1 1 2 
565 2 1 4 2 1 3 5 5 2 1 3 5 5 4 3 6 2 3 6 3 2 6 1 2 1 
565 2 1 4 2 1 3 5 5 2 1 3 5 5 4 3 6 2 3 6 3 6 5 1 5 2 
375 2 1 4 2 1 3 5 5 2 1 3 5 5 4 3 6 2 3 6 3 3 
370 2 1 4 2 1 3 5 5 2 1 3 5 5 4 3 6 2 3 6 4 
370 2 1 4 2 1 3 5 5 2 1 3 5 5 4 3 6 2 3 6 5 
370 2 1 4 2 1 3 5 5 2 1 3 5 5 4 3 6 2 3 6 1 
370 2 1 4 2 1 3 5 5 2 1 3 5 5 4 3 6 2 3 6 4 
370 2 1 4 2 1 3 5 5 2 1 3 5 5 4 3 6 2 3 6 1 
370 2 1 4 2 1 3 5 5 2 1 3 5 5 4 3 6 2 3 6 1 
370 2 1 4 2 1 3 5 5 2 1 3 5 5 4 3 6 2 3 6 5 
370 2 1 4 2 1 3 5 5 2 1 3 5 5 4 3 6 2 3 6 4 
370 2 1 4 2 1 3 5 5 2 1 3 5 5 4 3 6 2 3 6 4 
370 2 1 4 2 1 3 5 5 2 1 3 5 5 4 3 6 2 6 3 2 
370 2 1 4 2 1 3 5 5 2 1 3 5 5 4 3 6 2 3 6 1 
370 2 1 4 2 1 3 5 5 2 1 3 5 5 4 3 6 2 3 6 2 
365 2 1 4 2 1 3 5 5 2 1 3 5 5 4 3 6 2 6 1 
365 2 1 4 2 1 3 5 5 2 1 3 5 5 4 3 6 2 6 5 
365 2 1 4 2 1 3 5 5 2 1 3 5 5 4 3 6 2 6 6 
365 2 1 4 2 1 3 5 5 2 1 3 5 5 4 3 6 2 6 1 
365 2 1 4 2 1 3 5 5 2 1 3 5 5 4 3 6 2 6 1 
365 2 1 4 2 1 3 5 5 2 1 3 5 5 4 3 6 2 6 6 
365 2 1 4 2 1 3 5 5 2 1 3 5 5 4 3 6 2 6 1 
365 2 1 4 2 1 3 5 5 2 1 3 5 5 4 3 6 2 6 1 
325 2 1 4 2 1 3 5 5 2 1 3 5 5 4 3 6 2 4 3 
325 2 1 4 2 1 3 5 5 2 1 3 5 5 4 3 6 2 4 1 
325 2 1 4 2 1 3 5 5 2 1 3 5 5 4 3 6 2 4 3 
325 2 1 4 2 1 3 5 5 2 1 3 5 5 4 3 6 2 1 4 
325 2 1 4 2 1 3 5 5 2 1 3 5 5 4 3 6 2 4 4 
325 2 1 4 2 1 3 5 5 2 1 3 5 5 4 3 6 2 1 4 
325 2 1 4 2 1 3 5 5 2 1 3 5 5 4 3 6 2 1 3 
325 2 1 4 2 1 3 5 5 2 1 3 5 5 4 3 6 5 1 4 
325 2 1 4 2 1 3 5 5 2 1 3 5 5 4 3 6 2 1 1 
325 2 1 4 2 1 3 5 5 2 1 3 5 5 4 3 6 2 1 3 
325 2 1 4 2 1 3 5 5 2 1 3 5 5 4 3 6 5 1 3 
325 2 1 4 2 1 3 5 5 2 1 3 5 5 4 3 6 2 1 2 
315 2 1 4 2 1 3 5 5 2 1 3 5 5 4 3 6 6 3 
310 2 1 4 2 1 3 5 5 2 1 3 5 5 4 3 6 2 3 3 4 
310 2 1 4 2 1 3 5 5 2 1 3 5 5 4 3 6 2 3 3 1 
305 2 1 4 2 1 3 5 5 2 1 3 5 5 4 3 6 2 3 5 
305 2 1 4 2 1 3 5 5 2 1 3 5 5 4 3 6 2 3 2 
305 2 1 4 2 1 3 5 5 2 1 3 5 5 4 3 6 2 3 4 
305 2 1 4 2 1 3 5 5 2 1 3 5 5 4 3 6 2 3 5 
305 2 1 4 2 1 3 5 5 2 1 3 5 5 4 3 6 2 3 4 
300 2 1 4 2 1 3 5 5 2 1 3 5 5 4 3 6 2 2 
300 2 1 4 2 1 3 5 5 2 1 3 5 5 4 3 6 2 2 
300 2 1 4 2 1 3 5 5 2 1 3 5 5 4 3 6 2 5 
300 2 1 4 2 1 3 5 5 2 1 3 5 5 4 3 6 2 5 
300 2 1 4 2 1 3 5 5 2 1 3 5 5 4 3 6 2 5 
300 2 1 4 2 1 3 5 5 2 1 3 5 5 4 3 6 2 5 
250 2 1 4 2 1 3 5 5 2 1 3 5 5 4 3 6 4 
250 2 1 4 2 1 3 5 5 2 1 3 5 5 4 3 6 4 
250 2 1 4 2 1 3 5 5 2 1 3 5 5 4 3 6 1 
235 2 1 4 2 1 3 5 5 2 1 3 5 5 4 3 5 6 
235 2 1 4 2 1 3 5 5 2 1 3 5 5 4 3 5 1 
230 2 1 4 2 1 3 5 5 2 1 3 5 4 5 5 3 
220 2 1 4 2 1 3 5 5 2 1 3 5 5 6 5 
220 2 1 4 2 1 3 5 5 2 1 3 5 5 6 5 
220 2 1 4 2 1 3 5 5 2 1 3 5 5 6 4 5 
220 2 1 4 2 1 3 5 5 2 1 3 5 5 6 5 
185 2 1 4 2 1 3 5 5 2 1 3 5 4 3 5 5 
185 2 1 4 2 1 3 5 5 2 1 3 5 5 4 3 3 
185 2 1 4 2 1 3 5 5 2 1 3 5 5 4 3 2 
180 2 1 4 2 1 3 5 5 2 1 3 5 5 4 1 
155 2 1 4 2 1 3 5 5 2 1 3 5 5 1 
155 2 1 4 2 1 3 5 5 2 1 3 5 5 3 
155 2 1 4 2 1 3 5 5 2 1 3 5 5 2 
130 2 1 4 2 1 3 5 5 2 1 3 5 4 6 
-5 2 1 4 2 1 3 5 5 2 1 3 5 5 4 3 6 2 3 
-5 2 1 4 2 1 3 5 5 2 1 3 5 5 4 3 6 2 3 
-5 2 1 4 2 1 3 5 5 2 1 3 5 5 4 3 6 2 3 
-190 2 1 4 2 1 3 5 5 2 1 3 5 5 4 
