660 1 5 4 4 5 5 5 4 2 4 1 5 3 4 3 6 2 6 3 6 5 1 6 6 4 1 
660 1 5 4 4 5 5 5 4 2 4 1 5 3 4 3 6 2 6 3 6 5 1 6 6 4 1 
635 1 5 4 4 5 5 5 4 2 4 1 5 3 4 3 6 2 6 3 6 5 1 6 6 6 
635 1 5 4 4 5 5 5 4 2 4 1 5 3 4 3 6 2 6 3 6 5 1 6 6 5 
635 1 5 4 4 5 5 5 4 2 4 1 5 3 4 3 6 2 6 3 6 5 1 4 2 4 4 6 
630 1 5 4 4 5 5 5 4 2 4 1 5 3 4 3 6 2 6 3 6 5 1 6 6 2 1 6 
620 1 5 4 4 5 5 5 4 2 4 1 5 3 4 3 6 2 6 3 6 5 1 6 4 4 6 
620 1 5 4 4 5 5 5 4 2 4 1 5 3 4 3 6 2 6 3 6 5 1 6 5 5 
615 1 5 4 4 5 5 5 4 2 4 1 5 3 4 3 6 2 6 3 6 5 1 6 5 1 1 6 
580 1 5 4 4 5 5 5 4 2 4 1 5 3 4 3 6 2 6 3 6 5 1 5 4 3 
570 1 5 4 4 5 5 5 4 2 4 1 5 3 4 3 6 2 6 3 6 5 1 6 2 
570 1 5 4 4 5 5 5 4 2 4 1 5 3 4 3 6 2 6 3 6 5 1 6 1 
570 1 5 4 4 5 5 5 4 2 4 1 5 3 4 3 6 2 6 3 6 5 1 6 2 
555 1 5 4 4 5 5 5 4 2 4 1 5 3 4 3 6 2 6 3 6 5 1 5 5 
555 1 5 4 4 5 5 5 4 2 4 1 5 3 4 3 6 2 6 3 6 5 1 2 5 
555 1 5 4 4 5 5 5 4 2 4 1 5 3 4 3 6 2 6 3 6 5 4 2 3 
555 1 5 4 4 5 5 5 4 2 4 1 5 3 4 3 6 2 6 3 6 5 1 4 4 5 
555 1 5 4 4 5 5 5 4 2 4 1 5 3 4 3 6 2 6 3 6 5 1 5 5 
530 1 5 4 4 5 5 5 4 2 4 1 5 3 4 3 6 2 6 3 6 5 1 1 3 
510 1 5 4 4 5 5 5 4 2 4 1 5 3 4 3 6 2 6 3 6 5 1 3 5 
495 1 5 4 4 5 5 5 4 2 4 1 5 3 4 3 6 2 6 3 6 6 3 
480 1 5 4 4 5 5 5 4 2 4 1 5 3 4 3 6 2 6 3 6 5 2 
480 1 5 4 4 5 5 5 4 2 4 1 5 3 4 3 6 2 6 3 6 5 2 
480 1 5 4 4 5 5 5 4 2 4 1 5 3 4 3 6 2 6 3 6 5 3 
480 1 5 4 4 5 5 5 4 2 4 1 5 3 4 3 6 2 6 3 6 5 5 
480 1 5 4 4 5 5 5 4 2 4 1 5 3 4 3 6 2 6 3 6 5 3 
435 1 5 4 4 5 5 5 4 2 4 1 5 3 4 3 6 2 6 3 6 3 3 
435 1 5 4 4 5 5 5 4 2 4 1 5 3 4 3 6 2 6 3 6 3 4 
430 1 5 4 4 5 5 5 4 2 4 1 5 3 4 3 6 2 6 3 6 4 
385 1 5 4 4 5 5 5 4 2 4 1 5 3 4 3 6 2 6 4 1 
385 1 5 4 4 5 5 5 4 2 4 1 5 3 4 3 6 2 6 4 4 
375 1 5 4 4 5 5 5 4 2 4 1 5 3 4 3 6 2 4 5 3 2 
370 1 5 4 4 5 5 5 4 2 4 1 5 3 4 3 6 2 6 3 3 1 
370 1 5 4 4 5 5 5 4 2 4 1 5 3 4 3 6 2 6 3 3 1 
370 1 5 4 4 5 5 5 4 2 4 1 5 3 4 3 6 2 6 3 3 3 
370 1 5 4 4 5 5 5 4 2 4 1 5 3 4 3 6 2 6 3 3 3 
370 1 5 4 4 5 5 5 4 2 4 1 5 3 4 3 6 2 1 5 2 
365 1 5 4 4 5 5 5 4 2 4 1 5 3 4 3 6 2 6 3 5 
365 1 5 4 4 5 5 5 4 2 4 1 5 3 4 3 6 2 6 3 5 
365 1 5 4 4 5 5 5 4 2 4 1 5 3 4 3 6 2 6 3 2 
360 1 5 4 4 5 5 5 4 2 4 1 5 3 4 3 6 2 6 5 
360 1 5 4 4 5 5 5 4 2 4 1 5 3 4 3 6 2 6 2 
320 1 5 4 4 5 5 5 4 2 4 1 5 3 4 3 6 2 1 6 
310 1 5 4 4 5 5 5 4 2 4 1 5 3 4 3 6 6 2 
305 1 5 4 4 5 5 5 4 2 4 1 5 3 4 3 6 2 3 3 2 
295 1 5 4 4 5 5 5 4 2 4 1 5 3 4 3 6 2 5 
295 1 5 4 4 5 5 5 4 2 4 1 5 3 4 3 6 2 5 
195 1 5 4 4 5 5 5 4 2 4 1 5 3 4 3 6 2 6 3 6 5 1 
