720 2 1 4 2 1 3 5 5 2 1 3 5 5 4 3 6 2 3 6 6 3 5 4 6 6 4 5 2 
675 2 1 4 2 1 3 5 5 2 1 3 5 5 4 3 6 2 3 6 6 3 5 4 1 1 4 4 4 3 1 2 
655 2 1 4 2 1 3 5 5 2 1 3 5 5 4 3 6 2 3 6 6 3 5 4 1 6 1 4 4 
655 2 1 4 2 1 3 5 5 2 1 3 5 5 4 3 6 2 3 6 6 3 5 4 1 2 5 1 2 4 4 
655 2 1 4 2 1 3 5 5 2 1 3 5 5 4 3 6 2 3 6 6 3 5 4 1 6 1 4 1 
655 2 1 4 2 1 3 5 5 2 1 3 5 5 4 3 6 2 3 6 6 3 5 4 2 4 6 3 2 6 
655 2 1 4 2 1 3 5 5 2 1 3 5 5 4 3 6 2 3 6 6 3 5 4 1 6 5 1 
655 2 1 4 2 1 3 5 5 2 1 3 5 5 4 3 6 2 3 6 6 3 5 4 1 6 2 6 
615 2 1 4 2 1 3 5 5 2 1 3 5 5 4 3 6 2 3 6 3 2 6 1 2 3 5 2 6 
590 2 1 4 2 1 3 5 5 2 1 3 5 5 4 3 6 2 3 6 6 3 5 4 1 5 1 
590 2 1 4 2 1 3 5 5 2 1 3 5 5 4 3 6 2 3 6 6 3 5 4 2 4 3 
590 2 1 4 2 1 3 5 5 2 1 3 5 5 4 3 6 2 3 6 6 3 5 4 1 2 3 
590 2 1 4 2 1 3 5 5 2 1 3 5 5 4 3 6 2 3 6 6 3 5 4 1 2 3 
580 2 1 4 2 1 3 5 5 2 1 3 5 5 4 3 6 2 3 6 6 3 5 4 6 3 
570 2 1 4 2 1 3 5 5 2 1 3 5 5 4 3 6 2 3 6 6 3 5 4 1 1 3 2 
570 2 1 4 2 1 3 5 5 2 1 3 5 5 4 3 6 2 3 6 6 3 5 4 4 1 3 2 
565 2 1 4 2 1 3 5 5 2 1 3 5 5 4 3 6 2 3 6 6 3 5 4 5 6 
565 2 1 4 2 1 3 5 5 2 1 3 5 5 4 3 6 2 3 6 6 3 5 4 2 2 
565 2 1 4 2 1 3 5 5 2 1 3 5 5 4 3 6 2 3 6 6 3 5 4 1 1 5 
565 2 1 4 2 1 3 5 5 2 1 3 5 5 4 3 6 2 3 6 6 3 5 4 1 4 5 
565 2 1 4 2 1 3 5 5 2 1 3 5 5 4 3 6 2 3 6 6 3 5 4 1 1 5 
565 2 1 4 2 1 3 5 5 2 1 3 5 5 4 3 6 2 3 6 6 3 5 4 1 1 6 
565 2 1 4 2 1 3 5 5 2 1 3 5 5 4 3 6 2 3 6 6 3 5 4 1 1 5 
565 2 1 4 2 1 3 5 5 2 1 3 5 5 4 3 6 2 3 6 6 3 5 4 1 1 6 
565 2 1 4 2 1 3 5 5 2 1 3 5 5 4 3 6 2 3 6 6 3 5 4 1 1 1 
565 2 1 4 2 1 3 5 5 2 1 3 5 5 4 3 6 2 3 6 6 3 5 4 1 1 6 
565 2 1 4 2 1 3 5 5 2 1 3 5 5 4 3 6 2 3 6 6 3 5 4 1 4 1 
565 2 1 4 2 1 3 5 5 2 1 3 5 5 4 3 6 2 3 6 6 3 5 4 1 1 5 
565 2 1 4 2 1 3 5 5 2 1 3 5 5 4 3 6 2 3 6 6 3 5 4 1 1 5 
565 2 1 4 2 1 3 5 5 2 1 3 5 5 4 3 6 2 3 6 6 3 5 4 1 1 5 
565 2 1 4 2 1 3 5 5 2 1 3 5 5 4 3 6 2 3 6 6 3 5 4 1 1 2 
545 2 1 4 2 1 3 5 5 2 1 3 5 5 4 3 6 2 3 6 6 3 5 4 3 4 6 
540 2 1 4 2 1 3 5 5 2 1 3 5 5 4 3 6 2 3 6 6 3 5 4 3 3 3 3 3 6 
540 2 1 4 2 1 3 5 5 2 1 3 5 5 4 3 6 2 3 6 6 3 5 4 1 3 
540 2 1 4 2 1 3 5 5 2 1 3 5 5 4 3 6 2 3 6 6 3 5 4 4 3 
490 2 1 4 2 1 3 5 5 2 1 3 5 5 4 3 6 2 3 6 3 6 5 3 
465 2 1 4 2 1 3 5 5 2 1 3 5 5 4 3 6 2 3 6 3 6 4 6 
435 2 1 4 2 1 3 5 5 2 1 3 5 5 4 3 6 2 3 6 6 1 
375 2 1 4 2 1 3 5 5 2 1 3 5 5 4 3 6 2 3 6 3 1 
375 2 1 4 2 1 3 5 5 2 1 3 5 5 4 3 6 2 1 5 2 
370 2 1 4 2 1 3 5 5 2 1 3 5 5 4 3 6 2 3 6 4 
370 2 1 4 2 1 3 5 5 2 1 3 5 5 4 3 6 2 6 3 5 
370 2 1 4 2 1 3 5 5 2 1 3 5 5 4 3 6 2 3 6 5 
370 2 1 4 2 1 3 5 5 2 1 3 5 5 4 3 6 2 3 6 5 
370 2 1 4 2 1 3 5 5 2 1 3 5 5 4 3 6 2 3 6 5 
365 2 1 4 2 1 3 5 5 2 1 3 5 5 4 3 6 2 6 6 
365 2 1 4 2 1 3 5 5 2 1 3 5 5 4 3 6 2 6 4 
365 2 1 4 2 1 3 5 5 2 1 3 5 5 4 3 6 5 6 6 
325 2 1 4 2 1 3 5 5 2 1 3 5 5 4 3 6 5 1 2 
325 2 1 4 2 1 3 5 5 2 1 3 5 5 4 3 6 2 4 3 
325 2 1 4 2 1 3 5 5 2 1 3 5 5 4 3 6 5 1 3 
325 2 1 4 2 1 3 5 5 2 1 3 5 5 4 3 6 2 4 3 
325 2 1 4 2 1 3 5 5 2 1 3 5 5 4 3 6 2 1 4 
305 2 1 4 2 1 3 5 5 2 1 3 5 5 4 3 6 2 3 1 
305 2 1 4 2 1 3 5 5 2 1 3 5 5 4 3 6 5 3 4 
305 2 1 4 2 1 3 5 5 2 1 3 5 5 4 3 6 2 3 2 
305 2 1 4 2 1 3 5 5 2 1 3 5 5 4 3 6 2 3 2 
305 2 1 4 2 1 3 5 5 2 1 3 5 5 4 3 6 2 3 4 
305 2 1 4 2 1 3 5 5 2 1 3 5 5 4 3 6 2 3 5 
300 2 1 4 2 1 3 5 5 2 1 3 5 5 4 3 6 5 5 
300 2 1 4 2 1 3 5 5 2 1 3 5 5 4 3 6 2 2 
300 2 1 4 2 1 3 5 5 2 1 3 5 5 4 3 6 5 5 
255 2 1 4 2 1 3 5 5 2 1 3 5 5 4 3 6 2 3 6 6 3 5 4 1 1 4 5 2 
250 2 1 4 2 1 3 5 5 2 1 3 5 5 4 3 6 1 
250 2 1 4 2 1 3 5 5 2 1 3 5 5 4 3 6 4 
190 2 1 4 2 1 3 5 5 2 1 3 5 5 4 3 6 2 3 6 6 3 5 4 1 
165 2 1 4 2 1 3 5 5 2 1 3 5 5 4 3 6 2 3 6 6 3 5 4 
-10 2 1 4 2 1 3 5 5 2 1 3 5 5 4 3 6 2 
-50 2 1 4 2 1 3 5 5 2 1 3 5 5 4 3 6 2 
-50 2 1 4 2 1 3 5 5 2 1 3 5 5 4 3 6 2 
-50 2 1 4 2 1 3 5 5 2 1 3 5 5 4 3 6 5 
-125 2 1 4 2 1 3 5 5 2 1 3 5 5 4 3 
