999994 2 1 4 2 1 3 5 5 2 1 3 5 5 4 3 6 2 3 6 6 3 5 4 1 6 2 5 6 6 
730 2 1 4 2 1 3 5 5 2 1 3 5 5 4 3 6 2 3 6 6 3 5 4 3 2 4 2 4 5 3 4 
710 2 1 4 2 1 3 5 5 2 1 3 5 5 4 3 6 2 3 6 6 3 5 4 6 5 4 3 4 1 2 
705 2 1 4 2 1 3 5 5 2 1 3 5 5 4 3 6 2 3 6 6 3 5 4 1 6 1 4 5 2 
695 2 1 4 2 1 3 5 5 2 1 3 5 5 4 3 6 2 3 6 6 3 5 4 1 6 4 6 1 
680 2 1 4 2 1 3 5 5 2 1 3 5 5 4 3 6 2 3 6 6 3 5 4 6 6 3 4 3 3 
675 2 1 4 2 1 3 5 5 2 1 3 5 5 4 3 6 2 3 6 6 3 5 4 6 6 4 3 6 
675 2 1 4 2 1 3 5 5 2 1 3 5 5 4 3 6 2 3 6 6 3 5 4 6 6 4 3 6 
675 2 1 4 2 1 3 5 5 2 1 3 5 5 4 3 6 2 3 6 6 3 5 4 6 6 4 3 3 
675 2 1 4 2 1 3 5 5 2 1 3 5 5 4 3 6 2 3 6 6 3 5 4 6 6 3 4 1 
675 2 1 4 2 1 3 5 5 2 1 3 5 5 4 3 6 2 3 6 6 3 5 4 1 1 4 4 4 3 1 2 
670 2 1 4 2 1 3 5 5 2 1 3 5 5 4 3 6 2 3 6 6 3 5 4 6 6 4 1 
670 2 1 4 2 1 3 5 5 2 1 3 5 5 4 3 6 2 3 6 6 3 5 4 6 6 4 5 4 
670 2 1 4 2 1 3 5 5 2 1 3 5 5 4 3 6 2 3 6 6 3 5 4 6 6 4 1 
670 2 1 4 2 1 3 5 5 2 1 3 5 5 4 3 6 2 3 6 6 3 5 4 6 6 4 5 5 
670 2 1 4 2 1 3 5 5 2 1 3 5 5 4 3 6 2 3 6 6 3 5 4 6 6 4 2 
670 2 1 4 2 1 3 5 5 2 1 3 5 5 4 3 6 2 3 6 6 3 5 4 6 6 4 1 
670 2 1 4 2 1 3 5 5 2 1 3 5 5 4 3 6 2 3 6 6 3 5 4 6 6 4 5 4 
670 2 1 4 2 1 3 5 5 2 1 3 5 5 4 3 6 2 3 6 6 3 5 4 6 6 4 5 5 
670 2 1 4 2 1 3 5 5 2 1 3 5 5 4 3 6 2 3 6 6 3 5 4 6 6 4 5 
670 2 1 4 2 1 3 5 5 2 1 3 5 5 4 3 6 2 3 6 6 3 5 4 6 6 4 5 
670 2 1 4 2 1 3 5 5 2 1 3 5 5 4 3 6 2 3 6 6 3 5 4 6 6 4 5 
670 2 1 4 2 1 3 5 5 2 1 3 5 5 4 3 6 2 3 6 6 3 5 4 6 6 4 6 
670 2 1 4 2 1 3 5 5 2 1 3 5 5 4 3 6 2 3 6 6 3 5 4 6 6 4 5 6 
670 2 1 4 2 1 3 5 5 2 1 3 5 5 4 3 6 2 3 6 6 3 5 4 6 6 4 5 1 
670 2 1 4 2 1 3 5 5 2 1 3 5 5 4 3 6 2 3 6 6 3 5 4 6 6 4 1 
670 2 1 4 2 1 3 5 5 2 1 3 5 5 4 3 6 2 3 6 6 3 5 4 6 6 4 5 
670 2 1 4 2 1 3 5 5 2 1 3 5 5 4 3 6 2 3 6 6 3 5 4 6 6 4 4 
665 2 1 4 2 1 3 5 5 2 1 3 5 5 4 3 6 2 3 6 6 3 5 4 6 6 1 4 2 
660 2 1 4 2 1 3 5 5 2 1 3 5 5 4 3 6 2 3 6 6 3 5 4 1 6 5 3 3 
655 2 1 4 2 1 3 5 5 2 1 3 5 5 4 3 6 2 3 6 6 3 5 4 1 6 1 4 4 
650 2 1 4 2 1 3 5 5 2 1 3 5 5 4 3 6 2 3 6 6 3 5 4 6 6 3 5 
645 2 1 4 2 1 3 5 5 2 1 3 5 5 4 3 6 2 3 6 6 3 5 4 6 6 6 
645 2 1 4 2 1 3 5 5 2 1 3 5 5 4 3 6 2 3 6 6 3 5 4 6 6 5 
645 2 1 4 2 1 3 5 5 2 1 3 5 5 4 3 6 2 3 6 6 3 5 4 3 2 4 2 6 
645 2 1 4 2 1 3 5 5 2 1 3 5 5 4 3 6 2 3 6 6 3 5 4 6 6 3 1 6 
645 2 1 4 2 1 3 5 5 2 1 3 5 5 4 3 6 2 3 6 6 3 5 4 6 6 3 3 5 
645 2 1 4 2 1 3 5 5 2 1 3 5 5 4 3 6 2 3 6 6 3 5 4 6 6 1 3 6 
640 2 1 4 2 1 3 5 5 2 1 3 5 5 4 3 6 2 3 6 6 3 5 4 6 6 2 6 
635 2 1 4 2 1 3 5 5 2 1 3 5 5 4 3 6 2 3 6 6 3 5 4 1 5 5 1 6 
605 2 1 4 2 1 3 5 5 2 1 3 5 5 4 3 6 2 3 6 6 3 5 4 6 4 6 
590 2 1 4 2 1 3 5 5 2 1 3 5 5 4 3 6 2 3 6 6 3 5 4 1 2 2 
590 2 1 4 2 1 3 5 5 2 1 3 5 5 4 3 6 2 3 6 6 3 5 4 1 5 3 
580 2 1 4 2 1 3 5 5 2 1 3 5 5 4 3 6 2 3 6 6 3 5 4 6 3 
570 2 1 4 2 1 3 5 5 2 1 3 5 5 4 3 6 2 3 6 6 3 5 4 6 
565 2 1 4 2 1 3 5 5 2 1 3 5 5 4 3 6 2 3 6 6 3 5 4 1 1 1 
565 2 1 4 2 1 3 5 5 2 1 3 5 5 4 3 6 2 3 6 6 3 5 4 1 1 5 
565 2 1 4 2 1 3 5 5 2 1 3 5 5 4 3 6 2 3 6 6 3 5 4 2 6 
565 2 1 4 2 1 3 5 5 2 1 3 5 5 4 3 6 2 3 6 6 3 5 4 1 1 3 
565 2 1 4 2 1 3 5 5 2 1 3 5 5 4 3 6 2 3 6 6 3 5 4 4 1 3 4 
565 2 1 4 2 1 3 5 5 2 1 3 5 5 4 3 6 2 3 6 6 3 5 4 1 4 5 
565 2 1 4 2 1 3 5 5 2 1 3 5 5 4 3 6 2 3 6 6 3 5 4 5 1 
565 2 1 4 2 1 3 5 5 2 1 3 5 5 4 3 6 2 3 6 6 3 5 4 5 1 
565 2 1 4 2 1 3 5 5 2 1 3 5 5 4 3 6 2 3 6 6 3 5 4 5 5 
565 2 1 4 2 1 3 5 5 2 1 3 5 5 4 3 6 2 3 6 6 3 5 4 1 4 5 
565 2 1 4 2 1 3 5 5 2 1 3 5 5 4 3 6 2 3 6 6 3 5 4 1 4 3 
560 2 1 4 2 1 3 5 5 2 1 3 5 5 4 3 6 2 3 6 6 3 5 4 1 2 5 1 2 
540 2 1 4 2 1 3 5 5 2 1 3 5 5 4 3 6 2 3 6 6 3 5 4 1 3 
540 2 1 4 2 1 3 5 5 2 1 3 5 5 4 3 6 2 3 6 6 3 5 4 1 3 
535 2 1 4 2 1 3 5 5 2 1 3 5 5 4 3 6 2 3 6 6 3 5 4 3 3 3 3 6 
520 2 1 4 2 1 3 5 5 2 1 3 5 5 4 3 6 2 3 6 6 3 5 4 3 1 
490 2 1 4 2 1 3 5 5 2 1 3 5 5 4 3 6 2 3 6 3 6 5 5 
490 2 1 4 2 1 3 5 5 2 1 3 5 5 4 3 6 2 3 6 6 3 5 2 
295 2 1 4 2 1 3 5 5 2 1 3 5 5 4 3 6 2 3 6 6 3 5 4 6 6 4 
295 2 1 4 2 1 3 5 5 2 1 3 5 5 4 3 6 2 3 6 6 3 5 4 6 6 
295 2 1 4 2 1 3 5 5 2 1 3 5 5 4 3 6 2 3 6 6 3 5 4 6 6 
295 2 1 4 2 1 3 5 5 2 1 3 5 5 4 3 6 2 3 6 6 3 5 4 6 6 
270 2 1 4 2 1 3 5 5 2 1 3 5 5 4 3 6 2 3 6 6 3 5 4 6 
265 2 1 4 2 1 3 5 5 2 1 3 5 5 4 3 6 2 3 6 6 3 5 4 6 6 3 2 
215 2 1 4 2 1 3 5 5 2 1 3 5 5 4 3 6 2 3 6 6 3 5 4 2 4 
190 2 1 4 2 1 3 5 5 2 1 3 5 5 4 3 6 2 3 6 6 3 5 4 1 
140 2 1 4 2 1 3 5 5 2 1 3 5 5 4 3 6 2 3 6 3 2 6 1 2 3 5 
