999994 2 1 4 2 1 3 5 5 2 1 3 5 5 4 3 6 2 3 6 6 3 5 4 1 6 2 5 4 5 5 
999994 2 1 4 2 1 3 5 5 2 1 3 5 5 4 3 6 2 3 6 6 3 5 4 1 6 2 5 6 6 
999994 2 1 4 2 1 3 5 5 2 1 3 5 5 4 3 6 2 3 6 6 3 5 4 1 6 2 5 6 5 
999994 2 1 4 2 1 3 5 5 2 1 3 5 5 4 3 6 2 3 6 6 3 5 4 1 6 2 5 4 6 
999994 2 1 4 2 1 3 5 5 2 1 3 5 5 4 3 6 2 3 6 6 3 5 4 1 6 2 5 6 6 
999994 2 1 4 2 1 3 5 5 2 1 3 5 5 4 3 6 2 3 6 6 3 5 4 1 6 2 5 6 4 5 
999994 2 1 4 2 1 3 5 5 2 1 3 5 5 4 3 6 2 3 6 6 3 5 4 1 6 2 5 6 4 4 
999994 2 1 4 2 1 3 5 5 2 1 3 5 5 4 3 6 2 3 6 6 3 5 4 1 6 2 5 6 5 
999619 2 1 4 2 1 3 5 5 2 1 3 5 5 4 3 6 2 3 6 6 3 5 4 1 6 2 5 
770 2 1 4 2 1 3 5 5 2 1 3 5 5 4 3 6 2 3 6 6 3 5 4 1 6 2 5 6 2 
770 2 1 4 2 1 3 5 5 2 1 3 5 5 4 3 6 2 3 6 6 3 5 4 1 6 2 5 6 2 
770 2 1 4 2 1 3 5 5 2 1 3 5 5 4 3 6 2 3 6 6 3 5 4 1 6 2 5 6 3 
770 2 1 4 2 1 3 5 5 2 1 3 5 5 4 3 6 2 3 6 6 3 5 4 1 6 2 5 6 3 
770 2 1 4 2 1 3 5 5 2 1 3 5 5 4 3 6 2 3 6 6 3 5 4 1 6 2 5 6 2 
770 2 1 4 2 1 3 5 5 2 1 3 5 5 4 3 6 2 3 6 6 3 5 4 1 6 2 5 6 1 
770 2 1 4 2 1 3 5 5 2 1 3 5 5 4 3 6 2 3 6 6 3 5 4 1 6 2 5 6 2 
770 2 1 4 2 1 3 5 5 2 1 3 5 5 4 3 6 2 3 6 6 3 5 4 1 6 2 5 6 2 
755 2 1 4 2 1 3 5 5 2 1 3 5 5 4 3 6 2 3 6 6 3 5 4 1 6 2 5 5 1 
755 2 1 4 2 1 3 5 5 2 1 3 5 5 4 3 6 2 3 6 6 3 5 4 1 6 2 5 5 3 
755 2 1 4 2 1 3 5 5 2 1 3 5 5 4 3 6 2 3 6 6 3 5 4 1 6 2 5 5 1 
725 2 1 4 2 1 3 5 5 2 1 3 5 5 4 3 6 2 3 6 6 3 5 4 6 6 4 5 3 2 
725 2 1 4 2 1 3 5 5 2 1 3 5 5 4 3 6 2 3 6 6 3 5 4 6 6 4 3 2 3 
725 2 1 4 2 1 3 5 5 2 1 3 5 5 4 3 6 2 3 6 6 3 5 4 6 6 4 5 3 2 
725 2 1 4 2 1 3 5 5 2 1 3 5 5 4 3 6 2 3 6 6 3 5 4 6 6 4 2 3 2 
725 2 1 4 2 1 3 5 5 2 1 3 5 5 4 3 6 2 3 6 6 3 5 4 6 6 3 4 2 2 
720 2 1 4 2 1 3 5 5 2 1 3 5 5 4 3 6 2 3 6 6 3 5 4 6 6 4 2 1 
720 2 1 4 2 1 3 5 5 2 1 3 5 5 4 3 6 2 3 6 6 3 5 4 6 6 4 2 6 
710 2 1 4 2 1 3 5 5 2 1 3 5 5 4 3 6 2 3 6 6 3 5 4 6 6 6 4 
710 2 1 4 2 1 3 5 5 2 1 3 5 5 4 3 6 2 3 6 6 3 5 4 6 6 1 6 2 
705 2 1 4 2 1 3 5 5 2 1 3 5 5 4 3 6 2 3 6 6 3 5 4 6 6 1 6 6 
705 2 1 4 2 1 3 5 5 2 1 3 5 5 4 3 6 2 3 6 6 3 5 4 1 6 2 5 3 
705 2 1 4 2 1 3 5 5 2 1 3 5 5 4 3 6 2 3 6 6 3 5 4 1 6 2 5 1 
705 2 1 4 2 1 3 5 5 2 1 3 5 5 4 3 6 2 3 6 6 3 5 4 1 6 2 5 2 
705 2 1 4 2 1 3 5 5 2 1 3 5 5 4 3 6 2 3 6 6 3 5 4 1 6 2 5 1 
705 2 1 4 2 1 3 5 5 2 1 3 5 5 4 3 6 2 3 6 6 3 5 4 1 6 2 5 1 
705 2 1 4 2 1 3 5 5 2 1 3 5 5 4 3 6 2 3 6 6 3 5 4 1 6 2 5 2 
695 2 1 4 2 1 3 5 5 2 1 3 5 5 4 3 6 2 3 6 6 3 5 4 1 1 4 4 4 3 2 6 
685 2 1 4 2 1 3 5 5 2 1 3 5 5 4 3 6 2 3 6 6 3 5 4 6 5 4 3 4 4 
675 2 1 4 2 1 3 5 5 2 1 3 5 5 4 3 6 2 3 6 6 3 5 4 6 6 4 3 5 
675 2 1 4 2 1 3 5 5 2 1 3 5 5 4 3 6 2 3 6 6 3 5 4 6 6 4 3 3 
675 2 1 4 2 1 3 5 5 2 1 3 5 5 4 3 6 2 3 6 6 3 5 4 6 6 3 4 1 
670 2 1 4 2 1 3 5 5 2 1 3 5 5 4 3 6 2 3 6 6 3 5 4 6 6 4 6 
670 2 1 4 2 1 3 5 5 2 1 3 5 5 4 3 6 2 3 6 6 3 5 4 3 2 4 2 4 5 3 4 
670 2 1 4 2 1 3 5 5 2 1 3 5 5 4 3 6 2 3 6 6 3 5 4 6 6 4 6 
670 2 1 4 2 1 3 5 5 2 1 3 5 5 4 3 6 2 3 6 6 3 5 4 6 6 4 1 
670 2 1 4 2 1 3 5 5 2 1 3 5 5 4 3 6 2 3 6 6 3 5 4 6 6 4 1 
660 2 1 4 2 1 3 5 5 2 1 3 5 5 4 3 6 2 3 6 6 3 5 4 1 6 5 3 1 
660 2 1 4 2 1 3 5 5 2 1 3 5 5 4 3 6 2 3 6 6 3 5 4 1 6 2 3 3 
655 2 1 4 2 1 3 5 5 2 1 3 5 5 4 3 6 2 3 6 6 3 5 4 1 6 2 1 
655 2 1 4 2 1 3 5 5 2 1 3 5 5 4 3 6 2 3 6 6 3 5 4 1 6 2 6 
655 2 1 4 2 1 3 5 5 2 1 3 5 5 4 3 6 2 3 6 6 3 5 4 1 6 2 6 
655 2 1 4 2 1 3 5 5 2 1 3 5 5 4 3 6 2 3 6 6 3 5 4 1 6 2 6 
655 2 1 4 2 1 3 5 5 2 1 3 5 5 4 3 6 2 3 6 6 3 5 4 1 6 2 1 
645 2 1 4 2 1 3 5 5 2 1 3 5 5 4 3 6 2 3 6 6 3 5 4 6 6 5 
645 2 1 4 2 1 3 5 5 2 1 3 5 5 4 3 6 2 3 6 6 3 5 4 3 2 4 1 4 6 
635 2 1 4 2 1 3 5 5 2 1 3 5 5 4 3 6 2 3 6 6 3 5 4 1 6 1 3 5 
630 2 1 4 2 1 3 5 5 2 1 3 5 5 4 3 6 2 3 6 6 3 5 4 1 6 1 5 
605 2 1 4 2 1 3 5 5 2 1 3 5 5 4 3 6 2 3 6 6 3 5 4 1 6 6 
570 2 1 4 2 1 3 5 5 2 1 3 5 5 4 3 6 2 3 6 6 3 5 4 6 
570 2 1 4 2 1 3 5 5 2 1 3 5 5 4 3 6 2 3 6 6 3 5 4 6 
560 2 1 4 2 1 3 5 5 2 1 3 5 5 4 3 6 2 3 6 6 3 5 4 6 6 1 2 3 1 
345 2 1 4 2 1 3 5 5 2 1 3 5 5 4 3 6 2 3 6 6 3 5 4 6 6 4 
330 2 1 4 2 1 3 5 5 2 1 3 5 5 4 3 6 2 3 6 6 3 5 4 1 6 2 
295 2 1 4 2 1 3 5 5 2 1 3 5 5 4 3 6 2 3 6 6 3 5 4 6 6 
295 2 1 4 2 1 3 5 5 2 1 3 5 5 4 3 6 2 3 6 6 3 5 4 6 6 
280 2 1 4 2 1 3 5 5 2 1 3 5 5 4 3 6 2 3 6 6 3 5 4 1 6 
280 2 1 4 2 1 3 5 5 2 1 3 5 5 4 3 6 2 3 6 6 3 5 4 1 6 
280 2 1 4 2 1 3 5 5 2 1 3 5 5 4 3 6 2 3 6 6 3 5 4 1 6 
280 2 1 4 2 1 3 5 5 2 1 3 5 5 4 3 6 2 3 6 6 3 5 4 1 6 
275 2 1 4 2 1 3 5 5 2 1 3 5 5 4 3 6 2 3 6 6 3 5 4 6 6 3 
265 2 1 4 2 1 3 5 5 2 1 3 5 5 4 3 6 2 3 6 6 3 5 4 6 6 3 3 
205 2 1 4 2 1 3 5 5 2 1 3 5 5 4 3 6 2 3 6 6 3 5 4 
