195 3 4 3 4 5 3 3 4 3 2 2 
185 0 3 1 3 1 2 2 4 2 
230 4 0 0 2 5 1 2 4 4 
210 1 1 5 3 1 1 0 3 4 4 1 
210 5 4 5 1 3 4 0 4 3 5 
155 3 3 0 4 0 1 3 1 3 5 3 2 
195 0 0 2 1 0 3 2 5 0 4 
230 1 4 4 5 2 0 0 2 4 
