65 4 4 4 2 3 1 5 5 6 5 2 
35 2 3 3 6 2 2 1 6 4 4 
20 1 2 4 1 2 5 2 5 2 
15 6 6 1 1 1 5 6 5 
15 2 2 5 2 2 3 6 6 
10 2 6 3 5 4 1 4 6 3 1 
5 3 6 1 1 1 5 5 6 6 
5 1 5 5 3 5 6 6 4 
-5 5 6 3 6 5 6 2 
-25 2 1 5 4 4 4 4 2 3 6 
-25 2 2 5 4 1 1 5 3 6 
-25 1 5 5 2 2 5 3 6 
-30 1 2 1 2 2 5 1 1 
-35 6 4 5 4 3 4 4 2 4 
-40 6 5 2 5 2 2 
-40 5 2 6 1 1 5 4 
-40 6 5 5 2 5 3 
-40 4 1 2 2 6 2 1 
-45 6 6 3 5 1 5 6 
-45 6 5 1 3 6 2 3 
-45 2 1 1 3 5 5 4 3 4 4 
-45 4 3 2 6 2 6 1 
-50 6 1 2 5 6 2 
-50 6 4 1 1 5 6 1 
-50 1 3 3 5 6 1 2 3 1 4 
-50 4 3 3 3 5 3 3 2 1 5 1 2 
-50 5 1 4 3 2 5 5 1 
-50 4 6 5 4 3 3 2 3 4 2 
-50 1 1 5 4 4 2 3 1 4 6 
-55 6 5 3 5 4 3 5 1 
-55 6 1 4 3 3 5 4 5 2 
-55 4 4 1 1 2 1 5 1 2 
-55 2 4 2 4 3 4 6 3 5 
-55 3 6 4 1 6 6 6 
-55 4 6 3 1 4 2 3 4 4 4 
-60 1 1 6 6 6 2 
-60 3 3 4 1 2 3 2 4 2 3 4 
-65 3 3 2 1 1 3 2 1 5 6 
-65 1 3 3 1 5 1 2 3 5 2 
-65 4 3 1 5 4 1 3 4 5 3 6 
-65 5 1 6 4 2 1 5 
-65 2 3 2 5 4 3 3 2 5 
-65 6 2 4 3 6 4 3 2 
-70 3 2 3 3 2 6 3 5 4 
-70 2 1 2 2 3 3 2 5 
-70 6 1 6 4 3 2 2 
-70 1 6 3 1 6 5 6 
-70 6 5 5 6 3 2 
-70 2 4 5 1 3 5 1 3 2 
-75 6 5 3 3 1 1 3 2 6 
-75 6 2 6 5 2 
-80 5 2 1 2 4 4 6 
-80 4 3 1 6 1 3 4 2 2 
-80 3 2 3 6 1 4 1 1 6 
-80 4 4 5 3 6 2 3 2 
-85 3 4 6 1 2 2 5 
-90 3 3 5 6 4 6 2 
-95 1 1 5 4 2 1 3 3 6 
-95 6 5 1 6 3 6 
-100 2 6 6 4 6 
-100 2 3 6 3 4 4 1 3 6 
-100 2 4 6 6 6 
-110 6 1 3 2 5 6 
-115 6 6 3 3 5 6 
