120 4 2 2 1 2 3 5 6 5 5 5 
95 2 3 2 6 6 6 5 5 1 
70 4 2 1 2 5 4 2 5 5 2 
60 6 1 4 1 2 5 1 5 5 2 
10 6 4 5 2 1 5 5 2 
10 4 2 4 4 1 6 2 5 1 
0 6 2 2 4 6 5 4 
-5 2 5 4 3 6 5 3 5 2 
-25 3 2 2 5 2 4 5 4 
-25 3 2 4 5 4 5 1 5 4 
-30 1 5 1 2 5 4 5 3 
-30 4 5 1 4 1 5 1 2 6 
-30 4 1 1 2 5 5 2 1 
-35 3 5 6 2 2 5 1 
-35 4 4 2 3 3 3 5 4 5 1 1 
-40 4 1 4 2 6 4 2 6 
-40 2 6 1 1 4 1 2 6 
-40 1 1 4 4 5 6 5 2 
-40 5 2 2 6 5 1 
-40 1 4 4 6 1 1 4 1 1 3 
-45 2 4 2 1 3 2 4 3 1 6 
-45 4 1 5 3 4 1 3 2 5 2 
-50 5 5 2 4 3 1 2 1 
-50 4 5 2 2 1 2 3 5 
-50 3 4 3 2 5 6 5 3 6 
-50 6 6 2 4 5 2 
-50 3 4 5 1 1 2 4 1 4 4 
-50 4 6 4 1 6 2 1 
-50 6 6 2 2 1 2 
-50 2 6 5 1 6 1 
-50 5 4 4 4 6 6 1 
-55 5 5 4 4 5 1 1 2 
-55 2 2 2 5 1 4 6 
-55 3 2 3 5 4 3 4 2 3 4 4 
-55 2 2 1 5 4 5 5 
-60 6 1 6 6 4 4 
-60 6 3 2 5 4 4 1 1 
-60 4 1 6 5 4 3 5 2 
-60 6 6 6 2 6 
-60 3 3 3 1 5 4 3 3 5 6 4 
-65 1 6 4 2 2 1 6 
-65 4 4 6 3 3 2 6 1 
-65 6 6 4 3 3 1 2 1 
-65 3 5 1 1 6 3 3 4 4 3 4 
-65 4 3 3 4 4 1 1 5 4 4 6 
-70 5 1 6 6 3 1 1 
-70 3 3 5 3 5 6 4 3 4 4 
-70 4 6 1 3 6 5 4 
-70 6 6 1 1 2 3 1 
-75 2 6 6 2 6 
-75 2 6 2 6 2 
-75 5 1 3 5 2 5 5 
-75 1 4 1 1 4 2 4 1 3 2 
-75 5 3 5 1 6 3 3 4 2 
-75 6 6 4 2 4 5 
-80 5 3 3 3 2 3 5 2 3 6 
-80 1 3 5 3 6 1 5 2 
-80 1 2 3 6 4 5 3 6 
-80 3 6 1 1 4 5 3 1 2 
-80 5 3 3 5 3 3 3 5 5 2 
-80 6 3 5 3 3 3 1 3 3 5 1 
-80 3 2 6 2 3 1 4 5 
-85 2 4 3 1 2 6 6 
-85 5 4 3 3 2 3 4 2 3 2 
-85 4 3 4 4 6 5 4 5 
-90 6 3 1 3 6 2 6 
-90 1 2 5 6 1 6 
-90 3 3 1 2 1 1 3 5 1 6 
-95 6 4 6 1 4 3 6 
-100 4 2 2 5 1 3 6 
-100 2 6 3 2 3 1 3 6 
-100 5 1 5 5 3 1 6 
