-295 6 6 3 6 3 2 
-125 1 6 2 4 5 3 4 2 
-120 6 5 4 2 3 4 4 3 4 
-80 1 4 1 2 2 5 6 
-140 4 3 5 2 6 1 3 3 2 
-30 1 2 4 5 5 5 4 6 6 
-150 2 2 6 2 3 6 
-145 5 3 3 2 1 6 4 2 
-120 2 1 2 3 3 1 1 6 1 
-130 1 5 2 1 1 6 6 
-35 4 5 1 3 4 2 5 3 4 3 4 
-125 6 3 2 5 1 4 4 2 
-60 3 4 6 5 3 1 3 2 4 5 2 
-105 2 5 2 6 5 2 
-75 3 2 4 5 6 6 5 5 4 
-250 6 3 6 4 6 1 6 
-125 6 4 5 3 1 4 2 5 
-95 2 2 2 3 1 3 4 6 
-230 6 4 5 6 6 
-105 5 6 1 5 1 4 1 6 6 
-125 2 5 6 5 4 3 6 6 
-200 1 5 3 6 4 6 6 4 
-200 6 6 4 3 1 5 2 
-120 2 5 6 4 3 3 2 6 3 
-30 1 5 4 4 5 5 2 2 
-45 2 2 3 2 6 2 5 3 5 
-145 6 2 4 3 1 4 1 3 2 
20 1 2 1 2 5 2 4 5 4 
-105 4 4 4 1 2 4 1 6 6 
-75 1 2 3 1 4 2 4 1 5 
-35 2 2 1 4 3 4 3 5 3 4 2 
-155 6 1 4 4 4 5 6 
-100 6 3 4 2 4 2 5 2 
-170 3 5 6 4 2 3 6 
-65 3 3 2 3 4 2 2 1 4 2 
-165 5 1 2 3 3 3 6 6 
-175 3 6 6 2 4 5 4 
-200 6 1 6 3 2 1 6 4 
-45 2 3 4 5 4 4 5 3 4 1 
-195 1 3 6 1 3 1 4 6 1 
-130 1 4 5 6 5 4 2 
-130 5 1 1 2 4 6 5 
-180 2 4 6 6 4 1 6 3 
0 6 5 3 2 2 2 5 5 1 
-55 1 4 5 4 4 2 1 4 6 
-105 2 5 6 4 1 5 4 
-105 6 4 4 1 1 4 4 2 4 
-125 1 4 1 6 2 3 5 5 
-125 3 6 1 1 2 6 1 5 4 
-155 4 1 5 6 5 6 
-80 6 5 1 6 5 5 1 4 1 
-40 1 4 3 3 3 5 5 2 2 6 
-155 5 5 1 1 6 6 
0 6 5 3 5 2 5 5 5 4 
-200 6 6 2 3 2 6 
-40 3 5 4 2 5 3 1 2 3 4 
-135 6 2 3 2 3 2 3 3 4 
-200 3 1 5 6 6 1 6 
-175 5 1 6 6 5 3 4 
-205 5 3 3 3 6 6 4 3 3 1 
-120 3 6 3 4 5 5 5 2 
-200 5 1 1 6 6 3 2 
-100 1 2 1 3 1 6 5 1 6 
-120 1 2 3 1 2 3 6 4 1 
