40 4 6 6 2 5 6 4 1 
35 6 3 2 5 5 3 4 6 4 6 
20 3 4 5 5 6 4 1 4 5 3 3 
15 6 2 2 6 1 6 2 
15 4 6 6 5 5 6 5 
15 4 2 2 5 3 1 1 3 4 3 5 4 
15 2 2 4 1 1 3 6 1 5 1 
10 3 1 1 5 1 2 6 3 6 6 
0 6 6 4 1 6 5 3 3 6 
-25 4 3 1 1 1 2 2 1 2 4 
-25 4 2 1 2 2 5 1 3 6 
-25 4 2 3 1 5 1 4 2 4 1 
-25 2 3 2 5 4 5 2 4 
-25 2 1 5 5 3 2 4 1 3 
-30 1 1 4 4 5 2 2 1 4 
-30 5 1 2 1 5 5 4 2 
-30 2 1 1 2 1 4 5 1 2 
-30 5 2 2 5 4 1 1 4 
-35 5 6 2 2 3 2 6 
-35 4 5 1 2 6 3 4 4 4 
-35 1 5 3 6 1 2 2 4 
-35 4 1 6 2 1 4 2 3 1 
-40 5 4 6 1 4 4 5 1 
-45 5 3 1 6 5 6 4 
-50 5 6 4 6 5 1 
-50 5 4 6 1 1 6 2 
-50 2 4 2 2 5 3 1 5 
-50 4 4 2 5 3 2 1 1 5 
-50 6 6 2 2 1 4 
-50 6 5 4 3 3 3 5 2 4 
-55 1 1 2 5 1 2 4 6 
-55 4 5 2 6 2 3 3 1 
-55 1 1 3 5 6 4 5 3 5 
-55 2 4 1 5 5 5 2 
-60 3 5 2 4 6 2 5 
-60 6 1 4 1 4 1 3 5 5 
-60 6 1 4 1 5 3 2 6 
-65 1 2 6 2 4 4 5 
-65 1 2 5 6 2 6 
-65 2 1 1 5 6 1 5 
-65 5 1 1 6 5 1 6 
-65 1 4 4 4 4 5 6 6 
-65 4 5 2 6 5 2 
-70 1 6 6 3 4 1 1 2 
-70 6 4 3 2 6 4 2 
-75 6 3 1 3 4 2 3 5 6 
-75 4 2 1 2 1 4 1 3 2 
-75 6 1 2 6 1 2 
-75 5 2 5 1 2 3 6 
-75 6 6 2 4 4 2 
-75 5 1 6 1 6 2 
-75 4 4 1 1 6 6 5 
-75 6 3 4 6 6 3 2 
-80 3 5 6 3 1 1 2 5 
-80 6 3 4 2 1 1 3 1 6 
-85 6 3 3 6 4 2 3 2 
-85 1 6 2 3 1 2 6 
-85 6 5 3 1 1 5 6 
-90 1 5 1 6 5 6 
-90 2 4 2 4 6 6 
-90 5 6 5 5 6 
-90 2 2 5 6 6 
-95 2 1 3 5 1 2 3 6 
-110 3 3 5 3 4 4 2 3 4 6 
