-45 5 2 2 4 3 4 3 5 1 
-75 5 3 1 5 5 1 4 5 
-45 0 4 2 2 2 0 4 2 1 
-50 0 1 4 0 1 0 3 3 5 1 0 5 1 4 
-70 2 0 4 1 1 2 0 2 5 
-45 1 0 4 0 5 4 1 1 5 1 1 
-40 4 4 2 5 4 3 0 0 1 4 4 0 
-55 1 3 1 0 5 0 5 2 3 3 1 2 
-90 5 3 1 0 0 0 0 3 0 5 0 5 2 
-75 4 4 3 1 5 3 0 1 3 3 3 2 5 
-85 3 0 0 3 0 5 0 1 0 4 0 1 0 4 4 1 
-60 4 0 5 0 2 0 2 5 3 2 
-80 0 3 5 1 3 4 3 5 4 4 0 5 
-80 5 2 0 3 0 2 2 3 0 5 
-75 1 0 5 5 3 3 0 1 3 3 2 4 
-75 3 3 1 4 5 1 0 2 3 1 3 0 5 
-65 3 5 3 4 4 2 1 3 5 2 
-60 3 5 0 4 3 2 3 2 1 4 1 
-55 5 0 4 3 4 0 1 3 2 1 4 3 2 
-80 2 3 1 0 4 1 1 0 2 0 0 2 
-75 1 2 1 4 5 1 3 4 5 
-70 0 1 0 5 1 0 3 5 4 0 0 4 3 2 
-45 4 2 0 2 5 3 2 1 2 
-45 5 5 1 2 3 4 0 5 4 
-30 1 4 1 4 4 2 2 5 4 
-40 0 2 5 5 3 0 4 2 4 2 
-60 3 0 2 4 1 4 1 0 0 5 1 4 
-80 0 0 4 1 3 1 2 1 3 0 2 2 
-60 4 5 4 5 0 3 4 0 0 5 1 
-55 1 3 0 3 0 3 2 2 5 5 3 
-50 5 5 1 4 3 2 4 1 5 
-60 3 3 4 3 1 4 3 4 5 4 2 5 
-70 3 2 4 4 0 2 5 4 5 
-50 2 1 1 0 5 1 1 2 5 
10 1 3 1 2 2 2 3 1 1 0 5 1 
-40 0 3 2 2 4 4 2 5 3 0 
-65 2 3 4 2 0 4 1 2 3 2 
-40 3 5 1 2 4 3 0 5 1 1 1 
-55 2 5 1 2 1 2 5 
-55 3 3 5 4 0 5 1 2 0 0 4 0 
-55 3 1 4 5 3 0 0 3 4 5 5 3 
95 5 5 3 3 0 3 0 1 1 0 5 0 5 1 4 0 5 3 4 
-25 2 5 3 2 4 2 2 3 
-55 3 3 2 3 5 1 5 0 3 2 0 
-50 5 4 2 4 0 2 5 5 
-55 3 3 1 2 0 3 4 5 1 3 5 0 
-85 1 1 3 0 3 2 0 2 4 1 5 
-55 2 3 0 3 5 0 5 3 2 4 4 
-40 1 1 1 3 3 4 1 5 4 5 0 1 
-40 0 5 3 0 2 2 4 5 1 2 
-65 4 5 1 3 4 3 4 0 5 4 2 
-40 5 0 4 5 0 1 2 0 2 4 
-85 1 3 2 0 3 4 3 4 2 1 2 
-55 0 5 0 5 5 1 2 3 3 0 2 
-75 1 3 0 1 0 4 4 3 3 2 3 2 4 
-65 1 4 4 4 1 3 0 0 4 3 2 0 3 0 0 0 
-50 0 1 5 0 2 4 3 2 4 3 3 3 1 
-70 4 0 5 0 1 4 2 5 2 
-55 5 2 4 2 5 3 3 3 3 3 2 
-50 1 2 5 0 2 1 5 2 
-70 1 5 5 5 1 0 3 1 2 
-55 4 5 2 4 5 2 5 
-60 0 3 2 1 3 5 2 2 3 4 
-40 1 2 5 0 2 5 1 3 3 1 
-95 5 2 5 4 3 0 0 3 3 0 3 5 
-40 0 3 2 2 0 4 5 1 5 0 
-55 4 5 1 2 1 4 2 5 
-85 0 0 0 2 5 1 3 1 5 2 
-55 4 0 3 5 2 4 0 3 4 5 3 1 
-5 3 0 4 4 5 3 1 4 4 0 3 2 5 2 
-60 2 0 5 4 1 1 3 0 0 5 1 
-65 5 0 4 2 5 0 3 2 5 
-80 4 1 0 0 5 3 1 0 5 4 0 2 
15 2 4 1 1 3 2 3 4 0 2 5 0 2 
-85 3 4 5 5 0 3 2 3 1 5 
-40 4 0 5 3 2 0 5 4 2 0 
-45 4 3 1 4 0 4 2 2 1 1 4 
-50 1 1 4 2 5 1 3 2 5 
-85 3 0 3 4 5 3 5 5 1 2 
-75 3 1 2 2 0 3 0 2 3 3 4 5 
-45 2 2 0 1 5 5 1 3 1 
-60 1 4 0 3 4 2 2 3 0 5 1 
-55 3 0 1 0 0 3 1 4 2 2 2 0 
-75 1 5 5 5 0 2 5 
-75 3 1 5 2 5 2 5 
-60 2 1 3 0 4 1 0 4 0 2 4 5 
-55 3 0 2 3 2 0 4 5 2 3 1 
-50 5 4 0 5 1 5 2 1 
-100 4 3 0 3 3 3 4 2 4 2 0 5 
-75 1 1 1 0 5 0 3 4 3 0 0 4 1 4 
50 2 1 0 5 3 1 3 0 4 3 5 5 5 3 2 
-65 1 0 3 2 2 5 2 3 2 
-55 2 4 4 0 2 0 4 5 3 3 3 0 
-60 1 4 1 1 3 3 0 2 0 4 5 1 
45 3 0 5 4 1 2 1 4 1 1 3 5 3 4 0 1 
-55 5 2 0 3 4 0 4 3 1 0 5 4 
-55 0 2 2 3 3 5 4 5 0 3 0 
-100 0 1 3 5 0 2 0 2 0 3 5 
-40 5 0 5 5 0 3 2 2 3 
-70 1 0 5 4 1 2 0 2 2 
-55 3 1 1 0 2 1 0 1 4 3 0 1 1 0 
-70 1 4 4 5 3 0 2 2 5 
-50 3 0 4 0 3 3 4 2 2 4 3 5 2 
-75 0 1 4 4 1 0 0 3 1 3 0 5 4 1 
-60 5 5 1 3 0 3 4 4 0 5 4 
-50 4 2 1 2 5 2 0 2 
60 1 4 4 4 5 4 5 0 4 3 5 5 0 2 
-25 4 1 5 2 4 5 0 5 1 
-25 5 2 1 5 0 1 5 1 1 
-75 0 0 0 2 3 0 4 0 4 4 1 4 1 1 
-65 2 5 0 4 5 4 1 3 0 2 
-60 2 1 5 3 4 3 0 5 4 0 2 
-75 2 1 5 3 2 2 2 
-45 2 1 5 3 2 2 1 0 1 
-40 2 1 5 3 2 1 3 4 3 4 3 
-45 2 1 5 3 2 1 3 0 2 3 
-40 2 1 5 3 2 1 3 4 0 1 4 
15 2 1 5 3 2 1 3 0 2 5 3 1 
-40 2 1 5 3 2 1 3 0 2 2 
60 2 1 5 3 2 1 3 0 2 5 5 4 
65 2 1 5 3 2 1 3 0 2 5 0 5 3 
110 2 1 5 3 2 1 3 0 2 5 5 5 4 
115 2 1 5 3 2 1 3 0 2 5 5 5 0 3 
170 2 1 5 3 2 1 3 0 2 5 5 5 0 5 0 
285 2 1 5 3 2 1 3 0 2 5 5 5 0 5 0 5 5 3 0 3 5 
300 2 1 5 3 2 1 3 0 2 5 5 5 0 5 0 5 5 0 1 4 
1000659 2 1 5 3 2 1 3 0 2 5 5 5 0 5 0 2 4 3 5 3 3 5 4 
275 2 1 5 3 2 1 3 0 2 5 5 5 0 5 0 2 2 0 2 
1000674 2 1 5 3 2 1 3 0 2 5 5 5 0 5 0 2 2 2 5 0 2 
1000674 2 1 5 3 2 1 3 0 2 5 5 5 0 5 0 2 2 2 5 0 0 
320 2 1 5 3 2 1 3 0 2 5 5 5 0 5 0 2 2 2 4 
320 2 1 5 3 2 1 3 0 2 5 5 5 0 5 0 2 2 2 4 
1000669 2 1 5 3 2 1 3 0 2 5 5 5 0 5 0 2 2 2 5 2 
320 2 1 5 3 2 1 3 0 2 5 5 5 0 5 0 2 2 2 3 
-15 2 1 5 3 2 1 3 0 2 5 5 5 0 5 0 2 2 2 5 0 3 
320 2 1 5 3 2 1 3 0 2 5 5 5 0 5 0 2 2 2 2 
275 2 1 5 3 2 1 3 0 2 5 5 5 0 5 0 2 2 3 
320 2 1 5 3 2 1 3 0 2 5 5 5 0 5 0 2 2 4 4 0 
345 2 1 5 3 2 1 3 0 2 5 5 5 0 5 0 2 2 2 1 
320 2 1 5 3 2 1 3 0 2 5 5 5 0 5 0 2 2 2 4 
320 2 1 5 3 2 1 3 0 2 5 5 5 0 5 0 2 2 2 2 
320 2 1 5 3 2 1 3 0 2 5 5 5 0 5 0 2 2 2 4 
1000669 2 1 5 3 2 1 3 0 2 5 5 5 0 5 0 2 2 2 5 1 
1000669 2 1 5 3 2 1 3 0 2 5 5 5 0 5 0 2 2 2 5 4 
320 2 1 5 3 2 1 3 0 2 5 5 5 0 5 0 2 2 2 0 
1000674 2 1 5 3 2 1 3 0 2 5 5 5 0 5 0 2 2 2 5 0 4 
1000674 2 1 5 3 2 1 3 0 2 5 5 5 0 5 0 2 2 2 5 3 2 
370 2 1 5 3 2 1 3 0 2 5 5 5 0 5 0 2 2 2 5 
320 2 1 5 3 2 1 3 0 2 5 5 5 0 5 0 2 2 2 4 
320 2 1 5 3 2 1 3 0 2 5 5 5 0 5 0 2 2 2 3 
345 2 1 5 3 2 1 3 0 2 5 5 5 0 5 0 2 2 2 4 
1000669 2 1 5 3 2 1 3 0 2 5 5 5 0 5 0 2 2 2 5 1 
320 2 1 5 3 2 1 3 0 2 5 5 5 0 5 0 2 2 5 4 
1000669 2 1 5 3 2 1 3 0 2 5 5 5 0 5 0 2 2 2 5 1 
1000669 2 1 5 3 2 1 3 0 2 5 5 5 0 5 0 2 2 2 5 2 
1000669 2 1 5 3 2 1 3 0 2 5 5 5 0 5 0 2 2 2 5 5 
1000674 2 1 5 3 2 1 3 0 2 5 5 5 0 5 0 2 2 2 5 3 0 
320 2 1 5 3 2 1 3 0 2 5 5 5 0 5 0 2 2 5 3 
320 2 1 5 3 2 1 3 0 2 5 5 5 0 5 0 2 2 2 
1000674 2 1 5 3 2 1 3 0 2 5 5 5 0 5 0 2 2 2 5 0 2 
320 2 1 5 3 2 1 3 0 2 5 5 5 0 5 0 2 2 2 4 
1000669 2 1 5 3 2 1 3 0 2 5 5 5 0 5 0 2 2 2 5 4 
1000674 2 1 5 3 2 1 3 0 2 5 5 5 0 5 0 2 2 2 5 0 1 
320 2 1 5 3 2 1 3 0 2 5 5 5 0 5 0 2 2 2 3 
1000674 2 1 5 3 2 1 3 0 2 5 5 5 0 5 0 2 2 2 5 0 2 
1000674 2 1 5 3 2 1 3 0 2 5 5 5 0 5 0 2 2 2 5 0 1 
1000674 2 1 5 3 2 1 3 0 2 5 5 5 0 5 0 2 2 2 5 0 2 
425 2 1 5 3 2 1 3 0 2 5 5 5 0 5 0 2 2 2 5 0 5 
1000669 2 1 5 3 2 1 3 0 2 5 5 5 0 5 0 2 2 2 5 4 
320 2 1 5 3 2 1 3 0 2 5 5 5 0 5 0 2 2 2 3 
1000674 2 1 5 3 2 1 3 0 2 5 5 5 0 5 0 2 2 2 5 0 2 
275 2 1 5 3 2 1 3 0 2 5 5 5 0 5 0 2 2 3 2 
1000674 2 1 5 3 2 1 3 0 2 5 5 5 0 5 0 2 2 2 5 0 2 
1000669 2 1 5 3 2 1 3 0 2 5 5 5 0 5 0 2 2 2 5 5 
320 2 1 5 3 2 1 3 0 2 5 5 5 0 5 0 2 2 1 4 4 
1000674 2 1 5 3 2 1 3 0 2 5 5 5 0 5 0 2 2 2 5 0 0 
300 2 1 5 3 2 1 3 0 2 5 5 5 0 5 0 2 2 0 1 1 
1000669 2 1 5 3 2 1 3 0 2 5 5 5 0 5 0 2 2 2 5 1 
320 2 1 5 3 2 1 3 0 2 5 5 5 0 5 0 2 2 2 0 
320 2 1 5 3 2 1 3 0 2 5 5 5 0 5 0 2 2 5 2 
1000669 2 1 5 3 2 1 3 0 2 5 5 5 0 5 0 2 2 2 5 1 
320 2 1 5 3 2 1 3 0 2 5 5 5 0 5 0 2 2 2 3 
320 2 1 5 3 2 1 3 0 2 5 5 5 0 5 0 2 2 2 1 
320 2 1 5 3 2 1 3 0 2 5 5 5 0 5 0 2 2 5 4 
1000669 2 1 5 3 2 1 3 0 2 5 5 5 0 5 0 2 2 2 5 1 
320 2 1 5 3 2 1 3 0 2 5 5 5 0 5 0 2 2 2 4 
320 2 1 5 3 2 1 3 0 2 5 5 5 0 5 0 2 2 2 0 
1000669 2 1 5 3 2 1 3 0 2 5 5 5 0 5 0 2 2 2 5 4 
1000674 2 1 5 3 2 1 3 0 2 5 5 5 0 5 0 2 2 2 5 0 0 
280 2 1 5 3 2 1 3 0 2 5 5 5 0 5 0 2 2 0 0 5 
1000669 2 1 5 3 2 1 3 0 2 5 5 5 0 5 0 2 2 2 5 1 
-70 2 1 5 3 2 1 3 0 2 5 5 5 0 5 0 2 2 2 3 
320 2 1 5 3 2 1 3 0 2 5 5 5 0 5 0 2 2 5 0 
1000674 2 1 5 3 2 1 3 0 2 5 5 5 0 5 0 2 2 2 5 0 1 
320 2 1 5 3 2 1 3 0 2 5 5 5 0 5 0 2 2 2 1 
1000669 2 1 5 3 2 1 3 0 2 5 5 5 0 5 0 2 2 2 5 5 
275 2 1 5 3 2 1 3 0 2 5 5 5 0 5 0 2 2 3 5 
300 2 1 5 3 2 1 3 0 2 5 5 5 0 5 0 2 2 3 4 5 
320 2 1 5 3 2 1 3 0 2 5 5 5 0 5 0 2 2 2 3 
275 2 1 5 3 2 1 3 0 2 5 5 5 0 5 0 2 2 3 2 
320 2 1 5 3 2 1 3 0 2 5 5 5 0 5 0 2 2 1 1 3 
320 2 1 5 3 2 1 3 0 2 5 5 5 0 5 0 2 2 2 3 
1000674 2 1 5 3 2 1 3 0 2 5 5 5 0 5 0 2 2 2 5 0 3 
1000674 2 1 5 3 2 1 3 0 2 5 5 5 0 5 0 2 2 2 5 0 4 
1000674 2 1 5 3 2 1 3 0 2 5 5 5 0 5 0 2 2 2 5 0 0 
325 2 1 5 3 2 1 3 0 2 5 5 5 0 5 0 2 2 2 0 
320 2 1 5 3 2 1 3 0 2 5 5 5 0 5 0 2 2 2 3 
1000674 2 1 5 3 2 1 3 0 2 5 5 5 0 5 0 2 2 2 5 0 5 
320 2 1 5 3 2 1 3 0 2 5 5 5 0 5 0 2 2 2 4 
300 2 1 5 3 2 1 3 0 2 5 5 5 0 5 0 2 2 0 1 2 
70 2 1 5 3 2 1 3 0 2 5 5 5 0 5 0 2 2 2 5 0 1 
335 2 1 5 3 2 1 3 0 2 5 5 5 0 5 0 2 2 2 5 0 3 
320 2 1 5 3 2 1 3 0 2 5 5 5 0 5 0 2 2 2 2 
1000674 2 1 5 3 2 1 3 0 2 5 5 5 0 5 0 2 2 2 5 0 0 
1000674 2 1 5 3 2 1 3 0 2 5 5 5 0 5 0 2 2 2 5 0 0 
295 2 1 5 3 2 1 3 0 2 5 5 5 0 5 0 2 2 1 5 
295 2 1 5 3 2 1 3 0 2 5 5 5 0 5 0 2 2 4 5 
1000674 2 1 5 3 2 1 3 0 2 5 5 5 0 5 0 2 2 2 5 0 1 
1000674 2 1 5 3 2 1 3 0 2 5 5 5 0 5 0 2 2 2 5 0 4 
1000669 2 1 5 3 2 1 3 0 2 5 5 5 0 5 0 2 2 2 5 1 
1000674 2 1 5 3 2 1 3 0 2 5 5 5 0 5 0 2 2 2 5 0 3 
320 2 1 5 3 2 1 3 0 2 5 5 5 0 5 0 2 2 2 2 
1000669 2 1 5 3 2 1 3 0 2 5 5 5 0 5 0 2 2 2 5 4 
310 2 1 5 3 2 1 3 0 2 5 5 5 0 5 0 2 2 3 0 0 1 4 
1000669 2 1 5 3 2 1 3 0 2 5 5 5 0 5 0 2 2 2 5 4 
1000669 2 1 5 3 2 1 3 0 2 5 5 5 0 5 0 2 2 2 5 2 
1000674 2 1 5 3 2 1 3 0 2 5 5 5 0 5 0 2 2 2 5 0 2 
320 2 1 5 3 2 1 3 0 2 5 5 5 0 5 0 2 2 2 3 
1000674 2 1 5 3 2 1 3 0 2 5 5 5 0 5 0 2 2 2 5 0 4 
1000669 2 1 5 3 2 1 3 0 2 5 5 5 0 5 0 2 2 2 5 1 
295 2 1 5 3 2 1 3 0 2 5 5 5 0 5 0 2 2 1 
1000669 2 1 5 3 2 1 3 0 2 5 5 5 0 5 0 2 2 2 5 2 
320 2 1 5 3 2 1 3 0 2 5 5 5 0 5 0 2 2 1 4 3 
280 2 1 5 3 2 1 3 0 2 5 5 5 0 5 0 2 2 0 0 5 
295 2 1 5 3 2 1 3 0 2 5 5 5 0 5 0 2 2 4 
320 2 1 5 3 2 1 3 0 2 5 5 5 0 5 0 2 2 2 0 
320 2 1 5 3 2 1 3 0 2 5 5 5 0 5 0 2 2 2 0 
1000669 2 1 5 3 2 1 3 0 2 5 5 5 0 5 0 2 2 2 5 2 
320 2 1 5 3 2 1 3 0 2 5 5 5 0 5 0 2 2 2 1 
320 2 1 5 3 2 1 3 0 2 5 5 5 0 5 0 2 2 4 4 1 
1000674 2 1 5 3 2 1 3 0 2 5 5 5 0 5 0 2 2 2 5 3 1 
1000669 2 1 5 3 2 1 3 0 2 5 5 5 0 5 0 2 2 2 5 1 
70 2 1 5 3 2 1 3 0 2 5 5 5 0 5 0 2 2 2 5 0 5 
280 2 1 5 3 2 1 3 0 2 5 5 5 0 5 0 2 2 0 0 5 
300 2 1 5 3 2 1 3 0 2 5 5 5 0 5 0 2 2 3 1 4 
1000674 2 1 5 3 2 1 3 0 2 5 5 5 0 5 0 2 2 2 5 3 3 
375 2 1 5 3 2 1 3 0 2 5 5 5 0 5 0 2 2 2 5 3 
70 2 1 5 3 2 1 3 0 2 5 5 5 0 5 0 2 2 2 5 0 2 
1000674 2 1 5 3 2 1 3 0 2 5 5 5 0 5 0 2 2 2 5 0 4 
345 2 1 5 3 2 1 3 0 2 5 5 5 0 5 0 2 2 2 4 
1000674 2 1 5 3 2 1 3 0 2 5 5 5 0 5 0 2 2 2 5 0 1 
320 2 1 5 3 2 1 3 0 2 5 5 5 0 5 0 2 2 2 3 
1000669 2 1 5 3 2 1 3 0 2 5 5 5 0 5 0 2 2 2 5 1 
320 2 1 5 3 2 1 3 0 2 5 5 5 0 5 0 2 2 2 2 
1000674 2 1 5 3 2 1 3 0 2 5 5 5 0 5 0 2 2 2 5 0 3 
1000674 2 1 5 3 2 1 3 0 2 5 5 5 0 5 0 2 2 2 5 0 2 
