-5 5 4 0 0 0 2 4 0 4 1 1 5 2 
-20 5 1 3 3 4 3 0 5 0 0 2 5 4 
-60 2 4 0 1 0 0 1 4 4 2 3 4 
-70 3 3 4 5 1 3 0 1 3 2 1 3 1 
-105 5 4 0 3 3 0 3 5 2 2 
-65 3 3 3 4 1 1 1 2 1 1 4 1 
-45 2 5 3 4 4 1 5 4 3 1 
-30 4 2 5 5 5 2 3 
-85 3 5 3 0 1 2 3 1 2 2 
-90 1 0 0 2 2 0 5 4 5 
-95 3 0 4 0 2 5 0 0 0 0 5 1 
-60 1 3 5 0 5 5 2 0 3 2 
-60 2 0 1 5 0 3 5 2 0 1 
-70 3 0 4 1 0 0 3 5 4 5 0 1 1 
-45 1 5 1 0 4 5 1 2 3 4 
-85 5 4 4 4 3 5 4 3 3 0 5 
