0 2 4 4 5 1 2 5 1 2 
-20 2 2 3 6 5 6 2 
-45 3 6 5 4 6 5 6 
-65 2 1 6 2 2 3 
-70 6 6 4 1 3 5 1 
-85 3 4 1 2 2 6 3 
-95 6 4 3 6 5 6 
-95 1 3 4 3 4 6 3 5 2 
-95 3 6 6 5 1 6 
-95 6 6 5 3 4 2 
-100 6 6 5 1 2 
-105 1 4 4 5 5 4 6 
-105 5 1 4 1 5 4 5 
-110 6 3 5 1 5 2 
-110 3 4 2 4 1 6 2 
-120 6 6 5 3 6 
-125 3 3 2 2 6 3 5 
-130 4 4 4 2 1 4 1 
-140 4 3 3 5 2 4 3 3 
-140 6 5 5 3 
-145 1 5 5 3 3 1 2 
-155 2 1 3 6 3 1 
-165 1 1 1 6 2 
-165 3 3 6 6 4 
-180 2 2 4 6 
-180 4 2 2 2 
-205 5 4 1 2 
-205 5 2 2 
-205 2 2 6 
-250 3 2 6 
