45 3 1 6 4 6 5 6 5 2 
45 1 2 2 3 3 1 4 6 5 5 4 
25 4 4 3 5 4 4 2 1 3 1 6 2 
15 1 4 5 1 1 2 3 2 6 1 
10 1 3 5 4 1 6 2 3 6 1 
10 4 3 1 3 1 6 5 2 6 6 
5 6 6 4 1 6 6 6 
5 2 1 4 6 4 3 2 6 4 
5 6 6 2 6 6 2 
0 6 2 3 3 6 2 6 2 
-15 6 3 1 6 6 6 1 
-25 5 4 2 3 2 2 5 2 
-30 4 1 2 5 2 2 4 4 
-30 1 1 1 2 1 4 5 2 2 
-30 2 2 5 4 1 5 1 2 
-35 5 4 6 1 3 4 2 4 6 
-40 1 1 2 6 5 5 4 
-40 1 2 1 5 1 1 6 1 
-45 5 2 4 5 3 1 2 3 1 
-45 5 1 4 3 3 4 1 4 2 1 1 
-45 6 1 4 3 5 6 4 1 
-45 1 3 3 2 4 5 5 2 4 
-50 3 5 6 3 5 4 4 1 3 1 
-50 6 5 1 4 6 4 6 
-50 2 1 4 4 1 4 4 4 3 1 5 
-55 3 5 5 6 4 5 3 1 
-55 6 4 3 3 2 4 2 1 2 
-55 2 3 6 2 1 2 3 2 
-55 4 4 2 5 1 5 1 2 
-55 4 2 5 1 4 4 5 2 
-55 3 6 6 6 5 6 
-55 3 2 2 4 6 3 2 1 
-55 2 5 5 2 1 1 6 
-60 4 6 6 6 4 1 
-60 5 2 4 3 5 6 5 
-60 2 4 1 4 3 5 6 5 
-65 5 3 3 1 4 5 3 4 5 5 
-65 5 1 6 1 3 6 3 1 
-65 1 1 2 6 5 1 6 
-65 6 1 3 4 3 2 6 5 
-65 2 3 1 1 3 1 3 5 5 5 
-65 4 4 3 3 6 3 3 2 5 3 2 
-70 6 3 2 3 4 4 3 1 4 3 5 
-70 4 5 4 1 4 1 3 3 4 1 5 
-75 6 5 6 5 2 
-75 5 2 6 6 2 
-75 3 5 1 4 2 1 5 6 
-75 6 6 1 1 5 5 
-75 6 5 1 6 4 2 
-80 1 1 3 4 3 5 6 4 5 
-80 2 3 4 1 6 3 1 4 6 
-80 2 4 2 4 5 1 6 
-85 3 4 3 3 6 3 3 5 5 3 2 
-85 4 1 2 2 3 6 6 
-85 5 3 2 6 2 5 
-85 6 2 5 1 1 3 6 
-85 1 6 4 3 3 6 3 4 6 
-85 6 6 6 4 2 
-90 2 2 1 4 6 6 
-90 5 3 3 5 4 6 3 3 3 2 
-90 5 6 3 3 6 4 2 
-95 1 4 4 3 3 2 2 1 6 
-100 5 5 3 4 4 2 6 
-100 4 2 5 3 2 1 6 
