-60 2 0 1 5 0 3 5 2 3 1 
-60 2 0 1 5 0 3 5 2 3 4 
-10 2 0 1 5 0 3 5 2 3 5 4 
-60 2 0 1 5 0 3 5 2 0 4 
-60 2 0 1 5 0 3 5 2 0 3 
-10 2 0 1 5 0 3 5 2 0 5 4 
-10 2 0 1 5 0 3 5 2 0 5 1 
40 2 0 1 5 0 3 5 2 0 5 5 3 
150 2 0 1 5 0 3 5 2 0 5 5 5 0 5 0 3 
95 2 0 1 5 0 3 5 2 0 5 5 5 0 1 
95 2 0 1 5 0 3 5 2 0 5 5 5 0 0 
270 2 0 1 5 0 3 5 2 0 5 5 5 0 5 2 4 0 0 1 0 0 1 
95 2 0 1 5 0 3 5 2 0 5 5 5 0 3 
150 2 0 1 5 0 3 5 2 0 5 5 5 0 5 0 1 
145 2 0 1 5 0 3 5 2 0 5 5 5 0 5 1 
260 2 0 1 5 0 3 5 2 0 5 5 5 0 5 0 2 2 0 0 5 
