125 4 5 3 2 1 6 4 1 6 4 6 4 
40 1 5 2 3 5 5 5 6 1 
30 6 2 2 1 5 4 6 3 2 
10 6 6 3 6 6 5 1 
-10 5 6 6 2 6 1 
-15 5 1 5 5 1 4 6 6 
-15 2 2 4 4 5 4 6 4 
-20 2 1 1 2 3 5 4 1 4 3 4 
-25 1 4 2 2 6 6 6 
-25 3 4 1 1 1 2 4 1 1 2 5 
-30 4 2 2 2 4 5 4 4 
-35 6 6 5 1 6 2 
-40 1 1 4 5 6 5 1 4 
-40 4 1 4 6 4 5 4 4 5 
-50 4 6 2 4 6 4 2 
-50 3 3 2 5 2 6 1 3 4 
-50 4 3 2 3 1 4 6 5 3 4 
-55 4 4 2 2 5 4 4 6 
-55 5 2 5 2 5 6 
-60 2 3 3 3 6 6 1 1 5 
-65 6 1 1 2 3 6 3 1 
-65 6 5 1 1 1 5 6 
-65 3 5 2 6 3 6 2 
-75 6 6 4 5 1 2 
-85 3 6 5 3 1 3 6 6 
-90 3 2 3 6 4 6 6 
-90 3 2 6 4 3 6 5 
-95 4 6 4 1 3 6 6 
-100 2 6 1 6 6 
-100 6 1 5 6 6 
-105 2 1 2 1 5 1 
-105 1 1 5 2 2 1 
-115 5 2 6 4 3 
-115 4 4 5 4 6 3 
-115 4 6 2 2 2 
-115 5 2 4 6 1 
-115 1 2 2 6 1 
-115 6 1 2 4 1 3 
-120 2 6 3 6 6 
-125 6 6 4 4 2 
-125 3 1 2 2 5 3 
-125 4 3 1 5 5 1 5 
-125 4 1 4 3 2 5 3 
-125 5 3 1 1 2 1 2 
-125 1 4 2 4 3 5 4 
-125 2 2 3 1 4 1 1 
-130 2 4 5 2 2 
-135 5 6 5 3 1 
-135 4 5 4 3 6 1 
-135 3 1 1 1 4 6 1 
-135 6 5 3 5 2 
-135 2 3 6 2 1 
-140 3 6 4 3 6 2 
-145 4 1 4 5 3 4 3 5 
-150 5 3 3 6 3 4 1 
-150 3 2 4 2 1 2 
-150 3 5 3 6 3 4 2 
-155 4 4 2 4 1 2 
-160 1 6 5 3 5 
-160 6 4 2 3 5 
-160 3 3 1 2 3 5 3 1 
-160 6 4 5 3 2 
-160 3 4 3 3 2 2 3 2 
-165 3 1 3 2 3 4 1 1 
-170 3 4 3 5 2 2 
-175 4 5 2 3 6 
-180 1 1 1 4 4 6 
-190 4 3 1 3 3 2 5 
-190 3 3 1 3 4 2 2 
-195 3 1 4 2 3 6 
