-70 2 4 1 2 1 5 3 3 2 
-80 4 2 5 5 4 1 2 
-150 6 2 5 3 2 5 
-145 4 1 4 6 5 3 4 3 5 
-180 6 5 4 5 6 6 
-175 5 6 4 5 3 6 
-105 5 1 2 4 2 6 
-200 4 6 6 1 1 3 1 2 
-145 4 4 3 3 2 2 6 4 
-130 5 1 1 6 2 1 5 
-280 6 1 6 6 2 
-125 2 1 3 1 1 6 1 4 1 
-180 1 6 6 4 1 2 2 
-145 6 3 3 1 5 2 4 5 
-85 3 2 5 3 4 2 3 4 3 2 
-180 5 4 4 6 6 4 6 
-125 5 2 4 1 6 4 3 3 
-230 6 6 5 1 6 
-70 4 5 4 1 3 3 5 5 4 
-95 5 5 2 3 3 5 6 
-105 2 2 5 2 6 
-100 3 1 3 2 3 4 3 1 3 5 3 2 
-130 2 6 5 4 5 5 
-155 6 4 4 1 5 4 5 
-225 6 3 6 4 2 2 
-155 2 5 5 6 5 
-65 5 3 1 2 3 3 4 1 5 1 
-95 3 3 4 2 4 2 5 2 
-150 2 6 5 3 2 2 
-80 5 1 1 4 2 1 1 2 
-105 1 2 1 4 1 2 6 
-150 4 1 3 5 2 6 5 
-170 1 6 1 4 3 2 3 6 
-160 3 6 6 4 3 2 3 3 5 3 
-230 4 6 6 5 6 
-130 2 6 1 2 2 2 
-55 1 2 6 1 1 5 6 4 4 4 2 
100 2 2 1 2 2 1 3 5 5 5 5 
-155 2 2 6 2 6 
-150 4 4 6 3 2 1 4 2 
-205 4 6 2 6 4 5 
-130 4 6 2 5 5 2 
-155 4 1 1 1 2 6 5 
-265 3 6 1 3 6 3 6 
-125 6 1 5 3 5 2 1 
-125 6 1 2 2 4 4 3 4 
-130 2 2 6 4 5 5 
-95 5 3 2 1 4 4 4 3 2 
-175 1 3 6 1 5 1 6 
-130 5 4 6 1 2 1 5 
-95 4 2 4 4 3 3 2 1 5 
-125 6 5 3 5 5 1 6 
-270 3 4 6 6 6 3 3 
-130 2 1 6 5 2 1 
-130 6 4 5 2 5 2 
0 4 2 1 4 3 1 1 2 1 5 4 
-80 3 4 4 3 3 1 4 4 3 4 2 2 
-145 6 4 5 3 4 2 3 5 
-150 2 5 3 6 1 4 6 
-160 3 1 3 6 4 3 5 4 3 5 
-150 4 5 1 1 4 3 6 5 
-125 3 5 6 1 1 5 4 2 
-200 6 4 6 1 3 5 1 
-205 5 4 6 1 6 5 
