245 5 2 5 1 1 5 4 
225 2 4 4 4 1 4 2 3 5 
210 5 3 2 2 4 0 3 1 5 
215 4 0 4 3 4 2 0 1 4 3 4 2 
200 1 3 3 2 0 3 1 5 4 0 3 4 
235 2 3 5 2 0 3 5 1 3 
210 3 1 0 5 0 3 4 3 0 4 0 5 2 
235 0 1 4 4 4 3 4 5 3 2 3 
