20 6 3 6 1 5 5 6 5 
10 4 2 3 3 5 6 6 5 4 
10 3 2 3 3 5 5 3 4 1 5 5 1 
-15 2 6 1 4 5 4 5 2 
-35 4 1 6 1 4 5 4 4 3 4 
-35 5 4 5 1 3 5 3 6 3 3 
-35 1 4 5 2 6 5 3 2 
-40 6 2 4 4 4 4 2 2 
-40 3 4 5 1 5 3 4 4 5 3 2 
-50 4 6 5 2 6 4 
-50 1 5 4 3 5 5 5 5 
-60 3 3 3 6 4 6 4 2 5 
-65 4 1 1 4 5 6 4 6 
-65 2 6 5 5 1 4 
-65 3 3 2 3 6 5 2 3 3 4 
-65 6 2 4 4 4 3 2 3 5 
-65 2 5 4 5 6 5 
-65 2 2 5 6 4 4 
-70 6 3 6 1 3 3 1 1 1 6 
-70 2 1 1 4 1 1 3 6 6 
-80 2 3 3 3 4 3 6 6 2 
-80 1 6 3 6 6 5 
-80 5 3 1 3 5 4 6 6 
-90 6 5 6 1 3 3 1 
-90 1 3 3 6 1 4 6 2 
-100 1 6 5 6 6 
-105 5 4 5 1 2 6 
-115 5 1 6 4 1 4 
-115 4 2 5 6 2 
-115 6 2 4 4 1 2 
-125 4 5 5 5 3 1 
-125 2 5 4 5 3 2 
-125 5 4 3 4 5 1 3 
-125 3 1 5 4 1 5 5 
-125 2 3 2 4 2 3 
-130 5 2 1 2 2 
-130 4 1 5 2 1 4 
-130 2 1 4 4 1 4 1 
-135 3 2 6 5 2 
-135 2 1 1 3 6 3 
-135 4 5 1 6 3 2 
-135 2 3 6 5 2 
-135 3 6 4 4 4 4 6 
-135 5 5 3 6 1 
-140 1 1 2 6 2 
-140 4 1 6 1 4 4 
-140 1 6 1 2 2 
-145 1 4 3 3 2 2 1 
-145 1 3 6 6 2 
-145 3 3 5 4 2 4 2 
-145 4 2 2 3 4 3 2 
-145 5 2 3 3 2 2 
-150 1 3 4 1 4 2 1 
-150 3 1 2 4 2 2 
-150 6 1 6 2 
-150 3 2 1 4 5 2 
-150 4 6 6 2 
-150 4 3 1 1 1 2 2 
-150 4 2 1 4 3 1 1 
-155 3 3 6 1 4 1 1 
-155 3 6 3 1 2 2 
-155 6 3 2 1 3 1 
-160 1 6 3 2 2 
-160 1 3 6 5 5 
-165 3 1 2 3 3 5 4 
-170 3 3 6 1 3 3 4 6 
-175 3 6 1 1 3 3 2 
-190 3 3 4 3 5 1 5 
-195 3 1 1 5 3 6 
-215 1 4 1 3 3 3 6 
