255 2 0 1 5 0 3 5 2 0 5 5 5 0 5 5 3 5 3 0 2 
95 2 0 1 5 0 3 5 2 0 5 5 5 0 1 
40 2 0 1 5 0 3 5 2 0 5 5 3 
40 2 0 1 5 0 3 5 2 0 5 5 3 
90 2 0 1 5 0 3 5 2 0 5 5 5 4 
40 2 0 1 5 0 3 5 2 0 5 5 3 
90 2 0 1 5 0 3 5 2 0 5 5 5 5 
285 2 0 1 5 0 3 5 2 0 5 5 5 0 5 2 4 2 3 3 0 
280 2 0 1 5 0 3 5 2 0 5 5 5 0 5 2 4 0 0 5 4 
260 2 0 1 5 0 3 5 2 0 5 5 5 0 5 2 4 0 0 1 0 5 
265 2 0 1 5 0 3 5 2 0 5 5 5 0 5 2 4 0 0 1 0 0 4 
255 2 0 1 5 0 3 5 2 0 5 5 5 0 5 2 4 0 0 1 5 
265 2 0 1 5 0 3 5 2 0 5 5 5 0 5 2 4 0 0 1 0 0 2 
265 2 0 1 5 0 3 5 2 0 5 5 5 0 5 2 4 0 0 1 0 0 2 
265 2 0 1 5 0 3 5 2 0 5 5 5 0 5 2 4 0 0 1 0 0 4 
1000619 2 0 1 5 0 3 5 2 0 5 5 5 0 5 2 4 0 0 0 4 0 5 4 
