-60 0 1 1 3 3 0 1 5 4 1 0 4 3 0 3 3 
-85 5 4 1 3 0 3 5 5 3 5 
-85 0 2 5 5 3 4 3 3 4 2 
-45 3 1 1 2 2 2 5 0 1 
-90 1 1 2 0 3 1 0 4 3 3 0 0 1 0 5 
-60 5 2 1 0 0 4 4 2 0 0 4 
-60 3 3 3 4 3 5 5 5 5 1 
-70 2 1 5 0 0 5 5 5 
-45 5 4 1 4 0 3 4 1 2 1 2 
-50 1 1 2 4 0 2 2 1 2 
-55 5 0 1 4 3 2 1 3 1 4 0 0 2 
10 2 5 4 1 3 4 4 5 3 3 5 1 
-60 1 5 4 0 4 5 3 5 0 3 2 
-75 3 1 4 3 4 4 3 5 3 3 4 1 0 5 
-55 4 3 1 1 2 3 3 3 5 4 3 4 2 
-5 1 1 2 0 2 3 0 1 3 0 5 5 4 
