175 0 3 0 1 4 1 0 2 1 3 2 
215 3 0 0 2 2 4 5 3 4 5 
230 3 0 2 2 5 1 2 1 
200 2 4 0 2 1 4 4 5 
230 1 3 1 2 2 5 0 4 1 
205 3 2 4 3 1 2 2 5 
230 3 0 4 1 1 1 4 2 2 5 
200 1 5 1 5 3 2 2 
