230 3 5 3 2 1 4 4 5 4 
175 3 3 0 4 1 4 4 1 3 3 0 1 2 
215 3 3 3 3 4 1 3 3 3 1 4 1 2 3 4 
235 0 0 5 3 2 5 2 4 2 
205 3 0 0 0 0 2 2 3 5 3 1 2 
210 0 3 5 0 5 2 2 2 
235 3 2 3 2 0 5 1 5 1 
200 1 1 4 3 5 0 0 2 3 0 0 5 
