275 2 0 1 5 0 3 5 2 0 5 5 5 0 5 2 1 1 3 1 2 
1000624 2 0 1 5 0 3 5 2 0 5 5 5 0 5 2 4 3 1 0 3 0 5 3 1 
235 2 0 1 5 0 3 5 2 0 5 5 5 0 5 2 4 0 3 3 2 
255 2 0 1 5 0 3 5 2 0 5 5 5 0 5 2 4 0 0 1 5 
295 2 0 1 5 0 3 5 2 0 5 5 5 0 5 2 4 5 1 1 
280 2 0 1 5 0 3 5 2 0 5 5 5 0 5 2 4 0 3 2 0 
280 2 0 1 5 0 3 5 2 0 5 5 5 0 5 2 4 5 0 3 3 
295 2 0 1 5 0 3 5 2 0 5 5 5 0 5 2 2 1 1 4 
260 2 0 1 5 0 3 5 2 0 5 5 5 0 5 2 4 0 0 0 4 5 
265 2 0 1 5 0 3 5 2 0 5 5 5 0 5 2 4 0 0 0 1 0 0 
1000619 2 0 1 5 0 3 5 2 0 5 5 5 0 5 2 4 0 0 0 4 0 5 3 5 
260 2 0 1 5 0 3 5 2 0 5 5 5 0 5 2 4 0 0 0 4 4 
260 2 0 1 5 0 3 5 2 0 5 5 5 0 5 2 4 0 0 0 4 2 
245 2 0 1 5 0 3 5 2 0 5 5 5 0 5 2 4 0 0 0 3 0 2 
1000619 2 0 1 5 0 3 5 2 0 5 5 5 0 5 2 4 0 0 0 4 0 5 0 3 
1000614 2 0 1 5 0 3 5 2 0 5 5 5 0 5 2 4 0 0 0 4 0 5 4 
