215 1 0 3 1 5 3 1 3 5 1 1 
190 4 5 0 1 3 0 0 4 4 4 5 
250 4 1 3 5 2 5 5 4 
235 5 0 1 5 2 1 0 4 3 2 
225 0 1 0 4 5 2 1 4 0 3 0 
215 1 0 4 0 5 1 3 1 3 2 4 
220 2 0 5 0 0 1 2 3 4 0 3 
225 1 2 5 5 0 2 2 
