270 2 0 1 5 0 3 5 2 0 5 5 5 0 5 2 2 1 5 
275 2 0 1 5 0 3 5 2 0 5 5 5 0 5 2 4 5 0 4 
285 2 0 1 5 0 3 5 2 0 5 5 5 0 5 2 4 0 0 5 1 
95 2 0 1 5 0 3 5 2 0 5 5 5 0 0 
260 2 0 1 5 0 3 5 2 0 5 5 5 0 5 2 4 0 3 4 2 
280 2 0 1 5 0 3 5 2 0 5 5 5 0 5 2 4 0 1 4 2 
260 2 0 1 5 0 3 5 2 0 5 5 5 0 5 2 4 0 0 1 0 4 
265 2 0 1 5 0 3 5 2 0 5 5 5 0 5 2 4 0 0 0 4 0 1 
1000619 2 0 1 5 0 3 5 2 0 5 5 5 0 5 2 4 0 0 0 4 0 5 2 
265 2 0 1 5 0 3 5 2 0 5 5 5 0 5 2 4 0 0 0 4 0 3 
1000619 2 0 1 5 0 3 5 2 0 5 5 5 0 5 2 4 0 0 0 4 0 5 2 
265 2 0 1 5 0 3 5 2 0 5 5 5 0 5 2 4 0 0 0 4 0 1 
1000619 2 0 1 5 0 3 5 2 0 5 5 5 0 5 2 4 0 0 0 4 0 5 4 
1000619 2 0 1 5 0 3 5 2 0 5 5 5 0 5 2 4 0 0 0 4 0 5 1 
235 2 0 1 5 0 3 5 2 0 5 5 5 0 5 2 4 0 0 0 5 
270 2 0 1 5 0 3 5 2 0 5 5 5 0 5 2 4 0 0 0 4 0 0 
