295 2 4 3 2 3 2 6 6 4 5 6 6 5 4 4 
85 3 3 6 3 2 6 3 4 6 5 5 5 
55 5 6 6 5 4 3 5 5 4 
10 2 4 4 5 1 3 6 3 6 1 
5 5 6 6 5 4 5 3 6 
0 4 6 6 4 1 4 1 5 6 
0 3 4 5 5 3 2 6 5 3 1 
-5 3 6 2 4 3 1 3 1 4 3 6 3 
-25 2 5 4 2 4 1 1 1 3 1 
-25 5 2 1 3 4 4 4 2 4 6 
-30 4 2 2 2 2 5 4 
-30 2 5 4 2 5 5 1 
-30 2 2 1 2 1 4 2 4 
-35 4 5 3 2 1 6 2 1 
-35 2 2 6 1 1 1 3 4 3 
-35 5 4 5 2 6 1 3 2 
-40 4 1 1 4 5 6 5 2 
-40 6 5 1 1 1 1 5 1 
-40 5 4 3 3 2 1 4 4 3 4 4 2 
-45 6 5 4 5 3 6 3 
-45 4 2 2 6 6 3 3 
-45 5 3 6 6 5 4 4 
-50 1 4 4 5 3 1 2 2 1 
-50 6 3 2 5 3 1 3 2 4 
-50 4 1 1 3 4 5 2 5 4 
-55 4 6 2 2 3 2 3 4 
-55 3 6 1 6 6 4 1 
-55 4 5 6 5 5 3 3 2 
-55 6 6 5 3 6 1 
-55 3 5 1 2 5 6 3 4 
-55 3 1 4 6 4 1 1 2 3 1 
-60 6 4 6 4 6 1 
-60 4 6 3 2 5 5 5 
-60 6 4 6 1 6 4 
-60 3 1 2 4 1 2 6 4 
-60 3 2 1 4 4 2 6 4 
-60 6 4 6 4 3 3 1 3 1 4 
-65 6 1 3 3 3 5 4 5 3 3 3 
-65 2 5 3 3 5 4 4 1 3 5 
-65 5 6 1 5 5 2 
-65 1 5 5 5 6 2 
-65 4 5 2 4 4 6 6 
-70 2 5 2 3 3 4 2 6 
-70 1 6 3 6 2 4 5 
-75 1 1 2 5 3 1 2 5 
-75 1 2 1 3 4 5 4 4 5 
-75 2 4 4 2 1 4 3 1 6 
-75 3 1 6 3 4 1 5 4 3 2 
-75 3 2 4 1 1 5 2 6 
-75 5 4 2 4 3 1 2 6 
-75 2 5 2 1 3 5 6 
-80 1 3 6 3 2 3 3 6 5 
-80 1 3 2 3 5 1 6 2 
-80 5 2 5 3 3 6 2 
-80 5 1 4 5 5 4 6 
-85 3 3 4 4 3 6 1 6 2 
-95 6 6 3 4 5 6 
-95 4 3 3 3 5 3 4 6 4 5 
-95 5 4 4 3 2 2 3 6 
-100 4 6 2 6 6 
-100 1 6 2 6 6 
-105 3 5 3 4 5 6 6 
-110 5 6 4 1 4 3 6 
-110 6 6 6 6 
