65 5 4 1 5 6 5 3 5 5 1 
60 6 1 3 3 1 2 1 5 6 5 1 
60 3 6 2 3 1 5 5 6 5 3 
50 6 5 5 1 6 5 5 1 
35 1 5 4 6 3 3 2 1 6 4 1 
25 1 2 5 3 1 4 2 5 5 6 
25 1 4 2 5 3 1 5 2 5 1 
20 4 1 6 2 3 2 2 5 3 1 
20 2 2 5 3 2 3 5 6 2 
15 2 2 2 5 2 3 6 1 
15 3 1 6 1 5 1 5 1 5 6 
5 5 6 1 4 3 5 4 6 1 
5 1 5 6 1 1 6 5 3 4 
0 6 6 4 3 5 3 1 6 1 
-25 4 4 3 4 5 1 5 2 4 1 
-25 2 2 4 2 3 1 4 2 4 
-25 1 5 3 2 5 5 2 3 
-30 4 5 1 4 2 5 1 4 2 
-30 1 4 5 4 2 5 5 2 
-35 2 1 2 3 6 5 1 2 
-35 6 5 4 1 5 2 3 1 
-35 3 5 2 6 1 5 4 6 
-35 6 2 2 3 5 5 4 
-35 2 4 1 6 4 1 3 4 1 3 
-35 2 4 1 3 2 6 5 4 
-45 6 5 3 2 1 6 1 
-50 4 3 5 1 3 3 5 2 3 3 1 2 
-50 2 4 5 5 3 3 6 3 4 
-50 5 6 2 4 6 2 
-50 1 2 5 2 6 3 3 3 3 
-50 3 3 2 1 3 3 2 2 4 3 4 4 
-50 6 1 6 1 1 2 4 
-50 4 5 5 3 4 4 2 4 2 
-50 4 1 1 5 1 2 5 3 2 
-50 6 5 4 2 6 2 
-55 5 4 5 5 1 2 2 
-55 5 2 2 4 2 1 2 
-55 1 3 3 5 6 2 1 1 2 
-55 5 1 3 2 3 5 6 2 
-55 4 2 1 5 5 5 2 
-55 6 3 5 5 3 4 2 2 
-55 3 5 2 2 6 3 4 4 
-60 1 6 3 1 2 4 1 1 5 
-60 3 5 2 1 6 1 1 5 
-60 1 6 4 4 3 1 4 2 5 
-60 2 2 4 5 3 6 2 
-60 4 3 3 6 6 1 4 1 3 3 
-65 5 6 5 1 5 2 
-70 3 2 6 1 3 1 3 1 3 4 2 
-70 3 4 5 6 6 4 5 
-75 6 5 3 3 3 2 5 6 
-75 5 1 2 1 3 4 2 6 
-75 6 5 2 6 2 
-75 1 1 4 3 3 1 3 6 5 2 
-75 3 1 2 3 3 5 6 4 2 
-80 2 1 6 5 3 1 3 5 
-80 1 3 3 6 1 5 5 2 
-85 2 6 1 3 1 5 6 
-85 3 6 2 2 4 4 6 
-85 3 3 3 2 3 4 3 3 6 5 2 
-95 2 4 3 1 1 3 1 2 6 
-100 6 4 3 3 4 4 4 1 3 6 
-100 4 6 6 2 6 
-100 6 6 4 5 6 
