-125 2 4 2 3 6 2 1 
-100 6 1 1 3 2 2 2 1 
-145 3 5 6 1 3 1 2 5 
-150 1 3 4 6 5 5 6 
-50 2 1 5 1 5 1 4 3 6 2 
-255 5 6 6 6 4 
-200 6 2 3 6 2 5 
-105 4 4 5 2 6 5 4 
-175 3 6 6 5 1 2 2 
-45 3 1 2 5 2 1 5 3 4 
-120 3 5 5 6 1 3 2 1 
-125 3 6 5 4 5 4 4 4 
-145 1 3 6 4 5 3 5 2 
-195 5 4 6 6 3 4 3 4 
-30 5 1 6 2 4 5 5 4 2 
0 2 4 4 1 2 2 4 1 6 4 2 
-170 6 3 4 4 4 3 5 6 
-105 6 4 4 1 4 4 2 4 6 6 
-125 6 5 2 5 1 3 4 
-125 5 2 3 1 1 6 3 3 3 3 4 
-50 1 1 1 5 3 2 6 4 5 1 
-145 5 6 5 3 3 5 5 
-125 2 1 3 4 4 5 6 2 
-130 5 1 4 6 1 5 2 
-25 2 2 3 4 1 4 2 1 1 2 
-205 4 2 1 6 6 5 
-30 5 2 1 6 2 1 5 4 6 
-30 5 1 1 2 1 4 4 5 3 
-180 5 6 4 1 6 4 4 
-145 5 1 6 3 4 2 3 2 
-50 4 2 3 1 1 2 6 1 5 1 
-25 1 5 4 5 5 3 1 4 1 3 
-120 3 5 1 6 6 5 5 3 1 
-145 3 2 3 6 1 1 1 1 2 
80 2 1 4 5 5 2 3 1 5 5 6 
-115 6 3 1 3 4 2 5 3 4 3 
-195 6 2 6 3 4 3 1 6 6 
-180 6 6 5 1 1 4 3 
-250 6 5 3 6 6 6 
-125 2 5 5 4 6 3 5 
15 2 5 3 4 5 4 3 5 5 3 4 
-120 3 3 5 6 5 1 2 1 
-215 6 3 6 3 1 5 3 5 
-120 3 6 5 2 3 2 4 2 
-225 3 6 5 6 4 6 
-130 6 2 5 5 1 2 
-45 4 5 3 1 5 1 2 3 1 5 
-230 2 1 6 6 6 
-35 3 3 4 4 5 5 4 5 1 3 6 
-110 6 1 4 3 1 4 2 3 3 4 4 
-50 2 1 1 3 5 2 6 5 2 
-170 3 5 2 6 1 3 6 
-130 1 2 5 6 5 2 
-75 1 4 2 4 3 2 6 6 5 4 
-105 5 1 1 6 5 4 1 6 
15 2 3 5 5 1 3 5 4 3 5 4 
-55 5 1 5 5 5 4 2 
-30 1 2 5 2 5 5 2 
-180 4 6 6 4 4 2 1 
-105 1 1 5 1 6 4 4 1 3 
-40 2 4 4 3 5 6 1 1 5 3 6 
-20 4 5 4 2 1 1 3 1 1 4 3 
-50 1 1 5 3 4 2 4 2 1 
-55 1 5 4 1 1 1 2 1 5 
