295 2 0 1 5 0 3 5 2 0 5 5 5 0 5 2 5 2 0 
95 2 0 1 5 0 3 5 2 0 5 5 5 0 2 
150 2 0 1 5 0 3 5 2 0 5 5 5 0 5 3 3 
280 2 0 1 5 0 3 5 2 0 5 5 5 0 5 2 4 0 4 4 4 
235 2 0 1 5 0 3 5 2 0 5 5 5 0 5 2 4 0 0 0 2 
285 2 0 1 5 0 3 5 2 0 5 5 5 0 5 2 4 0 0 1 1 0 
260 2 0 1 5 0 3 5 2 0 5 5 5 0 5 2 4 0 0 1 0 2 
270 2 0 1 5 0 3 5 2 0 5 5 5 0 5 2 4 0 0 1 0 0 1 
270 2 0 1 5 0 3 5 2 0 5 5 5 0 5 2 4 0 0 0 4 0 4 
265 2 0 1 5 0 3 5 2 0 5 5 5 0 5 2 4 0 0 0 4 2 
260 2 0 1 5 0 3 5 2 0 5 5 5 0 5 2 4 0 0 0 4 5 
1000619 2 0 1 5 0 3 5 2 0 5 5 5 0 5 2 4 0 0 0 4 0 5 4 
270 2 0 1 5 0 3 5 2 0 5 5 5 0 5 2 4 0 0 0 4 0 0 
1000619 2 0 1 5 0 3 5 2 0 5 5 5 0 5 2 4 0 0 0 4 0 5 2 
270 2 0 1 5 0 3 5 2 0 5 5 5 0 5 2 4 0 0 0 4 0 4 
1000619 2 0 1 5 0 3 5 2 0 5 5 5 0 5 2 4 0 0 0 4 0 5 4 
