-45 1 3 2 3 4 1 1 5 5 1 
-105 6 1 5 2 2 4 6 4 
-145 4 4 4 1 3 3 6 2 6 
-145 3 6 2 2 5 3 2 
-165 3 5 3 6 5 3 4 6 
-160 3 6 3 4 3 5 3 4 4 5 
-105 2 4 4 6 5 1 4 6 3 
-105 2 4 6 4 5 1 1 6 5 
-175 1 3 6 2 5 6 
-195 1 5 3 3 6 1 6 4 
-130 4 2 2 2 6 2 
-195 4 4 6 5 6 3 3 3 
-55 1 5 1 1 1 2 2 1 
-150 3 6 2 5 5 2 
-50 1 3 1 2 5 2 5 1 
-105 4 2 1 5 1 1 6 3 
-120 4 4 4 5 6 1 3 4 3 2 
-125 1 3 6 5 5 4 4 1 
-145 1 1 3 4 4 3 6 6 5 6 3 
-75 3 5 5 2 4 2 2 
-145 2 5 6 2 3 3 6 
-90 2 4 5 3 5 3 3 4 6 
-180 4 4 6 1 1 4 6 4 
-130 5 6 5 5 1 5 
-245 4 3 1 3 6 6 6 
-220 4 6 2 6 3 3 5 
-10 2 1 3 3 3 1 3 1 2 2 5 2 
-145 5 3 5 6 2 3 6 
-180 1 4 5 6 1 6 2 
20 6 2 1 1 2 5 5 5 4 6 
-130 6 2 2 1 4 1 5 
-125 1 2 6 5 3 2 2 
-145 3 2 1 3 6 1 1 4 6 
-130 6 2 4 5 2 5 
-70 4 4 3 2 2 4 2 3 5 
-130 6 5 5 6 1 5 6 6 
-150 2 5 3 6 5 2 
-105 1 5 1 1 6 2 1 2 
-145 6 3 5 6 3 2 5 6 4 
-70 5 2 6 3 2 1 3 5 1 
-100 2 5 5 3 2 6 
-105 2 4 2 4 5 6 4 
5 5 3 4 5 5 4 5 5 3 6 3 
-180 6 5 5 6 1 6 6 
-75 5 2 4 2 5 3 2 
-205 5 6 6 6 5 1 
-15 5 6 1 5 3 4 4 3 5 5 2 
-50 5 1 1 3 5 2 5 4 
-255 6 1 6 6 4 3 
-195 6 6 3 2 1 4 3 2 
-125 6 2 2 5 4 3 5 
-150 4 1 2 1 6 1 3 6 
-130 4 6 2 2 5 6 
-90 3 3 2 1 4 3 4 5 1 2 
-180 2 6 4 4 6 4 2 
-105 5 4 2 6 4 5 6 4 
-225 1 3 6 6 4 1 5 
35 2 4 3 5 3 2 4 5 5 4 2 
-215 6 3 2 3 4 6 3 5 
-120 3 6 5 2 1 2 3 4 
-50 2 5 4 3 4 2 2 2 
-25 4 1 5 5 4 4 5 6 4 6 
-140 3 5 2 6 3 4 4 3 5 
-105 1 5 4 2 5 6 3 
