-60 0 1 4 1 3 3 3 2 5 2 5 
-70 3 4 3 3 3 3 4 0 2 3 2 2 4 
-70 3 4 2 2 1 5 3 4 2 
-75 5 3 3 3 1 4 1 3 0 2 1 3 5 
-40 2 0 5 3 3 1 1 2 2 4 
-65 3 2 2 3 4 0 2 2 2 
25 5 1 2 5 0 2 1 1 5 4 
0 4 1 2 0 3 1 3 0 2 1 3 4 5 0 0 
-40 2 3 0 1 1 1 1 2 5 0 2 
-45 1 3 1 4 2 5 0 5 1 4 
-40 0 5 4 2 1 5 1 3 3 1 4 
10 1 1 2 0 5 0 3 5 2 5 2 
-115 3 4 3 3 0 2 1 3 0 3 0 2 2 
5 5 3 4 2 1 3 4 0 0 3 5 5 3 3 1 
-65 5 5 3 0 5 1 1 4 3 2 
-75 4 3 4 2 2 4 4 1 5 
-80 2 3 0 0 4 0 4 5 3 2 5 
-75 4 1 4 5 5 2 3 5 
-85 0 1 0 0 2 0 1 2 5 5 
-80 2 1 0 0 3 4 3 5 5 3 2 
30 4 3 0 0 5 3 3 3 2 5 1 0 5 5 2 
-40 0 1 1 0 5 3 5 2 2 2 
-80 1 3 2 1 3 0 0 4 5 4 0 5 
-25 2 2 2 5 0 5 1 0 
-55 5 1 2 1 2 5 5 
-45 3 4 1 5 5 3 4 4 4 1 2 
20 2 1 5 5 4 2 4 5 2 
-45 5 4 3 0 1 1 4 5 2 1 
5 2 0 1 1 4 4 4 3 5 1 5 2 
-40 0 2 1 1 5 5 3 0 5 4 
-5 0 0 1 4 5 5 0 1 5 3 3 5 4 
-45 1 5 4 5 3 3 5 5 4 
-25 1 0 1 2 2 1 2 2 3 
15 5 4 1 2 0 0 5 3 2 5 0 0 
-65 4 5 3 2 2 5 0 3 2 
-75 5 3 5 0 5 1 3 4 0 0 3 5 
-45 1 5 2 3 2 1 1 1 0 4 
-85 2 0 4 0 2 0 1 3 2 5 
-15 3 0 1 3 0 4 3 2 4 1 3 3 4 1 5 3 2 
-75 5 5 5 4 2 0 5 
-70 1 5 5 0 1 0 1 4 1 2 
-65 5 1 5 3 5 0 5 3 5 
-55 0 5 0 1 3 1 1 3 4 4 3 5 0 
-40 4 2 2 1 0 5 3 4 1 3 2 
-85 2 2 2 3 1 3 1 0 0 5 
-50 1 2 5 5 1 3 2 2 
15 3 4 2 1 2 2 5 3 5 0 0 3 
-80 3 0 1 1 1 5 1 3 3 4 4 3 5 
-40 5 4 2 0 1 5 3 5 3 4 
-55 0 2 0 2 5 3 3 2 1 3 2 
-5 0 3 3 2 3 4 5 2 2 3 5 2 
-5 1 3 1 1 1 0 4 0 2 0 3 5 5 4 
-70 2 3 4 4 4 4 4 1 4 3 5 
-85 5 3 4 5 1 3 3 1 4 3 2 
-45 3 1 1 2 4 1 2 2 0 4 
-45 1 1 0 5 2 3 2 1 4 1 
-70 1 1 1 3 1 4 1 1 3 2 5 
-40 4 3 1 4 1 0 4 4 5 5 3 4 
-85 2 2 2 3 0 2 3 3 5 
-75 4 3 1 3 5 3 4 5 0 3 1 0 5 
-40 3 5 0 4 4 5 5 0 1 4 4 
-65 3 1 3 4 1 5 0 1 4 2 2 
-25 2 4 2 5 2 0 2 3 
-55 2 4 1 5 2 5 5 
-55 4 5 0 2 2 3 0 3 1 0 4 0 
-40 5 1 5 3 4 1 2 3 4 3 1 
-45 1 3 0 2 5 2 2 4 4 
-45 3 5 4 4 5 4 5 3 1 2 
-70 3 0 5 5 0 3 0 1 3 3 1 2 2 
-55 1 3 2 3 5 1 1 2 0 0 3 2 
-30 2 2 5 5 1 1 1 0 
-40 4 0 3 1 1 5 1 5 4 0 1 1 
-40 0 2 0 1 1 0 5 2 2 0 
-70 5 1 3 2 2 2 3 5 
-55 1 2 0 0 3 0 1 2 3 4 4 4 4 
-45 4 1 5 1 4 5 3 0 2 4 
-75 1 2 0 1 1 5 4 3 0 0 0 0 1 
-50 1 2 2 2 4 3 5 2 
-85 2 5 3 0 4 3 3 3 3 1 3 0 4 0 1 
-75 3 5 5 4 4 2 4 5 
-85 3 3 3 5 1 2 1 0 2 5 
-30 2 2 2 2 2 1 4 
-80 3 3 1 3 5 5 4 2 3 0 2 
-40 2 3 2 2 5 0 4 4 0 2 
-50 2 4 4 1 2 2 3 1 2 
-50 5 5 2 2 3 2 1 
-45 5 3 2 5 4 3 2 4 2 
-40 5 2 3 0 2 1 1 1 0 1 2 
-55 5 2 4 0 5 0 4 3 3 0 4 2 
-45 4 3 2 5 3 5 1 4 4 2 
-55 1 1 3 5 3 2 3 4 4 0 4 3 4 
30 2 5 1 4 4 0 2 0 3 3 0 5 0 3 4 1 
-55 0 0 3 4 2 4 0 1 3 2 2 0 
-65 0 5 0 5 5 0 1 2 5 
-40 3 1 5 5 1 1 2 1 3 0 2 
-70 4 1 4 2 2 0 5 3 2 
-75 3 3 2 2 0 1 0 0 5 3 1 4 
-45 5 1 0 5 4 4 2 4 0 4 
-50 5 1 2 2 1 3 4 1 4 
-55 5 3 0 2 5 0 0 3 1 4 4 0 
45 1 3 0 5 5 2 0 3 2 3 5 4 4 4 
-100 4 4 3 0 3 4 4 2 1 0 3 0 5 
-80 0 4 0 0 2 3 4 2 5 3 5 
-70 4 1 4 0 4 4 0 2 1 4 2 
-50 1 5 5 5 0 2 1 2 
-40 2 5 0 4 0 2 3 2 4 0 
-40 3 1 4 0 2 5 2 5 3 4 
-60 3 1 0 5 4 2 3 5 3 4 2 
-5 0 4 3 1 0 5 5 3 0 5 1 5 2 
-85 3 1 0 4 4 4 5 3 5 3 2 
-65 1 4 3 5 0 1 5 5 0 5 
-85 5 2 3 3 3 2 0 4 4 2 
-40 2 2 5 5 0 0 0 1 4 3 
-60 3 0 1 1 5 3 4 0 5 2 5 
-65 4 3 5 0 0 2 2 2 5 
-85 4 1 3 2 0 0 4 3 0 3 5 3 3 3 4 
-55 2 0 0 5 3 0 1 0 2 2 3 
-45 0 5 5 2 1 3 2 4 2 
0 0 2 3 2 3 0 4 2 4 1 5 0 0 3 
-70 5 1 1 2 1 0 0 2 5 
-85 2 3 3 0 4 4 3 3 0 2 3 1 0 3 2 
-60 5 4 2 4 3 3 5 3 0 1 1 
-85 4 5 3 3 5 2 0 0 1 2 
-55 4 2 1 2 4 5 4 2 
-90 3 1 3 0 3 2 3 0 2 4 1 3 3 5 
-60 0 5 3 3 1 5 1 1 0 5 5 
-60 0 4 0 1 2 1 1 4 0 5 0 2 
-55 2 0 0 2 0 2 1 3 2 0 1 
-65 0 3 0 4 5 1 2 4 2 2 
-45 1 5 3 4 5 1 0 1 5 4 
-40 3 1 5 3 5 4 2 3 1 1 4 
-65 0 5 3 5 4 0 2 4 4 2 
-70 3 3 1 2 4 5 1 4 1 2 
-45 0 2 5 3 4 4 2 2 4 
-15 3 1 3 0 5 0 0 3 4 0 0 5 2 5 2 
-75 0 0 1 3 2 3 5 4 4 1 0 0 2 
10 0 1 2 3 5 3 4 2 4 1 5 2 
-50 2 1 4 4 3 5 4 5 2 
60 4 0 1 1 4 3 3 5 4 5 4 5 5 4 
-65 5 3 3 4 4 1 5 1 0 1 2 
-60 4 5 3 4 2 1 0 0 0 5 2 
-45 1 0 1 2 1 2 1 3 2 1 
-60 3 4 5 2 5 0 0 5 0 2 
-75 2 3 3 3 1 3 2 5 3 3 4 1 
-55 2 4 1 1 4 5 2 2 
10 1 4 0 5 5 2 1 0 4 5 3 1 
-25 5 2 5 2 1 3 1 1 3 
-50 5 0 5 1 4 5 2 4 
-55 0 3 1 4 2 3 2 0 0 5 4 3 
-85 2 4 3 1 4 3 0 3 2 4 5 
-70 3 0 0 1 1 1 0 0 4 5 3 3 5 0 
-40 3 2 4 0 4 1 0 1 2 2 1 
-40 5 2 0 3 0 4 5 1 4 1 4 
-55 4 2 2 2 4 2 2 
-85 1 2 4 3 0 0 2 3 5 5 
-30 2 5 4 2 2 5 4 
-85 2 4 5 2 0 3 0 0 4 5 
-55 1 3 3 0 2 3 3 5 5 2 3 
20 1 5 5 5 2 1 4 5 4 
-75 3 1 4 5 1 5 2 5 
-65 0 5 1 4 3 0 3 3 3 3 2 4 0 1 2 
-40 5 0 4 3 1 1 3 5 2 4 4 
-55 5 3 0 2 0 0 5 0 2 1 0 
-70 0 1 1 3 0 5 3 1 3 5 0 1 3 4 
-40 2 3 3 0 1 4 4 5 5 1 0 
-100 3 0 3 2 5 4 4 1 3 0 0 5 
15 0 0 5 5 0 2 1 5 4 5 3 0 
-45 5 0 3 1 4 1 5 1 4 1 2 
-65 3 3 0 4 1 3 5 0 3 2 0 2 0 1 
-55 4 1 2 0 3 2 1 3 3 3 1 1 4 
-50 4 5 3 1 5 4 4 1 4 4 
-55 0 2 3 0 2 0 1 0 5 2 2 
-60 3 2 2 2 0 4 3 2 0 1 
-90 5 3 1 3 0 1 0 3 0 3 1 3 2 2 
-85 0 4 2 2 1 3 0 3 5 2 
-70 1 1 5 3 2 0 5 4 5 
-70 4 1 4 0 2 3 2 2 5 
-45 5 2 1 0 5 5 1 3 4 
-30 2 2 2 4 5 2 4 
10 3 3 2 2 4 1 5 2 0 5 1 
-45 1 5 4 0 5 1 3 5 4 2 
-100 5 0 4 3 0 2 4 1 3 0 3 2 
20 5 2 1 1 0 0 0 3 3 3 4 0 0 3 5 4 4 2 
-60 0 5 1 3 3 2 5 0 5 4 
-5 3 3 1 5 2 1 3 3 1 3 5 5 1 
-40 2 4 2 5 2 3 3 3 1 0 
-40 3 0 5 1 2 2 0 5 4 1 
-70 4 3 2 5 4 4 1 3 1 2 
-95 1 5 0 1 2 0 3 0 4 3 0 3 5 
-75 1 0 2 5 4 1 5 2 
-60 3 0 3 2 5 5 1 5 3 4 
-50 4 3 2 3 3 5 3 1 1 5 3 3 0 
-85 1 4 3 3 1 3 1 1 2 1 0 2 
-75 2 3 2 1 3 3 5 1 0 3 3 4 
5 0 1 4 0 0 0 5 0 2 4 3 0 4 5 4 0 
-60 3 2 0 0 4 1 1 1 5 1 0 4 
-70 2 0 0 3 0 4 5 0 0 4 2 0 1 
-60 4 1 2 0 3 5 4 1 4 3 0 5 
-55 3 2 4 5 2 3 0 3 2 0 2 
45 4 4 5 2 2 0 0 0 1 0 0 5 5 4 
-60 4 4 3 2 3 0 1 2 4 4 0 4 
-55 5 0 3 1 1 0 0 2 1 2 0 4 
-85 3 1 3 0 5 5 4 3 5 2 
-70 3 5 2 2 0 2 3 3 0 0 0 4 
-70 0 0 4 0 4 2 2 3 0 4 0 3 1 4 
-70 5 1 4 3 2 5 1 3 2 
-65 1 5 1 1 1 4 3 3 4 0 4 5 
-75 0 3 0 4 2 3 2 1 0 5 3 1 
-45 0 2 2 1 4 2 1 0 4 2 
-30 2 2 5 2 1 2 4 
-40 1 0 3 4 3 1 1 5 2 5 3 
-50 5 1 4 1 3 1 1 1 5 1 
-50 1 1 5 1 5 4 3 5 5 
-40 5 1 0 5 4 4 1 5 0 0 1 
-55 1 5 0 3 0 2 3 4 5 4 3 4 
-40 2 2 0 2 4 1 0 4 4 0 2 
-50 2 1 4 2 4 1 0 2 4 
-40 0 1 5 0 1 1 4 1 3 1 5 0 
-50 5 1 4 5 2 5 0 4 
-40 1 5 0 4 1 0 4 1 0 1 5 3 
-70 0 4 0 3 0 0 0 1 3 5 5 5 2 
-20 4 0 5 0 3 3 2 3 0 4 0 4 1 5 1 
-45 3 0 5 5 5 2 2 4 
-75 2 2 0 3 3 0 4 4 3 0 1 4 1 
20 4 1 4 4 1 2 4 1 4 1 5 2 
-70 2 1 5 4 2 0 3 1 5 
-45 4 5 1 5 0 0 5 5 4 
10 1 2 0 2 3 5 1 1 3 1 5 2 
-60 4 3 3 3 0 2 2 5 5 4 
-65 4 5 1 3 5 4 5 3 0 2 
-75 2 1 2 0 2 2 5 
15 4 2 2 5 0 0 1 2 5 3 0 3 
-50 0 5 5 2 5 2 5 
-55 2 1 4 2 1 4 5 5 
-85 3 1 5 4 0 3 3 2 5 5 
-60 1 1 0 4 0 1 1 2 1 3 0 4 1 
-30 4 2 5 5 2 2 0 
-40 0 4 0 5 1 1 1 0 2 5 2 
-55 5 4 3 2 0 4 4 0 3 5 3 1 
-60 3 2 1 2 0 5 0 1 4 3 2 
-70 0 4 4 0 3 4 2 0 4 0 3 5 0 4 
-70 0 2 3 2 1 4 4 2 2 
-55 0 0 5 0 2 1 1 2 0 3 4 1 
-40 2 5 4 0 5 0 3 4 2 2 
-70 4 3 1 0 0 1 4 3 3 5 5 3 3 3 
-65 2 0 4 1 5 0 5 1 3 2 
10 5 5 1 4 5 3 4 3 4 0 5 1 
-40 5 5 5 2 2 0 3 3 1 
-60 4 1 0 5 3 2 4 5 3 3 5 
-75 0 2 5 2 1 2 2 
-45 0 5 2 5 3 1 4 2 5 
-70 2 0 2 1 3 4 3 3 0 2 3 3 1 
-60 2 4 5 2 0 0 3 2 3 1 
-40 2 4 1 3 4 5 1 0 0 2 0 
30 5 5 1 0 2 1 5 3 5 4 2 
-40 2 4 3 5 4 5 2 0 3 0 
