-15 5 3 1 2 2 1 1 1 3 6 4 6 
-25 1 1 5 2 1 2 4 4 3 3 
-25 3 5 4 4 1 5 5 2 3 
-25 4 3 5 1 2 2 4 1 1 6 
-35 3 1 4 3 1 1 4 3 2 5 1 3 
-40 5 3 4 3 5 1 3 5 1 1 3 
-45 4 2 6 5 1 3 2 5 3 3 
-45 2 3 3 5 4 5 5 4 1 
-45 2 1 4 5 3 1 3 5 4 1 
-50 1 2 4 5 1 3 4 6 5 4 
-50 4 1 5 2 2 3 4 4 2 
-50 4 4 4 5 4 2 4 3 1 5 
-55 3 1 3 3 3 1 2 1 5 5 6 1 
-55 5 2 4 6 1 4 4 5 1 
-60 4 3 2 1 3 3 2 2 3 1 5 
-60 3 4 4 4 3 4 4 2 3 4 4 2 
-65 3 4 3 3 5 5 1 1 5 2 
-100 4 6 3 1 5 5 2 3 
-100 4 4 3 1 4 5 6 2 3 
-100 2 6 3 5 2 5 2 
-105 1 6 5 1 2 5 2 
-105 5 6 2 5 2 1 
-105 4 2 2 5 6 1 2 
-105 5 2 1 1 5 6 1 
-105 4 2 4 2 2 6 1 
-115 6 1 4 3 3 1 6 1 6 4 5 5 
-120 5 1 3 5 3 2 6 1 
-120 2 3 1 2 6 6 5 3 1 
-125 4 5 1 1 1 4 6 3 5 
-125 3 5 5 2 6 4 6 
-125 5 6 3 6 4 2 5 1 
-125 4 2 6 2 3 5 6 
-125 2 3 2 1 6 1 4 2 
-125 6 1 4 1 4 6 1 5 3 1 
-125 5 2 2 1 6 3 6 
-145 3 2 3 6 1 2 4 2 
-145 5 5 1 3 1 6 3 6 
-145 5 6 3 2 3 2 6 
-150 3 5 6 3 3 3 3 4 2 3 5 
-150 6 5 5 3 5 6 
-150 1 3 5 5 4 6 6 
-150 5 1 6 5 3 4 6 
-150 1 4 1 3 6 4 2 2 
-155 1 1 6 1 2 4 6 
-155 1 4 6 1 1 2 6 
-160 4 2 3 3 3 6 1 1 3 2 
-170 5 4 3 5 6 3 6 
-170 3 1 2 3 6 1 1 6 
-180 1 6 2 4 6 1 6 6 
-180 6 4 4 6 5 1 2 
-180 2 6 6 2 4 1 
-185 3 1 4 3 6 3 3 5 6 
-190 3 3 5 4 4 3 6 6 4 
-190 6 4 1 3 3 6 3 5 4 
-200 3 6 5 2 6 6 
-200 1 6 4 4 3 6 1 5 
-200 6 2 3 6 1 1 5 
-205 6 1 5 6 4 6 
-205 6 6 5 2 6 
-205 6 4 1 6 2 5 
-205 2 4 4 6 6 5 
-220 3 4 2 6 6 3 2 
-220 6 3 4 1 1 6 3 2 
-255 6 6 2 6 6 5 
