250 5 2 1 3 1 1 1 1 4 0 
195 3 5 3 3 1 2 3 2 0 2 
235 1 4 3 1 1 4 3 3 2 5 0 
230 3 0 1 4 4 1 1 5 5 5 
205 5 2 0 2 2 3 2 
225 5 0 4 2 0 0 1 0 4 0 1 5 
205 1 0 2 5 3 5 1 5 
190 5 4 2 0 0 3 1 3 1 5 
