-40 2 1 0 3 2 5 3 4 2 3 
-40 1 3 0 2 1 3 0 4 0 3 0 5 4 1 5 
-15 0 4 1 2 3 5 5 0 2 4 2 
-35 5 2 2 3 3 1 3 2 0 4 4 
-20 2 4 5 3 5 5 0 5 3 
-5 2 5 5 2 5 4 4 1 
-60 3 0 2 0 5 0 2 4 2 1 
-5 1 5 4 4 5 5 4 5 0 
