5 2 1 5 5 6 3 6 6 
0 5 6 4 5 6 5 2 
0 3 5 1 4 6 5 4 3 5 1 
-5 2 6 3 5 3 2 4 5 4 
-40 2 5 4 5 6 4 4 
-40 5 4 6 5 5 1 1 
-50 2 2 4 5 4 5 3 1 
-50 2 3 4 4 5 2 5 4 
-50 6 2 1 6 5 2 
-55 5 3 6 6 6 6 
-55 4 5 6 3 1 6 1 2 
-55 5 2 2 4 5 4 2 
-60 3 2 5 6 4 5 4 
-60 2 1 2 6 4 1 3 4 
-65 5 6 3 6 4 1 3 2 
-65 5 1 3 3 6 6 1 2 
-70 4 6 2 4 6 3 4 
-70 6 2 6 5 3 5 
-70 6 5 1 6 4 3 2 
-80 6 3 1 6 6 2 
-85 6 4 5 4 1 3 4 6 
-85 6 1 2 5 1 3 2 
-85 6 1 4 5 3 1 4 6 
-85 4 1 6 5 3 1 4 5 
-90 6 5 1 4 2 6 
-90 1 5 1 6 5 6 
-95 6 3 4 6 2 2 
-95 5 6 1 3 5 4 3 
-135 3 4 6 6 3 3 4 
-155 4 1 2 5 1 
-155 2 5 5 2 
-165 6 1 2 2 
-165 1 5 6 1 
-170 3 6 6 5 
-170 3 6 6 3 
-175 1 4 1 1 3 4 1 
-180 2 1 5 3 
-180 4 2 2 1 
-180 5 2 4 3 
-180 4 5 2 3 
-190 2 6 5 
-190 1 6 1 2 
-190 3 3 1 5 3 1 2 
-195 2 3 2 3 6 
-195 3 3 5 2 4 
-195 2 3 5 3 2 
-195 2 2 3 3 3 
-200 5 5 3 2 
-200 3 5 5 4 
-200 2 5 3 4 
-205 2 5 6 
-205 4 2 4 2 
-205 5 1 4 1 
-205 4 1 2 1 
-205 1 4 1 4 1 
-210 1 6 3 1 
-215 6 4 6 
-215 1 6 6 
-225 4 2 3 2 
-225 4 1 1 3 5 
-225 3 2 1 2 
-225 3 1 1 4 5 
-230 4 1 1 2 
-230 4 1 1 5 
