55 5 5 3 2 6 4 6 5 4 
25 5 4 4 1 1 2 6 6 3 
20 5 3 3 2 5 6 1 5 4 5 
15 4 3 1 2 5 6 5 5 2 
15 5 6 4 6 2 6 6 
5 1 3 2 2 2 4 3 1 1 5 2 
5 2 3 4 5 5 1 5 3 5 6 
0 6 4 3 3 2 5 5 3 5 6 
0 3 3 6 5 5 1 5 5 3 1 
-25 3 1 5 4 2 4 5 2 2 
-30 4 5 1 5 4 4 1 2 6 
-35 3 6 5 2 4 1 2 6 
-35 2 6 2 3 2 1 4 4 
-35 4 1 6 2 1 3 4 5 2 
-35 6 1 3 1 1 5 4 5 4 
-35 2 4 3 1 3 2 1 3 1 4 4 4 
-35 6 2 3 2 2 2 6 
-45 3 4 6 4 6 2 4 4 
-45 1 3 2 5 4 1 5 4 3 2 
-45 2 2 1 5 3 2 1 3 1 
-45 5 1 5 3 3 1 5 5 4 
-45 2 3 4 1 6 4 6 1 
-45 1 6 2 3 6 5 4 
-50 4 6 5 1 4 6 2 
-50 2 3 1 5 4 2 5 6 
-50 4 5 5 3 2 2 1 2 
-50 5 5 2 1 5 4 3 2 
-50 3 4 6 1 3 2 2 4 3 4 
-50 3 4 6 1 2 3 2 1 3 6 
-55 4 1 1 1 2 4 4 5 5 
-55 4 6 3 3 5 2 2 2 
-55 4 5 1 3 6 2 4 3 1 
-55 4 3 6 3 5 4 1 5 5 
-60 3 6 2 4 5 1 4 4 
-60 1 1 4 2 6 3 2 5 
-65 3 1 3 4 6 4 4 4 3 3 4 5 
-65 6 5 3 3 6 5 4 
-65 2 4 5 2 6 6 
-65 3 5 3 3 5 3 3 6 2 1 
-65 6 2 4 5 2 6 
-65 6 1 1 3 6 3 5 4 
-65 4 1 1 5 2 6 2 
-65 6 2 2 2 1 5 
-70 5 1 1 3 3 3 6 3 4 4 2 
-70 4 2 2 5 1 3 3 1 6 
-70 4 6 3 1 5 6 6 
-70 6 3 1 1 6 2 5 
-75 4 4 1 3 1 2 1 1 1 5 
-75 3 3 4 3 5 6 4 5 2 
-75 6 2 2 6 2 
-80 6 6 6 3 4 6 
-80 6 6 4 3 6 6 
-80 1 5 5 2 4 1 6 
-85 6 5 3 2 5 6 
-85 3 4 4 6 1 2 1 2 
-85 3 5 6 1 2 4 6 
-85 4 4 6 2 3 1 1 5 
-90 6 6 5 3 3 1 2 
-90 3 3 4 1 1 3 2 5 4 6 
-90 2 4 3 3 4 2 3 5 6 
-95 1 5 6 3 6 6 
-100 6 3 3 5 4 1 1 3 6 
-110 6 3 3 3 2 6 6 
-115 6 3 2 6 3 6 
