-40 2 2 3 4 5 1 5 3 3 4 
-40 2 1 4 3 4 4 4 2 0 4 0 1 
-80 1 1 0 1 4 4 0 3 3 5 4 3 2 
-55 3 1 4 1 4 1 3 5 3 3 0 2 0 
-65 5 4 3 2 0 1 4 3 4 4 5 
-45 4 4 5 0 4 2 2 0 1 1 
-50 3 0 5 0 0 2 3 0 5 1 4 4 4 
-25 2 5 5 5 1 3 5 0 
-40 1 3 3 2 2 5 0 1 5 2 
-75 3 0 0 0 3 4 1 1 2 5 4 0 4 
-60 0 5 3 0 4 4 3 5 5 4 2 
15 5 1 3 2 0 1 5 4 1 3 5 0 3 
-85 5 5 3 3 1 5 0 1 3 2 
-25 5 5 1 3 4 5 1 5 2 
-50 1 1 4 1 4 3 4 5 2 4 
-55 2 2 4 2 1 5 5 
-40 0 5 5 1 4 2 2 3 3 4 
-45 5 5 2 5 3 2 3 4 
-5 2 3 4 4 4 0 2 1 3 3 1 3 5 1 
15 5 4 1 0 0 4 3 1 5 2 5 3 3 
-60 0 5 3 4 0 2 1 1 0 2 2 
-50 1 2 4 4 3 4 4 1 4 1 5 
-50 1 3 4 5 5 5 2 5 
-55 5 2 1 5 5 4 5 
-30 1 1 1 2 5 5 4 4 2 
-40 2 4 4 1 4 2 3 3 3 4 1 4 
-100 4 3 3 3 4 5 3 0 2 3 1 5 
-50 4 5 1 5 0 1 1 2 1 
-55 0 0 5 5 2 0 2 1 0 3 1 
-60 1 2 3 2 3 0 2 1 3 1 2 
-55 1 2 4 4 5 2 1 5 
-55 4 2 1 1 2 1 5 2 
-55 0 4 2 2 2 3 3 1 3 4 3 3 
-45 2 1 4 2 0 2 0 5 4 
-60 5 0 0 5 3 2 1 0 2 2 
-45 4 5 2 0 0 4 2 1 4 4 
-55 0 0 1 4 3 2 0 2 3 1 4 4 3 
-45 5 4 2 4 0 4 0 1 2 2 
-30 1 2 4 4 5 2 2 0 
-80 5 5 1 0 3 3 0 5 4 3 5 
-55 1 5 0 3 2 0 4 2 0 0 4 0 
-40 4 0 5 4 5 2 0 3 5 3 
75 1 1 2 1 1 5 4 4 1 0 5 5 2 
-80 4 2 3 1 4 2 3 3 0 0 4 5 
-80 3 3 0 3 0 5 5 3 4 3 0 3 5 3 2 
-55 0 2 1 0 3 0 5 2 0 2 3 
-45 5 5 4 4 3 0 2 4 4 5 
-40 1 2 3 5 5 3 4 5 3 1 
-45 3 5 5 0 2 5 2 1 
-55 5 3 0 2 1 0 3 1 2 0 4 3 
-55 5 3 3 1 1 2 0 5 3 0 4 4 
-50 2 4 2 4 5 0 5 2 
-40 2 0 1 2 0 1 1 4 5 0 3 
-85 3 1 1 0 5 4 3 4 1 1 0 2 
-30 1 4 1 4 5 5 1 1 4 4 
-45 4 2 0 4 1 1 4 1 0 2 1 
30 1 0 2 4 2 1 1 5 4 5 3 2 
-40 0 2 5 0 5 3 4 4 5 1 
-60 1 0 1 2 3 3 1 5 3 5 4 
-55 4 3 5 3 4 3 3 1 1 2 0 1 4 
-40 4 2 1 0 3 4 0 5 5 4 0 
-65 1 5 5 1 4 4 3 1 3 0 2 
-45 4 2 0 5 2 4 0 4 1 1 
-70 2 1 0 5 3 2 2 2 
-25 1 1 0 1 2 2 4 1 4 1 1 
-50 1 5 3 1 4 5 2 1 5 
-65 3 4 5 3 2 4 5 3 4 2 
-40 2 1 5 5 0 2 3 0 1 4 
-85 4 2 1 1 1 3 5 0 0 3 5 
-45 2 5 3 3 2 2 4 4 4 
-55 4 4 2 5 2 2 2 
-40 4 3 3 3 5 4 5 2 2 3 
-55 0 4 0 1 1 3 1 5 3 3 4 4 4 4 
5 0 5 3 4 2 0 4 3 5 1 3 5 0 0 2 
-65 5 0 3 4 0 2 5 5 2 
-10 0 0 3 0 4 0 3 5 0 5 0 2 0 5 4 3 
-45 5 0 1 4 3 5 2 2 2 
-70 4 4 1 5 0 5 0 5 2 
30 1 1 0 2 4 1 0 4 4 2 5 4 2 
-80 3 1 0 4 0 2 0 2 0 2 2 
-40 2 2 5 4 4 2 0 3 3 2 
-30 1 5 5 4 4 1 1 5 0 
-60 3 1 2 0 4 3 4 4 5 1 3 1 
-70 4 4 3 4 4 2 0 1 1 1 2 
-55 3 4 2 3 2 5 0 0 5 3 0 
-45 1 1 1 4 5 5 0 5 3 1 
-50 5 5 2 5 5 0 5 
-55 2 4 0 1 4 2 0 3 1 4 3 3 3 
-45 5 5 0 4 3 5 4 5 1 
-40 3 2 3 3 4 5 1 4 4 4 1 0 
-60 0 3 4 0 5 5 3 5 5 2 
-60 3 1 0 5 4 1 5 3 5 3 5 
-55 5 3 3 1 0 0 1 1 2 0 4 1 2 
-40 5 0 2 0 5 3 1 1 1 4 0 
-100 3 3 5 0 0 1 4 4 0 0 5 5 
-40 0 4 1 3 1 5 2 1 3 2 3 
-40 2 0 2 0 2 0 1 4 2 3 
-55 2 2 5 5 5 5 
-25 5 4 0 2 5 5 5 2 
-75 4 1 0 5 4 1 3 5 3 3 0 0 5 
-30 4 2 4 2 2 2 1 2 
-45 5 2 4 5 3 3 5 4 1 
-45 5 2 2 3 5 1 1 0 1 
-75 1 1 3 0 0 3 5 5 3 3 2 2 
-75 3 1 3 0 2 1 5 3 0 0 1 4 2 
-65 5 3 1 3 2 5 1 0 1 2 
10 0 2 0 2 2 2 0 2 5 4 
-65 4 3 0 0 4 2 2 2 1 5 
-70 2 0 3 3 0 1 0 5 0 2 4 3 2 
-60 2 0 3 2 2 0 0 1 1 4 5 
-50 2 4 1 2 5 4 1 3 2 
-55 5 4 0 1 0 3 1 0 2 3 5 2 
-65 0 5 5 2 2 4 3 3 5 
-70 1 1 1 5 2 3 5 0 2 
-50 2 5 2 1 3 4 5 2 
-75 2 5 2 5 3 4 5 
-25 4 2 4 2 1 2 0 5 1 
-75 2 2 3 2 2 1 2 
-55 4 1 1 1 5 2 2 2 
110 2 1 5 3 2 1 3 0 2 5 5 5 4 
-55 4 3 2 0 4 0 5 1 3 0 4 1 1 
-60 2 4 0 4 4 4 0 3 0 4 4 1 5 
-70 5 4 3 1 1 0 2 2 2 
10 1 1 5 3 2 1 2 0 1 3 5 2 
-80 3 5 0 4 4 1 5 1 0 3 0 5 
-50 3 5 0 3 2 3 3 3 5 5 4 2 
-55 1 3 5 0 1 3 0 2 0 1 5 0 
-65 2 2 4 3 3 5 5 3 2 
-65 3 1 3 5 2 0 2 5 2 
-85 5 3 4 1 4 3 5 4 3 3 2 
-70 1 2 0 0 4 4 5 2 2 
-80 4 4 1 0 3 4 3 4 3 2 3 1 2 
-60 5 3 3 5 4 0 4 4 0 2 4 
-70 1 5 2 2 5 3 0 5 
-25 1 1 5 1 4 4 5 3 1 4 4 
-55 2 4 3 0 3 0 5 0 2 5 4 
60 2 4 1 2 2 2 3 0 3 5 5 3 
-65 0 0 2 4 2 5 0 2 5 
-80 1 0 0 0 3 3 4 4 1 2 5 2 
-95 0 2 3 0 0 0 4 0 1 5 0 4 2 
-50 2 5 2 0 1 5 4 5 
-40 1 5 0 2 4 0 2 4 4 0 4 
-45 4 3 2 5 1 4 4 5 3 2 
-55 1 4 1 3 0 1 4 1 5 1 0 3 0 2 
-40 2 1 2 0 4 5 3 0 2 2 
-65 5 4 1 2 0 0 4 3 1 4 2 
-60 3 3 1 2 1 3 4 3 5 5 5 
-60 3 4 1 2 1 4 3 1 3 0 4 1 5 
65 4 5 2 3 5 1 0 4 0 1 5 5 3 3 
-70 2 0 4 4 5 4 3 2 5 
-40 5 2 3 5 3 5 0 5 3 
-55 1 4 5 1 5 2 1 2 
-70 4 2 2 2 0 1 4 0 5 
-45 5 5 3 4 4 1 5 0 1 4 
-40 1 0 5 5 4 2 4 1 3 3 4 
-40 3 3 5 0 2 2 2 1 4 1 
-45 1 5 2 0 3 4 5 1 4 4 
-50 2 2 5 2 0 2 4 
-55 3 4 3 0 2 2 4 3 1 4 3 1 0 
-60 3 5 5 0 4 5 0 3 5 1 
-60 5 5 0 3 5 4 4 1 0 3 2 
-75 5 5 3 3 2 0 3 3 2 3 5 
-40 4 1 3 5 3 3 2 2 5 0 
-75 4 2 2 4 0 4 2 5 
-100 0 4 5 0 2 2 3 3 0 3 5 
-55 1 0 3 0 2 0 1 1 4 3 5 4 4 
60 4 4 2 4 5 3 4 3 5 3 5 5 4 
-40 2 0 1 0 3 5 4 4 1 2 0 
-25 0 2 1 2 1 1 1 4 4 1 2 
-45 3 0 4 1 1 5 5 4 2 2 
-65 5 2 4 3 3 5 5 3 2 
45 2 0 2 3 0 4 5 3 2 0 5 5 1 
-45 0 1 5 2 1 2 2 0 4 
-75 4 2 3 2 1 1 5 5 
-85 5 5 0 0 0 4 0 1 5 2 
-85 5 1 5 0 0 1 5 3 0 5 
-60 0 3 4 3 2 3 5 1 1 1 4 4 
-75 1 5 4 0 2 4 2 2 
-40 0 0 3 4 5 5 5 4 2 2 
-45 1 3 4 2 1 4 0 2 5 4 
-85 1 4 5 0 4 3 3 0 5 4 5 
-100 3 0 4 4 4 0 1 2 3 1 3 0 2 
-30 1 5 4 1 2 4 4 5 4 
-40 3 1 4 1 1 2 3 5 4 0 1 3 
-60 2 0 0 4 3 2 2 3 5 5 
-50 4 2 4 5 2 2 3 2 
-40 0 4 1 1 4 5 0 5 5 0 0 
-55 3 2 4 4 4 2 3 0 0 3 1 1 3 
-65 4 3 5 5 5 3 0 2 5 
-85 4 2 5 3 0 0 3 2 1 2 
-45 2 2 5 3 0 1 5 1 4 
-45 0 4 4 1 1 5 5 0 5 1 
-75 3 0 2 2 4 5 0 0 1 3 0 1 
-55 2 5 5 3 3 2 4 0 3 0 2 
-65 3 5 0 5 1 5 3 2 2 
-60 1 4 0 4 4 5 3 4 0 5 3 1 
-45 1 3 2 2 1 3 2 4 1 5 
-55 2 5 4 5 4 5 5 
-40 3 4 1 0 4 2 0 5 1 5 4 
-45 4 0 1 2 4 4 2 0 2 2 
-100 5 1 0 3 2 0 3 3 5 0 5 
-85 3 3 2 1 4 2 3 5 0 5 
-45 1 2 1 0 5 3 2 2 1 
-85 3 0 0 4 0 5 0 4 0 0 4 4 3 4 0 2 
-75 3 0 5 3 0 1 2 5 0 3 4 5 
-40 0 2 3 5 2 0 2 1 4 3 
-45 2 2 5 0 1 4 0 2 1 
-60 2 2 5 1 0 3 1 1 3 0 5 
-40 3 4 4 5 0 3 5 2 2 3 
-60 5 3 2 3 4 4 1 0 1 0 1 2 
-60 2 4 3 4 2 4 1 0 3 3 1 2 
-95 3 5 0 0 1 0 1 0 0 4 5 0 2 
-40 0 0 0 4 4 5 2 2 2 1 
-100 0 1 4 3 3 3 5 0 3 1 2 2 
-40 2 1 5 3 0 4 2 5 3 4 
-40 2 1 0 1 4 2 0 5 1 3 2 
-55 0 5 2 4 0 3 2 1 0 3 1 0 
-60 0 2 5 5 0 3 3 1 5 1 
-30 1 5 5 5 4 1 2 1 
-65 4 0 1 5 5 2 0 1 3 5 
-65 3 5 2 0 2 5 3 1 2 
-50 2 0 5 2 2 2 1 
-55 5 5 3 1 0 1 0 3 1 0 2 1 
-65 3 0 5 5 3 4 4 2 4 5 
-40 5 1 0 2 2 0 3 1 5 2 
-70 2 4 2 2 4 3 3 1 5 
-40 2 4 1 0 3 5 3 5 4 4 4 
40 1 4 3 2 0 0 3 0 4 0 3 1 5 5 0 5 3 
-40 3 5 5 0 1 5 0 1 2 3 
-65 2 0 0 4 3 0 0 3 1 0 2 2 0 1 
10 1 0 4 4 1 5 2 2 0 5 0 2 
-40 5 2 4 5 5 3 3 1 3 4 
-85 5 4 3 1 1 4 2 3 3 3 2 
-40 2 1 2 0 3 4 1 4 0 5 1 
-85 0 5 3 2 5 0 4 1 3 2 
-80 1 0 2 4 5 0 0 4 1 3 3 2 
-50 4 3 1 4 5 5 4 2 4 
-55 2 4 0 1 4 5 3 0 1 3 1 0 3 
-40 2 4 3 3 3 1 1 2 2 1 3 
-50 5 4 3 1 5 2 4 1 5 
-95 3 0 0 3 4 4 3 4 1 2 0 0 4 5 
-60 3 5 0 0 2 3 5 2 4 4 
-75 4 3 2 1 2 5 4 2 
-40 0 4 1 2 3 5 2 2 3 3 
-75 4 1 5 5 0 2 1 5 
-5 2 0 0 1 3 3 5 1 0 4 5 5 4 
-55 2 2 5 5 2 5 
-5 4 3 1 0 0 3 5 0 5 1 1 4 5 4 
-50 3 5 3 2 5 2 0 4 3 0 3 1 
-45 1 3 5 1 4 0 1 5 4 1 2 
-85 2 0 1 5 0 3 0 1 5 2 
-65 5 3 0 2 2 0 5 1 5 
-65 1 4 0 2 4 2 0 1 4 0 2 
-75 5 1 4 2 1 1 1 3 2 
-15 2 1 0 3 2 3 4 3 3 0 5 0 3 5 2 
-65 0 2 1 0 5 2 3 4 1 5 
