-145 5 3 3 4 6 4 5 5 
-275 1 6 3 6 6 5 
-180 1 6 5 4 1 6 2 
-130 5 1 4 6 1 4 1 6 
-30 5 2 4 1 1 4 6 5 4 6 
-125 6 3 5 4 2 5 5 
20 2 4 3 3 5 1 2 3 2 5 3 3 5 
-50 5 5 4 3 5 4 6 5 1 
-25 2 1 1 5 3 1 1 1 4 4 1 
-65 3 4 6 1 3 3 5 5 4 5 6 
-120 3 3 2 4 1 6 1 5 4 
-120 3 1 6 1 4 3 2 5 5 
-125 1 1 1 6 2 3 5 6 
-305 6 6 6 6 
-205 5 4 1 6 6 6 
-145 1 1 3 4 4 3 5 6 5 
-250 6 2 6 6 3 3 
-70 3 3 2 2 4 1 4 2 2 
-30 5 1 2 5 4 2 4 6 6 
-180 1 4 5 4 6 6 2 
-230 6 4 2 6 6 
-65 3 4 2 3 2 4 3 2 1 2 
-100 5 2 3 5 6 1 4 3 
-105 4 1 4 1 6 4 1 4 4 4 
-120 4 4 6 2 3 4 3 1 4 4 
-80 1 1 4 6 6 5 5 1 4 1 
-125 5 6 5 3 5 1 6 
-130 1 2 4 4 5 6 6 
-185 3 3 3 2 3 5 6 6 
-205 6 2 4 6 4 2 
-170 4 6 3 3 5 2 6 
-145 6 2 3 1 4 3 2 5 
-200 6 6 3 6 5 5 6 
-25 2 2 4 5 1 1 1 3 4 2 
-195 6 5 3 6 3 2 4 
-50 5 4 5 1 5 3 2 5 
-100 6 4 5 3 2 1 4 1 1 
-130 2 1 5 4 6 1 2 
-50 3 5 5 4 2 4 1 4 2 
-100 2 6 4 1 2 1 3 1 3 
-155 1 3 4 4 3 4 3 6 1 3 3 5 
-175 4 2 5 3 6 6 3 
-140 4 3 6 4 5 5 3 3 2 
-100 3 1 5 4 4 4 4 4 6 1 
-195 1 6 6 5 3 3 1 2 
-195 4 3 6 1 3 4 6 4 5 
-230 6 1 5 6 6 
-105 4 4 1 5 5 6 1 2 
-230 6 4 6 5 6 
-220 3 5 3 4 6 6 2 
-100 4 3 4 1 2 1 4 1 6 6 
-130 1 4 4 4 4 6 2 2 
-100 2 3 5 2 4 4 6 4 
-190 1 6 3 3 4 2 3 6 2 
-25 3 1 4 5 2 5 2 1 4 
-220 5 1 3 6 6 3 5 
-130 4 5 1 5 4 6 2 
-115 4 2 3 1 1 3 2 6 3 2 
-145 2 4 3 1 4 3 4 6 6 
-65 2 3 4 3 3 3 2 3 4 3 3 4 1 2 
-120 1 4 2 1 1 6 3 3 4 1 
-205 1 6 2 4 6 2 
-130 2 4 4 4 6 5 2 
-120 4 4 1 1 3 3 6 5 4 4 
