205 0 1 2 5 3 4 2 5 
225 3 2 2 0 1 3 1 0 1 3 1 2 
210 3 1 3 4 2 5 5 0 5 
220 1 5 4 1 5 5 2 
205 1 4 1 3 2 4 2 0 2 
210 1 3 4 4 0 2 5 0 4 2 
230 3 1 5 3 2 5 5 1 
215 3 3 5 0 2 2 5 0 2 
