-85 5 4 0 0 0 0 4 2 1 1 5 
-75 5 1 3 3 4 3 5 3 2 0 3 0 
-40 4 4 0 4 4 3 1 5 1 2 4 
-45 2 5 3 4 4 2 0 4 1 3 
-50 1 5 1 0 4 5 2 1 4 
-65 2 4 0 1 0 0 1 4 4 2 2 
-60 1 3 5 0 5 5 2 0 3 2 
40 2 0 1 5 0 3 5 2 0 5 5 1 
-60 5 4 0 0 0 2 4 0 4 1 1 3 
-60 5 4 0 0 0 2 4 0 4 1 1 1 
-5 5 4 0 0 0 2 4 0 4 1 1 5 3 1 
-60 5 4 0 0 0 2 4 0 4 2 4 
-95 5 4 0 0 0 2 4 0 4 3 3 0 5 
-85 5 4 0 0 0 2 4 0 4 1 2 
-60 5 4 0 0 0 2 4 0 4 1 1 3 
-85 5 4 0 0 0 2 4 0 4 1 5 
