-45 4 3 2 3 5 1 5 5 5 
-30 5 2 2 5 4 2 2 
-65 1 1 2 0 5 4 2 3 3 1 
-40 0 1 0 0 5 5 4 5 5 0 
-60 3 4 2 5 2 0 0 5 0 1 
-75 3 5 5 0 2 1 3 4 3 0 3 1 
-75 0 5 3 1 0 3 2 3 3 4 5 5 
-20 2 2 2 2 3 4 3 5 0 
-55 5 0 2 3 1 3 1 4 3 5 0 2 
-5 4 5 5 4 5 5 2 1 
-30 5 4 2 2 2 5 2 
55 2 4 2 2 2 0 3 5 4 2 1 
-45 4 3 4 4 5 5 4 1 4 3 1 
-55 3 4 3 3 1 0 0 4 5 5 2 0 
-70 2 3 4 4 2 3 4 1 4 2 
-25 4 2 4 1 3 1 5 1 5 4 
-85 4 3 0 3 0 0 0 0 3 2 5 0 2 1 
-35 2 4 2 3 3 0 3 5 5 1 0 
-35 4 3 4 4 3 3 2 5 3 4 5 4 
-40 0 1 3 5 5 0 1 4 4 5 4 
-70 2 3 2 5 3 4 2 5 
-55 0 4 3 0 1 5 3 5 0 4 1 4 0 
-5 0 3 3 4 0 2 2 2 2 0 5 2 
-60 0 5 1 3 0 2 2 4 4 0 1 
-65 3 1 1 2 2 3 3 1 1 4 5 
-35 0 1 4 3 1 0 5 2 1 1 0 4 4 
-65 3 0 1 4 5 5 4 2 0 1 
-70 2 1 0 2 1 0 2 1 2 
-55 5 2 2 3 3 3 4 3 3 5 0 
-95 0 3 3 1 0 5 3 3 4 2 0 1 1 
-60 2 5 5 4 1 0 0 3 4 0 1 
-20 0 3 2 4 4 2 5 5 4 3 
-75 0 4 4 3 1 3 1 0 2 1 0 4 3 4 
-60 5 2 2 0 1 3 3 5 0 0 
-75 5 3 3 1 0 3 0 4 1 5 0 4 5 
-80 1 5 0 3 0 1 5 5 3 0 5 
-5 4 2 2 1 4 1 4 5 4 5 
-40 0 3 4 0 5 4 4 5 4 1 4 1 
-60 1 1 3 3 4 3 5 5 1 1 0 0 
-25 2 2 3 2 5 1 5 4 
-35 3 4 0 5 4 4 2 0 0 1 5 2 
-55 2 3 0 4 2 4 0 0 4 0 5 1 
-75 3 1 0 5 4 0 2 0 0 0 5 4 
-40 1 2 0 3 1 1 1 2 4 1 3 1 
-55 4 0 0 3 3 4 2 1 1 5 3 4 0 
-30 2 5 1 4 1 5 2 5 
5 5 5 4 2 1 4 0 1 5 3 5 
-85 3 2 4 5 2 3 0 3 1 2 
0 3 2 5 5 4 4 4 5 1 3 
-80 4 3 3 0 0 3 1 5 1 4 5 1 
-85 3 1 3 0 0 1 0 3 0 2 0 4 3 5 0 
-80 4 0 3 0 2 3 4 2 5 0 1 
-50 0 5 1 1 2 1 0 1 3 1 0 0 3 5 
-60 3 3 4 4 3 4 1 0 1 4 2 4 5 
-70 1 3 0 3 2 4 3 3 2 3 4 4 3 4 
-45 1 5 4 0 1 5 1 2 3 3 
-45 0 1 4 1 5 3 4 5 5 1 
-40 2 2 1 3 5 0 4 3 5 3 
-75 2 0 4 4 1 5 0 4 0 0 0 3 5 
-45 2 0 2 5 4 0 1 5 0 
-50 3 5 3 2 0 4 1 0 4 5 0 3 3 
-60 3 0 4 3 1 0 5 1 2 5 2 
-85 5 0 5 3 4 0 5 3 1 1 
-50 3 2 5 2 2 2 1 
-40 3 1 2 1 5 1 0 0 1 5 5 
-65 1 3 1 0 1 3 2 2 5 1 
-40 5 2 2 3 3 3 1 2 4 5 
-65 1 1 2 2 1 3 1 0 3 1 1 
-70 3 3 2 5 0 4 4 1 3 1 0 3 0 1 
-100 2 3 0 3 3 2 4 5 0 3 2 
75 1 5 3 2 2 5 5 5 5 4 
-70 2 3 0 5 2 5 4 2 
-50 1 5 3 0 0 0 1 0 2 1 3 4 4 5 
-75 1 1 5 3 0 3 4 1 0 2 0 3 0 
-35 0 5 3 2 3 2 5 3 2 5 
30 1 4 2 1 5 5 3 0 5 4 4 5 
-45 1 2 1 1 5 3 4 3 2 5 
-65 1 5 4 1 0 3 5 4 4 0 2 
135 3 3 2 4 4 1 5 3 5 5 5 4 5 4 5 
-25 5 0 1 2 1 2 2 4 2 
-5 4 5 5 5 4 5 2 0 
-45 3 5 5 4 1 3 2 5 1 
-65 1 4 3 5 1 3 3 5 5 2 
-45 1 2 5 2 4 5 3 3 5 
-65 3 3 0 1 4 4 2 4 1 5 5 
-30 4 1 5 4 1 2 1 2 2 
-40 5 4 2 1 3 0 3 2 5 1 
-55 2 0 0 0 2 4 4 4 2 3 0 2 
-50 1 2 5 5 0 1 2 1 
-45 2 4 0 2 3 5 4 5 0 
-65 2 5 0 1 0 2 3 2 1 
-45 5 1 0 3 5 1 4 2 1 0 
-85 0 5 3 0 1 3 2 4 4 1 2 
-25 5 2 2 1 1 5 3 1 3 
-60 4 3 5 2 0 1 3 4 2 3 1 
-75 5 0 0 1 0 3 1 3 4 3 2 1 2 
-40 2 3 2 4 2 5 0 0 4 4 
-55 5 4 2 2 5 1 2 
-20 2 2 0 5 0 5 2 4 4 
-70 1 5 4 2 3 1 4 0 4 2 
-45 5 3 5 3 5 2 2 0 
-40 3 3 4 1 4 2 1 5 0 5 5 
-40 5 5 5 5 3 0 3 4 4 1 
290 3 5 5 4 3 2 0 1 1 5 1 4 4 5 5 2 0 2 1 2 
-25 5 2 2 4 3 2 5 2 
5 3 2 2 4 5 0 1 2 5 2 
-80 2 4 0 1 4 0 0 3 4 5 0 2 
-50 0 0 0 0 2 1 5 4 3 3 2 1 5 
-65 5 0 1 3 4 1 5 3 1 4 4 
-65 5 0 0 0 1 5 4 5 4 2 
-80 1 1 3 0 1 3 4 0 2 3 5 4 
-45 1 2 1 2 4 0 4 5 0 1 
-75 3 0 5 3 3 5 4 3 5 4 0 0 
-70 0 0 5 3 3 0 3 1 1 4 4 0 5 5 
-45 2 2 4 1 3 2 0 5 3 
-45 4 2 4 4 5 0 1 0 5 0 
10 3 0 2 4 4 5 5 1 1 5 0 2 
-65 0 4 3 1 3 1 4 2 5 1 1 
-50 1 4 2 0 5 5 1 4 4 
-60 0 3 5 1 3 4 1 2 5 3 0 
-20 3 1 3 5 2 1 2 1 5 3 
-80 5 1 4 1 3 0 1 3 2 0 0 2 
-65 3 4 5 3 1 3 1 5 1 1 1 
-50 1 5 2 3 5 1 5 4 
-90 5 1 2 2 3 0 0 1 2 
-50 4 2 2 0 1 3 2 0 0 3 0 4 2 
-90 0 2 2 3 2 3 4 1 2 
-70 5 0 4 1 0 5 2 1 1 
-55 1 1 4 2 2 1 5 4 
-45 1 1 5 2 3 5 3 4 4 1 
-15 5 1 2 3 2 0 0 4 4 2 1 
-100 0 0 1 0 2 5 3 3 1 0 1 2 
-65 5 4 0 2 4 4 1 4 0 3 5 
-65 5 3 0 0 0 3 1 2 1 3 3 0 1 4 1 
-45 1 3 2 4 4 0 1 1 1 1 4 4 
-80 0 4 4 3 3 5 0 3 4 5 4 4 
-25 4 4 1 4 5 0 1 2 1 4 5 
85 5 2 4 3 4 1 4 2 5 0 4 0 5 2 
-65 5 1 4 2 1 3 1 3 1 0 1 
-85 1 3 1 1 0 5 5 0 3 4 1 
-65 3 3 2 1 4 2 1 0 5 1 
-55 3 3 0 1 5 3 5 5 0 2 2 
45 3 3 0 0 4 5 0 1 1 5 4 4 5 5 2 
-85 2 4 0 3 1 4 0 0 5 4 2 
-25 0 1 1 0 2 5 0 0 0 5 0 5 2 
-25 1 3 4 5 4 4 2 2 4 5 
-45 2 1 3 4 2 0 5 2 0 
5 1 4 4 5 2 2 3 5 1 3 3 
-75 0 4 2 3 0 2 3 4 2 3 0 2 
-45 4 2 1 3 2 2 2 3 2 
-65 1 0 2 0 2 0 2 5 2 
-35 1 3 3 0 1 4 5 1 4 3 5 4 3 
-45 2 4 5 0 5 2 1 3 4 
-70 3 2 0 4 1 4 1 5 4 5 
-110 1 4 3 0 4 0 0 5 5 2 
-25 2 1 2 1 2 2 1 3 1 
-60 2 5 0 0 0 5 5 3 1 3 
-90 4 2 3 0 5 1 3 5 5 
-45 1 3 1 1 4 5 1 1 1 1 3 1 
-25 1 5 1 4 1 5 0 2 4 4 
-20 2 5 0 4 2 5 0 5 4 
-85 1 4 0 1 0 3 3 5 1 5 1 
-85 5 3 3 4 4 0 5 0 2 2 
-10 3 3 2 2 1 1 0 5 5 1 0 1 
-65 4 4 5 0 0 1 0 4 4 4 1 2 
-70 2 3 3 2 3 3 3 0 5 2 3 0 
-70 3 0 0 3 3 1 1 2 2 3 2 3 5 
-75 2 5 3 1 2 0 0 4 3 3 0 2 
-60 0 3 5 0 4 2 0 1 1 2 0 
-70 1 3 4 1 5 0 1 2 4 2 
-50 0 5 5 5 2 5 1 
-75 0 0 1 4 4 3 1 3 3 3 4 4 5 0 
-25 2 4 4 1 2 4 5 4 3 3 
-65 2 3 2 1 5 4 3 0 1 2 
-30 4 0 3 5 0 3 0 5 2 1 5 1 
-65 4 2 4 5 1 0 3 5 0 2 
-75 5 0 0 4 1 0 2 3 4 0 4 3 2 
5 0 5 2 3 1 5 5 1 5 1 
-95 0 0 3 3 1 5 3 0 3 3 0 1 0 0 0 5 2 
-75 2 2 2 2 1 0 2 
-75 0 1 3 1 0 2 4 3 2 0 0 4 4 
-35 2 3 0 2 2 1 0 3 4 5 2 
-85 2 3 0 4 5 1 3 5 0 1 
-40 0 1 5 4 2 1 5 1 0 3 5 
-45 5 1 5 2 3 5 3 4 1 
-70 5 3 0 2 4 2 5 1 
5 2 1 3 5 4 3 2 5 2 2 
-45 2 4 0 4 0 2 4 4 4 1 0 
-20 4 1 4 3 4 0 1 5 2 5 2 
-45 2 5 3 4 5 4 2 3 0 
-100 3 0 3 1 3 4 3 4 2 3 4 4 5 
35 4 2 2 1 4 3 4 0 4 3 5 2 2 
-80 5 5 0 3 0 5 3 4 3 4 4 
-50 1 4 2 4 5 0 1 4 1 2 
0 4 4 5 2 1 3 4 5 5 2 
-80 4 2 0 5 4 0 2 0 3 0 2 
-70 0 5 2 1 2 4 1 0 1 
-60 2 4 0 3 0 4 0 5 1 2 0 
-50 0 2 5 4 5 4 5 2 
-20 3 5 5 2 2 2 0 4 5 
-50 3 1 1 4 4 2 4 1 2 2 
-60 2 1 0 1 5 3 5 0 0 4 1 
50 5 1 5 1 1 2 3 1 5 2 2 
-25 3 4 1 1 1 3 5 3 3 0 1 3 4 5 3 
-55 4 4 4 4 4 2 4 2 2 
-70 4 1 1 0 2 4 4 0 1 4 1 
-40 3 5 3 0 5 5 1 4 4 4 0 
-75 5 3 2 2 5 4 2 
-50 0 2 4 2 2 1 5 1 
-75 3 4 0 3 4 0 0 2 1 0 4 5 0 
-75 5 0 3 5 3 3 0 2 2 3 3 
-60 2 3 4 5 0 1 5 3 4 0 4 
-65 2 5 5 4 1 1 3 0 0 2 
-90 0 4 1 1 3 4 3 5 5 5 
-60 4 4 3 0 4 1 0 3 2 1 5 5 
-60 0 2 1 2 1 0 0 4 0 2 0 
-15 1 3 4 2 5 4 1 0 1 5 3 5 
-80 3 4 3 0 3 2 1 4 2 1 3 0 
-65 5 1 1 4 3 1 3 1 3 4 1 1 
-50 1 1 1 0 5 4 4 1 5 3 
-80 3 0 5 5 0 2 0 4 3 1 2 
-65 0 0 2 5 2 3 4 1 4 0 
-70 5 5 4 0 1 4 0 5 2 
-90 3 2 3 5 2 0 2 2 
-55 1 5 1 2 2 2 0 
-50 1 1 1 1 0 5 2 5 4 
-75 1 1 0 4 3 5 4 0 0 1 0 1 3 1 
-75 1 5 1 4 0 1 2 4 2 
-45 4 5 0 3 4 4 5 4 2 3 
-70 5 1 4 1 3 5 4 0 4 1 
-65 3 2 1 1 4 5 0 2 0 2 
-105 2 3 3 0 3 0 1 5 5 5 
-45 1 3 3 5 5 4 1 1 5 2 
-65 1 5 2 4 0 4 3 2 0 1 
-25 1 1 5 4 5 4 3 4 5 5 
-90 5 3 0 3 0 0 3 3 1 3 1 2 4 1 
-50 5 4 2 5 4 3 5 4 
-55 2 1 5 0 0 0 3 5 3 5 4 
-55 5 0 0 0 3 1 5 5 3 5 4 
-85 5 0 4 3 0 2 1 3 5 5 
-65 5 5 0 5 5 4 3 3 4 
-10 3 5 3 1 0 5 0 1 5 4 5 4 
-45 1 5 4 0 5 0 2 5 2 
-45 1 2 2 2 0 3 4 2 3 
-75 0 0 3 3 4 2 4 3 3 5 1 4 5 
-45 3 4 4 5 5 4 2 0 4 1 
-65 1 0 1 1 1 0 5 5 1 3 0 
-40 5 4 3 3 4 0 5 1 2 4 5 
-85 4 0 2 1 2 0 3 2 3 4 
-20 3 4 5 4 0 4 5 4 1 5 0 
-105 0 2 5 0 1 3 1 3 0 3 3 3 3 0 5 
20 3 3 0 0 3 3 2 2 2 2 5 0 3 3 4 5 
-85 4 0 2 0 3 4 3 5 5 2 
-70 5 4 3 2 2 3 5 5 
-65 1 3 3 4 2 3 1 2 2 0 
-60 1 1 4 5 3 3 2 4 1 0 3 1 
