100 6 3 6 1 5 5 6 4 3 5 5 
55 6 3 6 1 5 5 5 4 4 4 
30 6 3 6 1 5 5 5 1 5 
30 1 5 4 3 5 6 5 6 1 
30 6 3 6 1 5 5 5 4 3 
20 6 3 6 1 5 5 6 5 
20 6 3 6 1 5 5 6 1 
20 6 3 6 1 5 5 6 3 
10 6 3 6 1 5 1 3 4 5 6 
5 6 3 6 1 5 5 5 2 
0 2 6 5 5 1 6 6 
-10 1 3 3 6 1 4 6 3 4 5 2 
-10 1 6 3 6 6 6 3 5 
-20 5 4 5 1 3 5 3 4 2 3 1 
-25 6 5 6 1 3 3 6 1 
-30 5 3 1 3 5 4 4 2 3 3 4 4 
-30 1 4 5 2 6 5 3 3 1 
-30 3 4 5 1 5 3 4 4 5 3 3 6 
-40 2 6 1 4 5 4 4 2 
-40 6 3 6 1 5 5 3 4 
-40 4 1 1 4 5 6 5 1 
-45 6 3 6 1 5 5 1 
-45 6 3 6 1 5 5 2 
-45 6 3 6 1 5 2 5 
-50 4 6 5 3 6 3 5 4 
-50 4 2 5 6 6 3 
-55 2 1 1 4 1 1 3 2 4 6 
-65 5 4 5 2 6 2 
-70 6 3 6 1 5 4 5 
-85 3 3 3 6 4 6 2 2 
-125 4 5 5 5 3 2 
-140 1 6 5 4 2 
-160 2 3 3 3 4 3 5 5 
-355 6 3 6 1 5 5 
-355 6 3 6 1 5 5 
-355 6 3 6 1 5 5 
-355 6 3 6 1 5 5 
-355 6 3 6 1 5 5 
-355 6 3 6 1 5 5 
-355 6 3 6 1 5 5 
-355 6 3 6 1 5 5 
-415 4 1 6 1 4 5 4 
-415 4 2 3 3 5 6 
-420 6 3 6 1 5 
-420 6 3 6 1 5 
-420 6 3 6 1 5 
-420 6 3 6 1 5 
-420 6 3 6 1 5 
-420 6 3 6 1 5 
-420 6 3 6 1 5 
-420 6 3 6 1 5 
-420 6 3 6 1 5 
-420 6 3 6 1 5 
-420 6 3 6 1 5 
-440 2 5 4 5 
-440 6 3 6 1 3 3 1 1 
-450 3 3 2 3 6 5 
-465 2 2 5 
-470 6 3 6 1 
-470 6 3 6 1 
-470 6 3 6 1 
-490 5 1 6 4 
-490 6 2 4 4 
-490 6 2 4 4 4 3 
-490 6 2 4 4 
-500 5 4 3 4 5 
-500 3 1 5 4 1 
-500 2 3 2 4 
-505 2 5 4 
-515 3 2 3 3 5 5 3 4 
