110 4 5 3 2 1 6 4 1 6 4 5 1 
110 4 5 3 2 1 6 4 1 6 4 5 2 
65 1 2 2 6 4 5 3 5 4 4 6 
60 4 5 3 2 1 6 4 1 6 4 6 5 
60 4 5 3 2 1 6 4 1 6 4 6 2 
60 4 5 3 2 1 6 4 1 6 4 6 2 
60 4 5 3 2 1 6 4 1 6 4 6 6 
60 4 5 3 2 1 6 4 1 6 4 6 6 
60 4 5 3 2 1 6 4 1 6 4 6 4 
60 4 5 3 2 1 6 4 1 6 4 6 6 
60 4 5 3 2 1 6 4 1 6 4 6 4 
60 4 5 3 2 1 6 4 1 6 4 6 1 
60 4 5 3 2 1 6 4 1 6 4 6 2 
60 4 5 3 2 1 6 4 1 6 4 6 1 
55 4 5 3 2 1 6 4 1 6 4 6 
55 4 5 3 2 1 6 4 1 6 4 4 
55 4 5 3 2 1 6 4 1 6 4 6 
40 5 6 6 2 6 5 4 
35 5 2 5 2 5 4 6 6 
0 3 4 1 1 1 2 4 1 5 2 6 
0 3 5 2 6 3 6 6 5 
-10 6 6 4 5 4 6 6 
-15 6 1 5 2 4 1 2 4 
-40 3 6 5 3 1 5 6 3 
-75 6 6 5 4 4 1 
-100 6 1 2 6 6 
-105 2 1 2 1 2 4 
-115 4 6 2 4 4 4 
-125 5 2 4 3 5 2 
-130 1 4 2 2 4 2 
-140 4 6 4 1 1 2 
-150 3 2 3 6 4 3 2 
-155 3 2 6 4 3 1 
-320 4 5 3 2 1 6 4 1 6 
-320 4 5 3 2 1 6 4 1 6 
-320 4 5 3 2 1 6 4 1 6 
-320 4 5 3 2 1 6 4 1 6 
-320 4 5 3 2 1 6 4 1 6 
-320 4 5 3 2 1 6 4 1 6 
-320 4 5 3 2 1 6 4 1 6 
-320 4 5 3 2 1 6 4 1 6 
-320 4 5 3 2 1 6 4 1 6 
-320 4 5 3 2 1 6 4 1 6 
-345 4 5 3 2 1 6 4 1 
-345 4 5 3 2 1 6 4 1 
-345 4 5 3 2 1 6 4 1 
-345 4 5 3 2 1 6 4 1 
-345 4 5 3 2 1 6 4 1 
-345 4 5 3 2 1 6 4 1 
-345 4 5 3 2 1 6 4 1 
-345 4 5 3 2 1 6 4 1 
-345 4 5 3 2 1 6 4 1 
-345 4 5 3 2 1 6 4 1 
-400 1 5 2 3 5 5 
-400 2 1 1 2 3 5 4 1 
-415 4 1 4 6 4 5 4 
-415 6 2 2 1 5 
-425 4 3 2 3 1 4 6 5 
-430 3 3 2 5 2 6 
-445 6 1 1 2 3 
-460 2 3 3 3 6 6 
-475 2 6 1 
-480 6 6 3 
-480 5 1 5 5 1 
-480 2 2 4 4 5 4 
-480 4 2 2 2 4 
-480 4 4 2 2 5 4 
-480 1 1 5 2 
-490 1 1 4 5 6 5 
-490 6 5 1 1 1 
