-45 4 5 1 4 5 4 3 3 1 1 4 
-85 0 5 3 4 5 2 4 3 0 5 
-45 5 5 4 2 5 3 4 0 2 
-25 3 1 2 4 2 4 2 2 3 
-30 5 2 2 1 2 5 2 
-65 3 2 1 3 5 5 3 2 2 
-65 0 0 2 5 1 2 3 2 2 
-55 2 0 5 0 3 0 5 2 3 4 2 
10 3 4 0 3 4 1 5 2 2 4 5 4 
-40 3 5 4 3 5 4 1 1 2 3 0 
-95 2 3 3 4 1 0 2 3 0 0 4 0 5 
-70 0 3 3 1 1 1 0 2 0 3 4 1 1 0 2 
-55 0 0 1 5 0 0 1 0 1 1 2 4 3 
-75 0 4 4 0 1 0 4 4 4 3 5 0 3 2 
-30 4 2 4 1 5 5 2 2 
-70 4 2 3 2 1 5 0 4 2 
-30 4 2 1 1 1 2 1 1 1 2 
-65 2 1 4 2 0 1 0 2 3 2 
-50 4 5 5 2 0 2 1 2 
-30 2 5 2 4 2 4 1 4 
-45 0 1 2 4 2 3 1 1 1 4 2 
-60 1 0 2 2 4 0 0 2 1 3 5 
-65 1 2 2 3 3 5 3 2 2 
-80 3 0 1 5 3 0 5 4 2 0 5 
-55 2 0 1 5 0 3 1 4 0 3 2 2 
-60 0 1 1 1 2 4 0 2 3 4 0 4 
-100 4 4 3 4 3 3 3 1 1 3 1 4 0 2 
-45 0 2 5 5 4 0 2 4 2 
-40 3 2 5 3 3 5 2 5 1 
30 5 1 1 4 1 5 5 4 5 3 0 3 
-40 1 3 0 2 2 4 1 5 3 1 1 
-30 2 2 1 5 5 4 1 0 
-80 5 3 0 5 3 1 5 3 1 0 2 
-50 0 2 3 3 1 3 1 5 0 2 0 4 4 
-75 5 1 0 4 0 0 3 3 4 0 4 2 1 
100 5 2 3 4 0 3 1 0 3 1 2 5 5 5 0 4 
-40 2 1 3 0 2 2 3 4 2 1 
-45 1 2 5 2 4 0 1 0 4 5 
-75 1 0 3 3 2 3 0 2 4 1 0 1 4 
-40 2 1 4 4 3 1 1 3 4 4 3 4 2 
-45 5 3 3 5 5 2 2 2 
-75 4 0 2 5 2 2 2 
-30 2 4 1 5 5 5 4 4 
-5 0 1 2 3 2 0 0 1 1 5 3 5 1 
-65 0 3 0 4 3 0 3 1 5 1 3 0 4 2 1 
-60 2 1 0 3 3 4 2 5 3 4 4 
-65 2 0 3 2 0 4 1 5 1 2 
10 0 2 5 2 3 2 0 2 5 1 
-40 4 5 3 0 4 2 0 5 5 0 
-60 0 4 5 0 5 4 4 4 3 1 3 2 
-50 4 1 4 5 2 2 3 1 4 
-25 4 1 5 0 4 4 2 2 1 2 
-45 1 5 5 2 1 4 4 0 0 2 
-45 5 4 1 0 0 2 1 5 4 2 
-60 2 0 3 2 5 4 0 0 2 5 
-45 5 1 5 1 1 3 3 4 4 1 5 
-40 1 4 0 1 1 3 5 3 1 2 1 2 
10 0 2 5 3 4 4 0 1 4 2 5 2 
-100 3 0 0 1 3 3 1 5 4 0 2 5 
-55 2 5 2 1 3 0 1 3 3 3 4 2 
-25 0 5 4 1 1 1 4 4 1 5 3 
-65 5 0 2 0 0 5 5 1 5 
-55 1 4 4 5 1 2 5 5 
-45 1 4 5 2 3 5 0 2 2 
-75 4 1 1 3 5 5 4 1 5 
-60 4 0 3 5 2 0 1 1 2 3 5 
-45 5 3 4 2 5 3 4 2 3 
-40 3 5 3 2 5 5 5 3 4 
-75 5 0 0 3 0 1 3 2 2 0 4 4 
-75 4 3 5 1 3 5 4 0 1 0 3 0 2 
-45 3 1 1 4 1 3 4 1 5 2 4 
-40 5 0 1 1 4 3 2 4 3 5 0 
-70 5 3 4 2 1 5 3 3 3 3 3 0 1 
-65 4 3 5 3 4 1 0 4 2 1 2 
-40 5 4 5 0 2 4 1 3 4 3 2 
-70 4 4 1 5 3 0 1 5 1 2 
-40 3 3 2 5 4 2 5 1 0 0 
-40 3 5 3 1 1 2 0 1 2 4 1 
-50 1 2 5 3 4 2 5 2 
-75 3 2 2 5 1 5 2 
35 5 3 3 0 5 5 3 0 4 0 0 1 5 3 5 4 
-60 0 1 2 3 5 3 4 0 4 2 4 
-40 4 0 4 4 4 2 3 5 2 0 2 
-40 0 1 2 3 5 1 1 4 3 5 0 
-50 0 1 3 0 2 0 2 0 1 4 0 5 2 
-55 0 1 3 1 0 2 4 4 5 0 4 3 2 
-45 4 2 0 5 1 2 1 3 1 4 
-55 1 3 1 2 0 1 4 5 3 3 4 3 1 
-50 2 5 0 4 2 5 1 2 
-40 0 2 2 0 4 5 0 4 5 1 
-30 5 4 1 4 4 5 2 4 2 
0 5 1 1 3 2 1 0 0 4 0 0 4 5 3 1 
-25 3 5 4 5 5 2 1 4 3 
15 1 3 4 1 5 0 1 4 2 1 0 5 3 3 
-40 5 1 1 5 1 0 2 1 3 3 0 
-75 2 4 1 5 0 1 2 2 
-60 1 4 4 0 5 2 4 3 4 0 0 4 
-65 2 4 3 3 3 4 4 1 1 1 4 2 
-40 5 4 0 3 4 3 5 2 5 4 
-60 1 1 3 0 1 3 0 5 4 0 1 3 0 4 0 0 
-85 5 4 5 4 0 0 4 0 3 4 2 
-45 3 4 4 1 3 1 4 1 5 5 1 
-55 1 1 0 3 1 2 1 4 4 0 1 3 0 0 
-40 1 4 0 3 4 1 2 0 4 1 5 4 
-25 0 5 2 5 1 4 5 1 3 
-55 0 2 1 1 3 4 4 3 0 2 4 0 3 
-45 2 4 3 4 5 5 0 5 4 
-75 4 3 4 2 2 2 4 2 
0 0 4 1 0 5 3 5 2 3 4 0 5 3 4 
-40 2 1 3 5 0 1 1 1 3 5 3 
10 0 1 4 0 1 2 3 2 1 3 3 1 5 0 0 3 
-30 1 2 4 2 2 5 1 2 
-65 5 0 4 1 2 3 5 4 0 5 
-80 0 3 3 5 0 2 4 3 1 2 2 
-40 2 2 3 5 5 0 2 0 4 
-25 3 1 5 1 2 5 1 5 4 
-70 0 0 3 0 5 3 2 1 3 4 5 0 1 
-75 5 1 2 5 3 1 4 2 
-65 3 5 2 0 5 5 1 0 5 
-70 2 5 4 1 0 2 0 4 5 
-70 0 1 5 5 1 2 4 3 2 
-60 1 5 0 3 2 3 5 0 2 5 
-85 2 4 0 1 4 5 3 3 3 4 2 
-30 2 1 4 4 5 4 5 1 1 
20 1 4 1 3 0 1 4 1 5 1 4 3 5 0 0 3 
-25 2 2 5 1 5 0 2 3 
-80 0 2 1 0 3 0 5 2 0 1 5 
25 5 3 3 1 0 0 1 1 2 0 4 1 5 0 4 5 
110 2 1 5 3 2 1 3 0 2 5 5 5 4 
115 2 1 5 3 2 1 3 0 2 5 5 5 3 1 
15 2 1 5 3 2 1 3 0 2 5 3 2 
110 2 1 5 3 2 1 3 0 2 5 5 5 4 
15 2 1 5 3 2 1 3 0 2 5 0 3 
65 2 1 5 3 2 1 3 0 2 5 5 3 4 
10 2 1 5 3 2 1 3 0 2 5 2 
10 2 1 5 3 2 1 3 0 2 5 1 
115 2 1 5 3 2 1 3 0 2 5 5 5 3 4 
15 2 1 5 3 2 1 3 0 2 5 0 1 
-40 2 1 5 3 2 1 3 0 2 3 
110 2 1 5 3 2 1 3 0 2 5 5 5 0 
-40 2 1 5 3 2 1 3 0 2 3 
60 2 1 5 3 2 1 3 0 2 5 5 2 
60 2 1 5 3 2 1 3 0 2 5 5 0 
15 2 1 5 3 2 1 3 0 2 5 0 5 
40 2 1 5 3 2 1 3 0 2 5 0 4 5 
40 2 1 5 3 2 1 3 0 2 5 3 4 1 
10 2 1 5 3 2 1 3 0 2 5 1 
110 2 1 5 3 2 1 3 0 2 5 5 5 2 
110 2 1 5 3 2 1 3 0 2 5 5 5 4 
-40 2 1 5 3 2 1 3 0 2 4 
60 2 1 5 3 2 1 3 0 2 5 5 4 
10 2 1 5 3 2 1 3 0 2 5 4 
110 2 1 5 3 2 1 3 0 2 5 5 5 1 
60 2 1 5 3 2 1 3 0 2 5 5 1 
-40 2 1 5 3 2 1 3 0 2 3 
60 2 1 5 3 2 1 3 0 2 5 5 4 
10 2 1 5 3 2 1 3 0 2 5 4 
-40 2 1 5 3 2 1 3 0 2 4 
-40 2 1 5 3 2 1 3 0 2 1 
10 2 1 5 3 2 1 3 0 2 5 2 
-40 2 1 5 3 2 1 3 0 2 3 
10 2 1 5 3 2 1 3 0 2 5 2 
115 2 1 5 3 2 1 3 0 2 5 5 5 0 4 
10 2 1 5 3 2 1 3 0 2 5 4 
10 2 1 5 3 2 1 3 0 2 5 2 
-40 2 1 5 3 2 1 3 0 2 0 
-40 2 1 5 3 2 1 3 0 2 0 
110 2 1 5 3 2 1 3 0 2 5 5 5 3 
10 2 1 5 3 2 1 3 0 2 5 4 
-40 2 1 5 3 2 1 3 0 2 3 
60 2 1 5 3 2 1 3 0 2 5 5 1 
60 2 1 5 3 2 1 3 0 2 5 5 1 
115 2 1 5 3 2 1 3 0 2 5 5 5 3 2 
60 2 1 5 3 2 1 3 0 2 5 5 0 
-40 2 1 5 3 2 1 3 0 2 2 
65 2 1 5 3 2 1 3 0 2 5 5 0 1 
60 2 1 5 3 2 1 3 0 2 5 5 3 
-40 2 1 5 3 2 1 3 0 2 0 
60 2 1 5 3 2 1 3 0 2 5 5 1 
10 2 1 5 3 2 1 3 0 2 5 1 
115 2 1 5 3 2 1 3 0 2 5 5 5 0 4 
-40 2 1 5 3 2 1 3 0 2 3 
10 2 1 5 3 2 1 3 0 2 5 4 
-40 2 1 5 3 2 1 3 0 2 4 
40 2 1 5 3 2 1 3 0 2 5 5 1 
110 2 1 5 3 2 1 3 0 2 5 5 5 2 
10 2 1 5 3 2 1 3 0 2 5 4 
60 2 1 5 3 2 1 3 0 2 5 5 4 
115 2 1 5 3 2 1 3 0 2 5 5 5 3 4 
-40 2 1 5 3 2 1 3 0 2 0 
10 2 1 5 3 2 1 3 0 2 5 2 
60 2 1 5 3 2 1 3 0 2 5 5 1 
-40 2 1 5 3 2 1 3 0 2 0 
10 2 1 5 3 2 1 3 0 2 5 4 
65 2 1 5 3 2 1 3 0 2 5 0 5 2 
115 2 1 5 3 2 1 3 0 2 5 5 5 0 0 
60 2 1 5 3 2 1 3 0 2 5 5 2 
-40 2 1 5 3 2 1 3 0 2 2 
-40 2 1 5 3 2 1 3 0 2 1 
60 2 1 5 3 2 1 3 0 2 5 5 4 
60 2 1 5 3 2 1 3 0 2 5 5 1 
10 2 1 5 3 2 1 3 0 2 5 2 
60 2 1 5 3 2 1 3 0 2 5 5 3 
110 2 1 5 3 2 1 3 0 2 5 5 5 1 
110 2 1 5 3 2 1 3 0 2 5 5 5 5 
60 2 1 5 3 2 1 3 0 2 5 5 4 
115 2 1 5 3 2 1 3 0 2 5 0 4 1 5 3 
-40 2 1 5 3 2 1 3 0 2 0 
-40 2 1 5 3 2 1 3 0 2 3 
20 2 1 5 3 2 1 3 0 2 5 0 0 0 
60 2 1 5 3 2 1 3 0 2 5 5 3 
70 2 1 5 3 2 1 3 0 2 5 5 5 3 
110 2 1 5 3 2 1 3 0 2 5 5 5 5 
10 2 1 5 3 2 1 3 0 2 5 2 
110 2 1 5 3 2 1 3 0 2 5 5 5 4 
10 2 1 5 3 2 1 3 0 2 5 1 
15 2 1 5 3 2 1 3 0 2 5 0 2 
10 2 1 5 3 2 1 3 0 2 5 4 
-40 2 1 5 3 2 1 3 0 2 2 
10 2 1 5 3 2 1 3 0 2 5 2 
-40 2 1 5 3 2 1 3 0 2 2 
60 2 1 5 3 2 1 3 0 2 5 5 2 
15 2 1 5 3 2 1 3 0 2 5 3 5 
60 2 1 5 3 2 1 3 0 2 5 5 1 
60 2 1 5 3 2 1 3 0 2 5 5 2 
110 2 1 5 3 2 1 3 0 2 5 5 5 2 
50 2 1 5 3 2 1 3 0 2 5 3 4 3 3 0 
15 2 1 5 3 2 1 3 0 2 5 0 2 
110 2 1 5 3 2 1 3 0 2 5 5 5 2 
60 2 1 5 3 2 1 3 0 2 5 5 1 
10 2 1 5 3 2 1 3 0 2 5 2 
60 2 1 5 3 2 1 3 0 2 5 5 4 
-40 2 1 5 3 2 1 3 0 2 4 
-40 2 1 5 3 2 1 3 0 2 2 
60 2 1 5 3 2 1 3 0 2 5 5 3 
10 2 1 5 3 2 1 3 0 2 5 2 
65 2 1 5 3 2 1 3 0 2 5 5 0 1 
60 2 1 5 3 2 1 3 0 2 5 5 2 
15 2 1 5 3 2 1 3 0 2 5 0 0 
60 2 1 5 3 2 1 3 0 2 5 5 2 
110 2 1 5 3 2 1 3 0 2 5 5 5 5 
10 2 1 5 3 2 1 3 0 2 5 4 
110 2 1 5 3 2 1 3 0 2 5 5 5 0 
-40 2 1 5 3 2 1 3 0 2 2 
60 2 1 5 3 2 1 3 0 2 5 5 0 
45 2 1 5 3 2 1 3 0 2 5 3 4 3 1 
10 2 1 5 3 2 1 3 0 2 5 1 
-40 2 1 5 3 2 1 3 0 2 2 
-40 2 1 5 3 2 1 3 0 2 3 
-80 2 1 5 3 2 1 3 0 2 0 
10 2 1 5 3 2 1 3 0 2 5 4 
-40 2 1 5 3 2 1 3 0 2 1 
110 2 1 5 3 2 1 3 0 2 5 5 5 1 
15 2 1 5 3 2 1 3 0 2 5 0 1 
15 2 1 5 3 2 1 3 0 2 5 3 2 
65 2 1 5 3 2 1 3 0 2 5 5 0 1 
