90 3 4 5 5 6 4 1 4 5 5 4 
80 4 6 6 2 5 6 4 1 
55 4 2 1 2 2 5 1 3 5 5 1 
45 6 3 2 5 5 3 4 6 5 
40 5 2 2 5 4 1 1 6 4 3 4 
30 4 6 6 5 5 6 1 
20 4 6 6 2 5 6 4 5 3 3 2 
20 4 6 6 2 5 6 4 3 5 5 
0 6 6 4 1 6 5 3 3 1 
0 2 3 2 5 4 4 4 2 5 6 
-10 4 6 6 2 5 6 4 3 1 
-10 1 1 4 4 5 2 2 1 5 6 
-15 1 1 3 5 6 4 5 3 6 4 2 
-25 4 6 6 2 5 6 4 4 
-25 4 6 6 2 5 6 4 1 
-25 4 6 6 2 5 6 4 4 
-30 4 6 6 2 5 6 4 3 2 
-30 4 2 2 5 3 1 1 3 4 1 
-35 4 6 6 2 5 6 4 2 
-35 4 6 6 2 5 6 4 2 
-40 4 6 6 2 5 6 3 
-40 4 6 6 2 5 5 4 6 
-45 4 6 6 2 5 6 6 
-45 4 6 6 2 5 6 1 
-45 2 2 4 1 1 3 6 5 
-45 2 4 1 5 5 6 5 6 
-50 4 6 6 2 5 6 5 
-50 3 1 1 5 1 2 6 6 
-50 4 6 6 2 5 6 4 1 
-50 4 3 1 1 1 2 2 1 2 2 
-50 2 1 5 5 3 2 5 1 
-50 4 6 6 2 5 6 4 4 
-55 4 6 6 2 5 6 6 
-60 4 6 6 2 5 6 2 
-60 4 6 6 2 5 6 3 
-60 4 6 6 2 5 6 1 
-60 4 6 6 2 5 6 1 
-60 6 2 2 6 5 
-60 4 2 3 1 5 1 4 6 6 
-60 5 1 2 1 5 5 4 4 
-70 4 6 6 2 5 6 5 
-70 4 5 1 2 6 3 2 1 
-75 4 6 6 2 5 6 5 
-75 2 4 2 2 5 5 3 6 
-80 4 6 6 2 5 6 1 
-80 5 4 6 1 4 4 2 2 
-85 4 6 6 2 5 5 3 6 
-85 2 1 1 2 1 4 2 6 
-90 5 3 1 6 5 6 3 
-90 1 5 3 6 1 2 4 3 2 
-95 4 6 6 2 5 6 2 
-95 5 6 2 2 3 4 2 
-100 4 4 2 5 3 2 1 1 6 
-110 4 6 6 2 5 3 6 
-110 4 6 6 2 5 2 
-115 5 6 4 6 1 3 3 1 
-115 4 6 6 2 5 3 1 
-120 4 1 6 2 1 4 3 6 
-120 5 4 6 1 6 3 2 
-125 4 6 6 2 5 3 1 
-125 6 6 2 2 2 
-125 6 5 4 3 3 3 5 1 5 
-130 4 6 6 2 5 1 
-135 4 6 6 2 5 1 
