999999 2 4 3 2 3 2 6 6 4 5 6 6 2 3 3 5 4 
999994 2 4 3 2 3 2 6 6 4 5 6 6 5 4 5 4 
999994 2 4 3 2 3 2 6 6 4 5 6 6 3 6 6 
999994 2 4 3 2 3 2 6 6 4 5 6 6 5 6 5 
999994 2 4 3 2 3 2 6 6 4 5 6 6 5 4 5 6 
999994 2 4 3 2 3 2 6 6 4 5 6 6 5 4 5 4 
999994 2 4 3 2 3 2 6 6 4 5 6 6 5 6 3 1 
999994 2 4 3 2 3 2 6 6 4 5 6 6 5 6 6 
999994 2 4 3 2 3 2 6 6 4 5 6 6 5 4 6 
999994 2 4 3 2 3 2 6 6 4 5 6 6 5 4 5 5 
999994 2 4 3 2 3 2 6 6 4 5 6 6 5 4 5 4 
999994 2 4 3 2 3 2 6 6 4 5 6 6 5 4 6 
999994 2 4 3 2 3 2 6 6 4 5 6 6 5 3 6 4 
290 2 4 3 2 3 2 6 6 4 5 6 6 5 4 2 
290 2 4 3 2 3 2 6 6 4 5 6 6 5 4 3 
290 2 4 3 2 3 2 6 6 4 5 6 6 5 4 1 
290 2 4 3 2 3 2 6 6 4 5 6 6 5 4 2 
290 2 4 3 2 3 2 6 6 4 5 6 6 5 4 1 
290 2 4 3 2 3 2 6 6 4 5 6 6 5 1 2 
290 2 4 3 2 3 2 6 6 4 5 6 6 5 4 4 
290 2 4 3 2 3 2 6 6 4 5 6 6 5 4 2 
290 2 4 3 2 3 2 6 6 4 5 6 6 5 4 4 
290 2 4 3 2 3 2 6 6 4 5 6 6 5 4 3 
285 2 4 3 2 3 2 6 6 4 5 6 6 3 6 2 
270 2 4 3 2 3 2 6 6 4 5 6 6 3 5 5 
265 2 4 3 2 3 2 6 6 4 5 6 6 5 2 
265 2 4 3 2 3 2 6 6 4 5 6 6 5 2 
265 2 4 3 2 3 2 6 6 4 5 6 6 5 2 
265 2 4 3 2 3 2 6 6 4 5 6 6 5 2 
265 2 4 3 2 3 2 6 6 4 5 6 6 5 5 
265 2 4 3 2 3 2 6 6 4 5 6 6 5 2 
265 2 4 3 2 3 2 6 6 4 5 6 6 5 2 
240 2 4 3 2 3 2 6 6 4 5 6 6 1 6 
90 2 4 4 5 1 3 6 3 6 4 5 3 2 
55 5 6 6 5 4 3 5 5 3 
40 1 4 4 5 3 1 2 4 3 4 5 3 3 4 4 
20 3 4 5 5 3 2 6 5 4 3 
15 4 1 1 3 4 5 5 5 6 6 
10 4 6 6 4 1 4 1 5 3 3 1 
5 5 6 6 5 4 5 3 2 
-5 3 6 2 4 3 1 3 1 4 3 6 3 
-5 3 6 1 6 6 1 5 2 
-15 3 3 6 3 2 6 3 4 6 5 
-30 2 5 4 2 4 1 1 4 2 
-35 4 5 3 2 1 6 2 4 
-35 5 4 5 2 6 1 3 2 
-40 6 5 1 1 1 1 5 1 
-45 4 2 2 6 6 3 3 
-50 2 5 4 2 5 3 1 5 
-50 5 2 1 3 4 4 4 2 4 
-50 6 6 5 5 1 2 
-55 2 2 1 2 1 2 6 
-55 2 2 6 1 1 1 3 4 
-55 3 1 4 6 4 1 1 2 3 1 
-55 6 3 2 5 3 1 5 1 
-60 4 1 1 4 5 3 1 6 5 
-60 4 6 2 2 3 2 2 
-60 3 5 1 2 5 6 2 
-65 5 4 3 3 2 1 4 4 3 4 2 
-65 4 5 6 5 5 6 
-70 6 5 4 5 3 3 3 3 1 1 
-70 5 3 6 6 5 5 
-80 4 2 2 2 2 6 
-85 6 4 6 4 3 3 1 3 6 
