100 4 3 1 3 1 6 5 2 6 4 6 2 
60 3 5 6 3 5 4 4 4 3 5 3 5 2 
50 6 6 4 1 1 4 4 5 5 1 
45 4 1 2 5 2 2 4 5 4 3 
35 4 4 2 5 1 5 1 4 6 5 
25 5 2 4 5 3 1 4 2 5 2 
20 1 3 3 2 4 5 5 2 6 1 
20 5 1 4 3 3 4 1 4 2 1 6 3 
20 4 4 3 5 4 4 2 1 3 1 6 2 
5 3 1 6 4 6 5 4 5 1 
5 6 1 4 3 5 6 4 5 1 
-25 1 4 5 1 1 2 3 2 4 3 
-25 5 4 2 3 2 2 5 6 
-25 1 2 1 5 1 4 2 4 3 1 
-30 2 5 5 2 1 1 1 4 
-35 2 1 4 6 4 3 4 5 1 
-35 5 4 6 1 3 4 2 4 2 
-35 1 1 2 6 5 5 3 1 
-40 2 2 5 4 1 6 2 
-45 1 1 1 2 1 4 5 3 4 3 1 
-45 3 1 6 4 6 5 4 1 
-50 2 1 4 4 1 4 4 4 3 1 2 
-50 1 2 2 3 3 1 4 6 5 5 
-55 3 2 2 4 6 3 2 5 
-55 1 3 5 4 1 6 2 3 4 
-60 6 6 2 6 1 
-65 3 1 6 4 6 5 6 5 
-65 3 1 6 4 6 5 6 5 
-65 3 1 6 4 6 5 6 5 
-65 3 1 6 4 6 5 6 5 
-65 3 1 6 4 6 5 6 5 
-65 3 1 6 4 6 5 6 5 
-65 3 1 6 4 6 5 6 
-65 3 1 6 4 6 5 6 
-65 3 1 6 4 6 5 6 
-65 3 1 6 4 6 5 6 
-65 3 1 6 4 6 5 6 5 
-65 3 1 6 4 6 5 6 
-65 3 1 6 4 6 5 6 5 
-65 3 1 6 4 6 5 6 5 
-65 3 1 6 4 6 5 3 2 
-65 3 1 6 4 6 5 6 
-65 3 1 6 4 6 5 6 
-65 3 1 6 4 6 5 6 
-65 4 2 5 1 4 6 5 
-65 3 1 6 4 6 5 6 
-65 3 1 6 4 6 5 6 5 
-65 3 1 6 4 6 5 6 5 
-65 3 1 6 4 6 5 6 5 
-65 3 1 6 4 6 5 6 
-65 3 1 6 4 6 5 6 
-65 3 1 6 4 6 5 6 
-65 3 1 6 4 6 5 6 5 
-65 3 1 6 4 6 5 6 5 
-70 3 1 6 4 6 5 2 
-70 3 1 6 4 6 5 5 
-70 3 1 6 4 6 5 6 
-70 6 4 3 3 2 4 3 5 3 5 
-70 3 1 6 4 6 5 6 
-75 3 6 6 3 6 4 1 
-75 6 5 1 4 6 2 
-80 6 3 1 6 6 5 
-95 2 3 6 2 1 3 3 3 6 
-115 6 2 3 3 6 6 
