105 5 5 3 2 6 4 6 5 5 1 
105 5 5 3 2 6 4 6 5 5 4 
105 5 5 3 2 6 4 6 4 1 5 1 
105 5 5 3 2 6 4 6 5 5 5 
55 5 5 3 2 6 4 6 5 3 
55 5 5 3 2 6 4 6 5 6 
55 5 5 3 2 6 4 6 5 4 
55 5 5 3 2 6 4 6 5 2 
55 5 5 3 2 6 4 6 5 3 
55 5 5 3 2 6 4 6 5 6 
55 5 5 3 2 6 4 6 5 3 
55 5 5 3 2 6 4 6 5 3 
55 5 5 3 2 6 4 6 5 4 
55 5 5 3 2 6 4 6 5 3 
35 5 5 3 2 6 4 6 4 3 6 
35 1 3 2 2 2 4 3 1 1 5 1 1 
30 5 5 3 2 6 4 6 4 2 
30 5 5 3 2 6 4 6 4 5 
15 4 3 1 2 5 6 5 5 1 
15 5 6 4 6 2 6 3 
10 5 5 3 2 6 4 6 3 6 
10 5 5 3 2 6 4 3 6 2 
10 5 5 3 2 6 4 6 3 1 
5 5 1 5 3 3 1 5 5 5 6 
5 5 5 3 2 6 4 6 6 
5 5 5 3 2 6 4 6 6 
5 5 5 3 2 6 4 6 2 
5 5 5 3 2 6 4 6 6 
0 3 4 6 1 2 3 2 1 3 5 6 
-5 3 3 6 5 5 1 5 5 2 
-5 1 6 2 3 6 1 6 6 
-30 5 5 2 1 5 4 4 1 
-30 4 5 1 5 4 4 1 2 1 
-35 6 2 3 2 2 2 4 
-35 3 6 5 2 4 1 5 3 
-35 5 4 4 1 1 2 6 6 
-45 2 3 4 5 5 1 5 3 4 
-45 2 2 1 5 3 2 1 3 2 
-45 3 1 5 4 2 4 5 3 1 4 
-50 6 4 3 3 2 5 5 3 3 
-50 5 5 3 2 6 4 3 3 2 
-55 4 3 6 3 5 4 1 5 3 
-55 5 5 3 2 6 4 3 2 
-55 5 3 3 2 5 6 1 4 
-55 3 4 6 4 6 6 6 
-55 5 5 3 2 6 4 3 4 
-60 5 5 3 2 6 4 2 
-60 5 5 3 2 6 4 5 
-60 5 5 3 2 6 4 5 
-60 5 5 3 2 6 4 5 
-60 4 1 6 2 1 3 2 5 
-60 5 5 3 2 6 4 5 
-60 2 6 2 3 2 1 2 
-60 5 5 3 2 6 4 2 
-60 4 5 1 3 6 2 1 1 
-60 2 3 4 1 6 2 4 1 
-70 3 4 6 1 3 2 2 3 3 1 
-75 4 5 5 3 2 2 2 
-75 2 3 1 5 4 2 1 5 
-75 1 3 2 5 4 1 5 5 
-80 6 1 3 1 1 5 4 5 
-85 4 6 5 1 4 3 4 5 
-90 2 4 3 1 3 2 1 3 1 6 
-100 4 6 3 3 5 2 3 6 
