115 4 4 4 2 3 1 5 5 6 5 5 4 
115 4 4 4 2 3 1 5 5 6 5 5 5 
105 4 4 4 2 3 1 5 5 6 3 4 3 5 4 
70 1 2 4 1 2 5 2 5 5 6 
65 4 4 4 2 3 1 5 5 6 5 6 
65 4 4 4 2 3 1 5 5 6 5 4 
65 4 4 4 2 3 1 5 5 6 5 2 
65 4 4 4 2 3 1 5 5 6 5 1 
65 4 4 4 2 3 1 5 5 6 5 2 
65 4 4 4 2 3 1 5 5 6 5 6 
65 4 4 4 2 3 1 5 5 6 5 4 
65 4 4 4 2 3 1 5 5 6 5 1 
40 6 6 1 1 1 5 6 4 6 
35 1 5 5 2 2 5 6 1 
35 2 3 3 6 2 2 1 6 4 2 
25 4 4 4 2 3 1 5 5 1 5 4 
20 4 4 4 2 3 1 5 5 3 6 2 
20 2 1 1 3 5 5 4 3 4 6 6 
20 4 4 4 2 3 1 5 5 6 3 5 
15 2 4 2 4 3 4 1 5 6 2 
15 4 4 4 2 3 1 5 5 6 1 
15 4 4 4 2 3 1 5 5 6 1 
15 4 4 4 2 3 1 5 5 6 6 
15 4 4 4 2 3 1 5 5 6 6 
15 4 4 4 2 3 1 5 5 6 2 
15 4 4 4 2 3 1 5 5 6 6 
15 4 4 4 2 3 1 5 5 6 2 
15 4 4 4 2 3 1 5 5 6 4 
10 6 5 2 5 3 4 6 3 1 
-5 5 6 3 6 5 6 4 
-10 3 6 4 1 6 3 1 3 1 5 2 
-25 4 4 4 2 3 1 5 5 1 4 
-25 4 4 4 2 3 1 5 5 1 3 
-25 4 4 4 2 3 1 5 5 1 4 
-25 4 4 4 2 3 1 5 5 1 1 
-25 2 1 5 4 4 4 4 2 3 
-25 4 4 4 2 3 1 5 5 4 1 
-25 4 4 4 2 3 1 5 5 4 2 
-25 1 5 5 3 5 4 4 1 4 2 
-30 2 2 5 4 1 1 5 2 
-35 6 4 5 4 3 4 4 2 6 
-35 2 6 3 5 4 1 4 1 4 
-40 6 5 5 2 5 4 
-40 5 2 6 1 1 5 1 
-40 4 4 4 2 3 1 5 5 3 3 4 
-45 6 5 1 3 6 2 4 
-45 4 3 2 6 1 6 1 3 
-45 4 4 4 2 3 1 5 5 3 4 
-45 6 4 1 1 5 6 3 2 
-50 4 4 4 2 3 1 5 5 5 
-50 2 2 5 2 2 3 2 
-50 1 1 5 4 4 2 3 5 6 
-50 4 4 4 2 3 1 5 5 5 
-50 4 4 4 2 3 1 5 5 2 
-50 5 1 4 3 2 4 5 4 4 
-55 4 6 5 4 3 3 2 1 2 
-55 4 6 3 1 4 2 3 4 4 5 
-55 1 3 3 5 6 1 2 4 5 
-55 1 2 1 2 2 5 6 
-55 6 6 3 5 6 4 
-60 3 6 1 1 1 5 5 2 
-60 6 1 2 2 5 3 5 
-65 4 1 2 2 6 1 5 
-80 4 3 3 3 5 3 3 2 1 5 5 
