110 5 3 4 3 5 1 3 5 1 1 5 5 5 2 
55 5 3 1 2 2 1 1 1 3 6 4 5 4 2 
20 4 4 4 5 4 2 4 2 5 6 
10 3 1 4 3 1 1 4 3 2 5 4 5 4 
-15 5 3 1 2 2 1 1 1 3 6 4 3 1 
-20 5 3 1 2 2 1 1 1 3 6 4 4 
-20 5 3 1 2 2 1 1 1 3 6 4 1 
-20 5 3 1 2 2 1 1 1 3 6 4 6 2 
-20 5 3 1 2 2 1 1 1 3 6 4 2 
-20 5 3 1 2 2 1 1 1 3 6 4 4 
-20 5 3 1 2 2 1 1 1 3 6 4 2 
-20 5 3 1 2 2 1 1 1 3 6 4 6 6 
-20 5 3 1 2 2 1 1 1 3 6 4 4 
-20 5 3 1 2 2 1 1 1 3 6 4 4 
-25 1 1 5 2 1 2 4 4 3 2 
-25 4 3 5 1 2 2 4 1 1 6 
-25 4 2 4 2 5 1 2 3 1 
-30 3 1 3 3 3 1 2 1 5 1 1 6 4 6 4 
-30 5 2 2 1 6 1 6 4 5 6 4 
-40 3 4 4 4 3 4 4 2 3 4 4 4 6 
-45 5 3 1 2 2 1 1 1 3 6 2 
-45 5 3 1 2 2 1 1 1 3 5 
-45 5 3 1 2 2 1 1 1 3 1 
-45 5 3 1 2 2 1 1 1 3 6 5 
-45 5 3 1 2 2 1 1 1 3 6 3 
-45 5 3 1 2 2 1 1 1 3 6 6 
-45 5 3 1 2 2 1 1 1 3 1 
-45 5 3 1 2 2 1 1 1 3 6 5 
-45 5 3 1 2 2 1 1 1 3 2 
-45 5 3 1 2 2 1 1 1 3 6 2 
-45 5 3 1 2 2 1 1 1 3 2 
-45 5 3 1 2 2 1 1 1 3 6 3 
-45 5 3 1 2 2 1 1 1 3 6 3 
-45 5 3 1 2 2 1 1 1 3 6 6 
-45 5 3 1 2 2 1 1 1 3 6 6 
-45 5 3 1 2 2 1 1 1 3 6 3 
-45 5 3 1 2 2 1 1 1 3 6 6 
-45 5 3 1 2 2 1 1 1 3 6 5 
-45 5 3 1 2 2 1 1 1 3 6 6 
-45 5 3 1 2 2 1 1 1 3 6 3 
-45 5 3 1 2 2 1 1 1 3 6 1 
-45 5 3 1 2 2 1 1 1 3 4 
-45 2 1 4 5 3 1 3 5 4 5 
-45 4 1 5 2 2 3 4 4 3 5 
-50 3 5 4 4 1 5 5 4 5 
-55 5 2 4 6 1 4 4 5 6 
-65 3 4 3 3 5 5 1 2 1 2 
-85 4 3 2 1 3 3 2 2 3 6 
-100 4 2 6 5 1 3 2 1 
-100 1 2 4 5 1 3 4 6 4 
-100 5 2 1 1 5 6 3 1 
-100 4 2 2 5 6 1 3 3 
-100 2 6 3 5 2 5 4 
-105 5 6 2 5 5 4 
-105 1 6 5 1 2 2 2 
-105 6 1 4 1 4 6 1 5 1 2 
-120 2 3 3 5 4 5 6 6 6 
-120 4 6 3 1 5 4 1 4 6 3 2 
-120 5 1 3 5 3 2 6 1 
-125 4 4 3 1 4 5 6 1 2 
-125 2 3 2 1 6 1 4 6 
-170 6 1 4 3 3 1 6 1 6 4 2 
-175 4 2 6 2 3 6 1 
-175 2 3 1 2 6 6 2 
