60 2 1 5 5 6 1 5 5 4 
30 2 1 5 5 6 3 6 4 2 
15 2 3 4 4 5 2 5 6 3 
10 2 1 5 5 6 1 5 2 
5 2 1 5 5 6 3 6 1 
5 2 1 5 5 6 3 6 2 
5 2 1 5 5 6 3 6 6 
5 2 1 5 5 6 3 6 2 
5 2 1 5 5 6 3 6 6 
5 2 1 5 5 6 3 6 6 
5 2 1 5 5 6 3 6 6 
5 2 1 5 5 6 3 6 6 
0 5 1 3 3 6 6 1 6 6 
0 5 6 4 5 6 5 6 
0 3 5 1 4 6 5 4 3 5 2 
-5 2 1 5 5 6 3 3 5 4 
-5 5 6 3 6 4 1 6 1 
-30 2 2 4 5 4 5 1 1 
-40 1 5 1 6 2 5 3 
-40 2 1 5 5 6 4 1 
-40 2 1 5 5 6 4 3 
-40 2 1 5 5 6 1 2 
-40 2 1 5 5 6 4 6 
-40 2 1 5 5 6 4 6 
-40 2 1 5 5 6 4 4 
-50 4 5 6 3 1 6 1 1 
-50 1 5 6 5 6 4 
-55 2 1 5 5 6 3 3 6 
-55 5 2 2 4 5 4 6 
-60 2 1 5 5 6 3 2 
-60 2 1 5 5 6 3 4 
-60 2 1 5 5 6 3 4 
-60 2 1 5 5 6 3 5 
-60 2 1 5 5 6 3 2 
-60 2 1 5 5 6 3 2 
-60 3 2 5 6 4 5 2 
-60 2 1 2 6 4 1 3 2 
-60 6 2 6 6 6 
-60 6 1 2 5 1 3 4 5 
-60 6 1 4 5 3 1 4 1 2 
-60 4 1 6 5 3 1 2 1 
-60 6 5 1 4 4 5 3 4 
-60 2 1 5 5 6 3 2 
-60 4 1 2 5 6 3 4 5 
-65 5 6 1 3 5 4 4 5 
-65 2 5 4 5 6 5 
-65 2 1 5 5 6 5 
-65 2 1 5 5 6 2 
-65 5 4 6 5 5 2 
-65 2 1 5 5 6 5 
-65 2 1 5 5 6 5 
-65 2 1 5 5 6 5 
-65 2 1 5 5 6 5 
-65 2 1 5 5 6 5 
-70 4 6 2 4 6 3 5 
-70 3 4 6 6 5 4 4 
-75 6 5 1 6 4 6 
-80 2 6 3 5 3 2 5 
-95 5 3 6 6 1 5 
-100 6 2 1 6 6 
-110 6 4 5 4 1 3 3 
-135 6 3 1 5 1 3 
-180 2 5 1 3 
-205 6 3 4 3 4 
