-45 2 1 4 5 5 2 3 1 
-45 2 1 4 5 5 2 3 1 5 5 
-50 2 1 4 5 5 2 3 2 
-45 2 1 4 5 5 2 3 1 
-50 2 1 4 5 5 2 3 2 
-50 2 1 4 5 5 2 3 2 
-50 2 1 4 5 5 2 3 1 
-45 2 1 4 5 5 2 3 1 5 
-45 2 1 4 5 5 2 3 1 5 5 
-45 2 1 4 5 5 2 3 1 
-45 2 1 4 5 5 2 3 1 
-45 2 1 4 5 5 2 3 1 5 
-45 2 1 4 5 5 2 3 1 5 
-50 2 1 4 5 5 2 3 4 
-45 2 1 4 5 5 2 3 1 5 5 
-45 2 1 4 5 5 2 3 1 5 
-45 2 1 4 5 5 2 3 1 5 5 
-45 2 1 4 5 5 2 3 1 
-45 2 1 4 5 5 2 3 1 5 5 
-45 2 1 4 5 5 2 3 1 
-45 2 1 4 5 5 2 3 1 5 5 
-45 2 1 4 5 5 2 3 1 5 
-50 2 1 4 5 5 2 3 2 
-45 2 1 4 5 5 2 3 1 5 
-45 2 1 4 5 5 2 3 1 5 
-45 2 1 4 5 5 2 3 1 5 5 
-45 2 1 4 5 5 2 3 1 
-45 2 1 4 5 5 2 3 1 
-50 2 1 4 5 5 2 3 2 
-45 2 1 4 5 5 2 3 1 5 5 
-45 2 1 4 5 5 2 3 1 5 
-45 2 1 4 5 5 2 3 3 1 
-115 3 5 1 6 6 5 5 3 1 
-115 3 5 5 6 1 3 2 1 
-100 2 4 2 3 6 2 1 1 
-100 3 6 5 4 5 4 4 4 4 
-50 6 5 2 5 1 3 4 5 1 
-125 5 2 3 1 1 6 3 3 3 3 4 
-120 2 1 3 4 4 5 6 2 
-120 2 5 5 4 6 3 5 
-125 5 1 4 6 1 5 2 
-125 6 2 5 5 1 2 
-125 1 2 5 6 5 2 
-140 3 2 3 6 1 1 1 1 2 
-140 3 5 6 1 3 1 2 5 
-140 5 1 6 3 4 2 3 2 
-140 1 3 6 4 5 3 5 2 
-140 5 6 5 3 3 5 5 
-145 1 3 4 6 5 5 6 
-165 6 3 4 4 4 3 5 6 
-165 3 5 2 6 1 3 6 
-170 3 6 6 5 1 2 2 
-175 6 6 5 1 1 4 3 3 
-175 5 6 4 1 6 4 4 
-175 4 6 6 4 4 2 1 
-190 6 2 6 3 4 3 1 6 6 
-190 5 4 6 6 3 4 3 4 
-195 6 2 3 6 2 5 
-200 4 2 1 6 6 5 
-210 6 3 6 3 1 5 3 5 
-220 3 6 5 6 4 6 
-225 2 1 6 6 6 
-245 6 5 3 6 6 6 
-250 5 6 6 6 4 
