20 2 4 4 5 1 2 5 5 1 
-5 2 4 4 5 1 2 5 4 6 
-5 2 4 4 5 1 2 5 1 6 
-25 2 4 4 5 1 2 5 3 6 
-30 2 4 4 5 1 2 5 2 
-45 3 6 5 4 6 5 6 
-50 1 3 4 3 4 6 1 4 1 1 4 
-70 6 6 4 1 3 2 6 
-70 3 6 6 5 2 3 
-70 6 6 5 3 4 4 1 
-70 6 6 5 3 2 1 
-75 2 4 4 5 1 2 3 1 
-75 2 4 4 5 1 2 3 6 
-75 2 4 4 5 1 2 3 2 
-105 1 4 4 5 5 4 2 
-155 6 4 3 5 3 1 
-155 2 1 6 3 3 1 
-380 2 4 4 5 1 2 5 
-380 2 4 4 5 1 2 5 
-380 2 4 4 5 1 2 5 
-395 2 2 3 6 5 
-405 2 4 4 5 1 2 
-405 2 4 4 5 1 2 
-405 2 4 4 5 1 2 
-405 2 4 4 5 1 2 
-455 2 4 4 5 1 
-480 5 1 4 1 5 
-525 3 4 1 2 
-550 3 4 2 4 
-560 6 3 
