90 5 6 6 2 6 5 5 5 
70 6 1 5 2 4 1 2 5 3 4 6 
40 1 2 2 6 4 5 3 5 1 1 
15 4 5 3 2 1 6 4 1 5 1 
15 4 5 3 2 1 6 4 1 5 1 
10 6 1 2 6 4 1 5 3 3 6 
5 4 5 3 2 1 6 4 6 4 
5 4 5 3 2 1 6 4 6 2 
0 3 2 6 4 3 6 4 6 6 
-30 4 5 3 2 1 6 4 1 6 4 5 
-30 4 5 3 2 1 6 4 1 6 4 4 
-30 4 5 3 2 1 6 4 1 6 4 5 
-30 4 5 3 2 1 6 4 1 6 4 5 
-30 4 5 3 2 1 6 4 1 6 4 3 
-30 4 5 3 2 1 6 4 1 6 4 5 
-30 4 5 3 2 1 6 4 1 6 4 6 
-30 4 5 3 2 1 6 4 1 6 4 1 
-30 4 5 3 2 1 6 4 1 6 4 2 
-30 4 5 3 2 1 6 4 1 6 4 5 
-30 4 5 3 2 1 6 4 1 6 4 5 
-30 4 5 3 2 1 6 4 1 6 4 6 
-30 4 5 3 2 1 6 4 1 6 4 5 
-30 4 5 3 2 1 6 4 1 6 4 5 
-30 4 5 3 2 1 6 4 1 6 4 6 
-30 4 5 3 2 1 6 4 1 6 4 5 
-30 4 5 3 2 1 6 4 1 6 4 5 
-30 4 5 3 2 1 6 4 1 6 4 2 
-30 4 5 3 2 1 6 4 1 6 4 5 
-30 4 5 3 2 1 6 4 1 6 4 3 
-30 4 5 3 2 1 6 4 1 6 4 5 
-30 4 5 3 2 1 6 4 1 6 4 5 
-30 4 5 3 2 1 6 4 1 6 4 5 
-30 4 5 3 2 1 6 4 1 6 4 4 
-30 4 5 3 2 1 6 4 1 6 4 1 
-30 4 5 3 2 1 6 4 1 6 4 6 
-30 4 5 3 2 1 6 4 1 6 4 5 
-30 3 2 3 6 4 4 2 5 6 
-35 4 5 3 2 1 6 4 1 3 
-35 4 5 3 2 1 6 4 1 6 5 
-35 4 5 3 2 1 6 4 1 6 6 
-35 4 5 3 2 1 6 4 1 6 6 
-35 4 5 3 2 1 6 4 1 6 5 
-35 4 5 3 2 1 6 4 1 6 3 
-35 4 5 3 2 1 6 4 1 6 
-35 4 5 3 2 1 6 4 1 6 3 
-35 4 5 3 2 1 6 4 1 6 4 
-35 4 5 3 2 1 6 4 1 6 1 
-35 4 5 3 2 1 6 4 1 6 1 
-35 4 5 3 2 1 6 4 1 1 
-35 4 5 3 2 1 6 4 1 4 
-35 4 5 3 2 1 6 4 1 6 3 
-35 4 5 3 2 1 6 4 1 6 6 
-35 4 5 3 2 1 6 4 1 6 4 
-35 4 5 3 2 1 6 4 1 6 5 
-35 4 5 3 2 1 6 4 1 6 6 
-55 4 5 3 2 1 6 4 3 1 
-55 3 6 5 3 1 5 2 6 
-130 2 1 2 5 1 
-175 6 6 4 
-175 1 4 2 1 3 5 
-410 4 5 3 2 1 6 4 1 
-410 4 5 3 2 1 6 4 1 
-410 4 5 3 2 1 6 4 1 
-425 3 4 1 1 1 2 4 1 
-430 5 2 5 2 
-450 6 6 5 4 
-500 5 2 4 3 
-505 3 5 2 6 3 6 
-515 4 6 2 
-540 4 6 4 
