125 4 6 6 2 5 6 4 3 2 
115 4 6 6 2 5 6 4 5 3 3 
70 4 6 6 5 5 6 4 2 
70 1 1 3 5 6 4 5 3 6 4 5 4 
65 4 6 6 2 5 6 4 5 4 
60 4 6 6 2 5 6 4 1 
45 6 6 4 1 6 5 3 5 6 
30 3 4 5 5 6 4 1 4 5 
25 4 2 1 2 2 5 1 3 
15 4 6 6 2 5 6 4 3 2 
10 1 1 4 4 5 2 2 1 5 2 
10 5 2 2 5 4 1 1 6 4 
5 4 6 6 2 5 6 3 
-10 4 6 6 2 5 6 4 4 
-25 4 6 6 2 5 5 6 
-30 2 4 1 5 5 6 5 3 2 
-45 4 6 6 2 4 4 5 4 
-70 2 3 2 5 4 4 4 2 
-90 4 6 6 2 5 4 
-95 2 2 4 1 1 3 5 4 2 
-95 4 6 6 2 1 1 3 
-100 4 3 1 1 1 2 2 5 4 
-110 3 4 5 5 6 4 1 4 5 
-115 3 4 5 5 6 4 1 4 5 5 
-115 3 4 5 5 6 4 1 4 5 5 
-115 3 4 5 5 6 4 1 4 
-115 3 4 5 5 6 4 1 4 5 
-115 3 4 5 5 6 4 1 4 
-115 3 4 5 5 6 4 1 4 5 5 
-115 3 4 5 5 6 4 1 4 5 
-125 3 4 5 5 6 4 1 4 
-125 3 4 5 5 6 4 1 4 5 5 
-125 2 1 5 5 3 2 6 
-125 3 1 1 5 1 2 5 5 
-130 3 4 5 5 6 4 1 4 5 5 
-130 3 4 5 5 6 4 1 4 
-135 3 4 5 5 6 4 1 4 
-135 3 4 5 5 6 4 1 4 5 
-140 3 4 5 5 6 4 1 4 5 5 
-140 3 4 5 5 6 4 1 4 
-145 3 4 5 5 6 4 1 4 5 5 
-145 3 4 5 5 6 4 1 4 
-150 3 4 5 5 6 4 1 4 5 5 
-150 3 4 5 5 6 4 1 4 5 5 
-155 3 4 5 5 6 4 1 4 
-165 3 4 5 5 6 4 1 4 5 
-165 3 4 5 5 6 4 1 4 5 5 
-170 3 4 5 5 6 4 1 4 5 5 
-170 3 4 5 5 6 4 1 4 
-175 3 4 5 5 6 4 1 4 
-175 3 4 5 5 6 4 1 4 5 5 
-180 3 4 5 5 6 4 1 4 5 
-180 3 4 5 5 6 4 1 4 
-180 3 4 5 5 6 4 1 4 
-185 3 4 5 5 6 4 1 4 
-190 3 4 5 5 6 4 1 4 5 5 
-385 4 6 6 2 5 
-395 4 6 6 2 5 
-410 6 3 2 5 5 
-410 4 6 6 2 5 
-410 4 6 6 2 5 
-450 4 2 2 5 3 1 1 3 
-460 4 6 6 2 
-465 4 6 6 2 
