115 5 4 6 1 3 4 2 1 5 5 5 4 
105 3 1 6 4 6 1 2 5 5 5 2 
95 4 3 1 3 1 6 5 2 6 4 5 3 5 
70 1 2 1 5 1 4 2 4 5 5 1 
55 5 2 4 5 3 1 4 2 5 3 4 6 
50 5 1 4 3 3 4 1 4 2 1 6 4 2 
40 4 3 1 3 1 6 5 2 6 4 6 
40 4 3 1 3 1 6 5 2 6 4 6 
40 4 3 1 3 1 6 5 2 6 4 6 
40 4 3 1 3 1 6 5 2 6 4 3 3 
40 4 3 1 3 1 6 5 2 6 4 3 2 
40 4 3 1 3 1 6 5 2 6 4 6 
40 4 3 1 3 1 6 5 2 6 4 6 
40 4 3 1 3 1 6 5 2 6 4 6 
40 4 3 1 3 1 6 5 2 6 4 6 
35 4 3 1 3 1 6 5 2 6 4 6 
35 4 3 1 3 1 6 5 2 6 4 2 
35 4 3 1 3 1 6 5 2 6 4 4 
35 4 3 1 3 1 6 5 2 6 4 4 
35 4 3 1 3 1 6 5 2 6 4 1 
35 4 3 1 3 1 6 5 2 6 4 2 
35 4 3 1 3 1 6 5 2 6 4 1 
35 4 4 3 5 4 4 2 1 3 1 5 1 2 
35 4 3 1 3 1 6 5 2 6 4 2 
20 4 1 2 5 2 2 4 5 1 
20 1 3 3 2 4 5 5 5 6 5 
15 4 2 5 1 2 6 5 3 4 
10 4 3 1 3 1 6 5 2 6 5 
10 4 3 1 3 1 6 5 2 6 5 
10 4 3 1 3 1 6 5 2 6 1 
10 4 3 1 3 1 6 5 2 6 1 
10 4 3 1 3 1 6 5 2 6 3 
10 4 3 1 3 1 6 5 2 6 1 
10 4 3 1 3 1 6 5 2 6 3 
10 4 3 1 3 1 6 5 2 6 1 
10 4 3 1 3 1 6 5 2 6 3 
5 3 1 6 4 6 5 1 5 2 
5 6 1 4 3 5 6 4 5 4 
5 3 5 6 3 5 4 4 4 3 5 3 5 
-25 4 4 2 5 1 5 1 4 6 
-30 2 5 5 2 1 1 4 1 
-35 1 1 2 6 5 5 3 
-45 2 1 4 4 1 4 4 4 3 1 3 1 
-45 1 1 1 2 1 4 5 3 4 3 2 
-45 3 1 6 4 6 5 4 6 
-45 1 4 5 1 1 2 3 2 4 
-45 3 1 6 4 6 5 4 6 
-45 6 6 4 1 1 4 4 3 4 
-55 3 2 2 4 6 3 2 4 
-55 1 2 2 3 3 1 4 6 5 
-60 3 1 6 4 6 3 3 2 6 
-70 3 1 6 4 6 5 5 
-70 3 1 6 4 6 5 2 
-80 2 2 5 4 5 6 
-85 2 1 4 6 4 3 4 5 
-340 4 3 1 3 1 6 5 2 6 
-365 4 3 1 3 1 6 5 2 
-365 4 3 1 3 1 6 5 2 
-365 4 3 1 3 1 6 5 2 
-365 4 3 1 3 1 6 5 2 
-365 4 3 1 3 1 6 5 2 
-435 6 6 2 
-435 1 3 5 4 1 6 
-450 5 4 2 3 2 
