290 5 5 3 2 6 4 6 5 5 6 6 5 5 
110 5 5 3 2 6 4 6 5 5 3 4 
110 5 5 3 2 6 4 6 5 5 3 2 
110 5 5 3 2 6 4 6 5 5 3 2 
110 5 5 3 2 6 4 6 5 5 3 4 
105 5 5 3 2 6 4 6 5 5 2 
105 5 5 3 2 6 4 6 5 5 2 
105 5 5 3 2 6 4 6 5 5 5 
105 5 5 3 2 6 4 6 5 5 2 
105 5 5 3 2 6 4 6 5 5 2 
55 5 5 3 2 6 4 6 5 4 
55 5 5 3 2 6 4 6 5 2 
55 5 5 3 2 6 4 6 5 1 
55 5 5 3 2 6 4 6 5 2 
55 5 5 3 2 6 4 6 5 2 
55 5 5 3 2 6 4 6 5 6 
55 5 5 3 2 6 4 6 5 1 
55 5 5 3 2 6 4 6 5 3 
55 5 5 3 2 6 4 6 5 4 
55 5 5 3 2 6 4 6 5 3 
55 5 5 3 2 6 4 6 5 4 
55 5 5 3 2 6 4 6 5 2 
55 5 5 3 2 6 4 6 5 2 
55 5 5 3 2 6 4 6 5 3 
55 5 5 3 2 6 4 6 5 4 
55 5 5 3 2 6 4 6 5 1 
30 1 3 2 2 2 4 3 1 1 5 1 5 
25 5 6 4 6 2 5 4 2 
10 5 5 3 2 6 4 6 4 1 
10 5 5 3 2 6 4 6 3 6 
10 5 5 3 2 6 4 6 3 2 
10 5 5 3 2 6 4 6 4 
10 5 5 3 2 6 4 6 3 3 
10 5 5 3 2 6 4 6 4 
10 5 5 3 2 6 4 3 6 3 
10 5 5 3 2 6 4 6 3 6 
5 5 5 3 2 6 4 6 4 
5 5 5 3 2 6 4 6 1 
5 5 5 3 2 6 4 6 1 
5 5 5 3 2 6 4 6 6 
0 3 3 6 5 5 1 5 5 3 6 
-5 1 6 2 3 6 1 6 2 
-35 5 5 3 2 6 4 1 1 
-35 5 5 3 2 6 4 4 3 
-35 5 5 3 2 6 4 1 3 
-40 5 1 5 3 3 1 5 5 5 
-55 4 5 1 5 4 4 5 5 
-55 3 4 6 1 2 3 2 1 4 
-55 5 5 3 2 6 4 3 1 
-270 5 5 3 2 6 4 6 5 
-270 5 5 3 2 6 4 6 5 
-270 5 5 3 2 6 4 6 5 
-270 5 5 3 2 6 4 6 5 
-320 5 5 3 2 6 4 6 
-320 5 5 3 2 6 4 6 
-320 5 5 3 2 6 4 6 
-360 4 3 1 2 5 6 5 
-370 5 5 3 2 6 4 
-370 5 5 3 2 6 4 
-370 5 5 3 2 6 4 
-435 5 5 3 2 6 
-435 5 5 3 2 6 
-435 5 5 3 2 6 
-460 5 5 3 2 
