999999 5 3 1 2 2 1 1 1 3 6 4 5 6 5 4 2 4 6 
115 5 3 4 3 5 1 3 5 1 1 5 5 5 6 3 6 6 
115 5 3 4 3 5 1 3 5 1 1 5 5 3 5 5 
115 5 3 4 3 5 1 3 5 1 1 5 5 5 3 2 
110 5 3 4 3 5 1 3 5 1 1 5 5 5 4 
110 5 3 4 3 5 1 3 5 1 1 5 5 5 5 
110 5 3 4 3 5 1 3 5 1 1 5 5 5 2 
110 5 3 4 3 5 1 3 5 1 1 5 5 5 5 
110 5 3 4 3 5 1 3 5 1 1 5 5 5 5 
110 5 3 4 3 5 1 3 5 1 1 5 5 5 5 
110 5 3 4 3 5 1 3 5 1 1 5 5 5 2 
110 5 3 4 3 5 1 3 5 1 1 5 5 5 2 
110 5 3 4 3 5 1 3 5 1 1 5 5 5 1 
110 5 3 4 3 5 1 3 5 1 1 5 5 5 5 
110 5 3 4 3 5 1 3 5 1 1 5 5 5 4 
110 5 3 4 3 5 1 3 5 1 1 5 5 5 2 
110 5 3 4 3 5 1 3 5 1 1 5 5 5 6 4 
110 5 3 4 3 5 1 3 5 1 1 5 5 5 5 
90 5 3 4 3 5 1 3 5 1 1 5 3 4 5 2 
65 5 3 4 3 5 1 3 5 1 1 5 5 3 2 
65 5 3 4 3 5 1 3 5 1 1 5 5 3 3 
60 5 3 4 3 5 1 3 5 1 1 5 5 4 
60 5 3 1 2 2 1 1 1 3 6 4 5 3 6 6 1 6 
60 5 3 4 3 5 1 3 5 1 1 5 5 2 
60 5 3 4 3 5 1 3 5 1 1 5 5 2 
60 5 3 4 3 5 1 3 5 1 1 5 5 2 
60 5 3 4 3 5 1 3 5 1 1 5 5 1 
35 5 3 1 2 2 1 1 1 3 6 4 3 5 4 
30 5 3 1 2 2 1 1 1 3 6 4 5 6 4 
30 5 3 1 2 2 1 1 1 3 6 4 5 4 
25 4 3 5 1 2 2 4 1 1 5 6 
20 4 4 4 5 4 2 4 2 5 6 
10 5 3 4 3 5 1 3 5 1 1 5 1 
10 5 3 4 3 5 1 3 5 1 1 5 2 
10 5 3 4 3 5 1 3 5 1 1 5 4 
10 5 3 4 3 5 1 3 5 1 1 5 2 
10 3 1 4 3 1 1 4 3 2 5 4 5 1 
10 5 3 4 3 5 1 3 5 1 1 5 1 
10 5 3 4 3 5 1 3 5 1 1 5 4 
10 5 3 4 3 5 1 3 5 1 1 5 6 
10 5 3 4 3 5 1 3 5 1 1 5 1 
10 3 4 4 4 3 4 4 2 3 4 4 4 5 2 
-20 5 3 1 2 2 1 1 1 3 6 4 6 1 
-20 5 3 1 2 2 1 1 1 3 6 4 2 
-25 5 3 1 2 2 1 1 2 4 
-25 5 3 1 2 2 1 1 1 1 2 
-30 4 2 4 2 5 1 2 1 
-40 5 3 1 2 2 1 1 1 3 3 1 
-45 5 3 1 2 2 1 1 1 3 2 
-45 5 3 1 2 2 1 1 1 3 6 3 
-45 5 3 1 2 2 1 1 1 3 4 
-45 5 3 1 2 2 1 1 1 3 1 
-45 5 3 1 2 2 1 1 1 3 6 5 
-45 5 3 1 2 2 1 1 1 3 1 
-45 5 3 1 2 2 1 1 1 3 6 6 
-45 5 3 1 2 2 1 1 1 3 6 2 
-45 5 3 1 2 2 1 1 1 3 6 6 
-45 5 3 1 2 2 1 1 1 3 2 
-45 2 1 4 5 3 1 3 5 4 6 1 
-45 4 1 5 2 2 3 4 4 3 4 
-45 5 3 1 2 2 1 1 1 3 6 3 
-50 1 1 5 2 1 2 4 3 5 
-60 3 1 3 3 3 1 2 1 5 1 1 6 5 
-80 5 2 2 1 6 1 6 4 2 
