215 2 3 4 3 2 0 2 4 0 4 
200 0 0 5 4 2 1 4 4 5 
195 3 3 4 1 5 3 5 3 0 1 2 
225 4 2 1 4 0 1 5 1 5 
220 0 3 4 4 4 0 4 1 2 1 0 1 
235 4 4 3 2 0 5 1 3 4 1 4 
230 4 5 2 0 5 0 2 2 
215 0 1 4 5 0 1 5 1 3 3 5 
