-50 2 2 1 2 2 1 3 3 
0 2 2 1 2 2 1 3 5 2 
50 2 2 1 2 2 1 3 5 5 4 
50 2 2 1 2 2 1 3 5 5 4 
50 2 2 1 2 2 1 3 5 5 4 
50 2 2 1 2 2 1 3 5 5 1 
50 2 2 1 2 2 1 3 5 5 1 
-50 2 2 1 2 2 1 3 4 
100 2 2 1 2 2 1 3 5 5 5 3 
50 2 2 1 2 2 1 3 5 5 1 
100 2 2 1 2 2 1 3 5 5 5 2 
-50 2 2 1 2 2 1 3 1 
50 2 2 1 2 2 1 3 5 5 4 
-50 2 2 1 2 2 1 3 3 
0 2 2 1 2 2 1 3 5 2 
-50 2 2 1 2 2 1 3 3 
0 2 2 1 2 2 1 3 5 2 
100 2 2 1 2 2 1 3 5 5 5 3 
100 2 2 1 2 2 1 3 5 5 5 1 
100 2 2 1 2 2 1 3 5 5 5 2 
50 2 2 1 2 2 1 3 5 5 6 
5 2 2 1 2 2 1 3 5 3 6 
50 2 2 1 2 2 1 3 5 5 3 
-50 2 2 1 2 2 1 3 4 
0 2 2 1 2 2 1 3 5 4 
100 2 2 1 2 2 1 3 5 5 5 3 
-50 2 2 1 2 2 1 3 6 
0 2 2 1 2 2 1 3 5 2 
0 2 2 1 2 2 1 3 5 1 
0 2 2 1 2 2 1 3 5 1 
105 2 2 1 2 2 1 3 5 5 5 4 
-50 2 2 1 2 2 1 3 3 
-140 6 3 3 1 5 2 4 5 
-140 6 4 5 3 4 2 3 5 
-140 4 4 3 3 2 2 6 4 
-140 4 1 4 6 5 3 4 3 5 
-145 6 2 5 3 2 5 
-145 4 4 6 3 2 1 4 2 
-145 4 5 1 1 4 3 6 5 
-145 4 1 3 5 2 6 5 
-145 2 6 5 3 2 2 
-145 2 5 3 6 1 4 6 
-150 2 2 6 2 6 
-150 4 1 1 1 2 6 5 
-150 2 5 5 6 5 
-150 6 4 4 1 5 4 5 
-155 3 6 6 4 3 2 3 3 5 3 
-155 3 1 3 6 4 3 5 4 3 5 
-165 1 6 1 4 3 2 3 6 
-170 5 6 4 5 3 6 
-170 1 3 6 1 5 1 6 
-175 5 4 4 6 6 4 6 
-175 1 6 6 4 1 2 2 
-175 6 5 4 5 6 6 
-195 4 6 6 1 1 3 1 2 
-195 6 4 6 1 3 5 1 
-200 4 6 2 6 4 5 
-200 5 4 6 1 6 5 
-220 6 3 6 4 2 2 
-225 4 6 6 5 6 
-225 6 6 5 1 6 
-260 3 6 1 3 6 3 6 
-265 3 4 6 6 6 3 3 
-275 6 1 6 6 2 
