-10 6 6 5 3 3 1 5 1 5 
-80 1 4 4 5 5 5 5 
-125 1 3 4 3 4 6 1 4 1 
-150 2 4 4 5 1 2 5 5 5 
-150 2 4 4 5 1 2 5 1 4 
-150 2 4 4 5 1 2 5 5 2 
-150 2 4 4 5 1 2 5 5 1 
-150 2 4 4 5 1 2 5 5 6 
-150 2 4 4 5 1 2 5 5 6 
-155 2 4 4 5 1 2 5 6 
-155 2 4 4 5 1 2 5 3 
-155 2 4 4 5 1 2 5 5 
-155 2 4 4 5 1 2 5 5 
-155 2 4 4 5 1 2 2 
-155 2 4 4 5 1 2 1 
-155 2 4 4 5 1 2 5 4 
-155 2 4 4 5 1 2 5 5 
-155 2 4 4 5 1 2 2 
-445 6 6 5 3 4 
-445 3 6 6 5 
-470 3 6 5 4 6 
-530 2 4 4 5 1 2 
-530 2 4 4 5 
-530 2 4 4 5 1 
-530 2 4 4 5 
-530 2 4 4 5 1 2 
-530 2 4 4 5 1 2 
-530 2 4 4 5 1 2 
-530 2 4 4 5 1 2 
-550 6 6 4 
