180 2 1 5 5 6 1 5 5 5 6 3 
60 2 1 5 5 6 1 5 5 6 
60 2 1 5 5 6 1 5 5 6 
60 2 1 5 5 6 1 5 5 2 
60 2 1 5 5 6 1 5 5 3 
60 2 1 5 5 6 1 5 5 1 
40 2 1 5 5 6 1 5 3 4 2 
30 2 1 5 5 6 3 6 4 6 
15 2 1 5 5 6 1 5 3 1 
15 2 1 5 5 6 1 5 3 3 
10 2 1 5 5 6 1 5 4 
10 2 1 5 5 6 1 5 6 
10 2 1 5 5 6 1 5 1 
10 2 1 5 5 6 1 5 2 
10 2 1 5 5 6 1 5 2 
5 2 1 5 5 6 3 6 2 
5 2 1 5 5 6 3 6 2 
-40 2 1 5 5 6 1 2 
-40 2 1 5 5 6 1 4 
-40 2 1 5 5 6 4 2 
-40 2 1 5 5 6 4 4 
-40 1 5 1 6 2 5 4 
-40 2 1 5 5 6 4 4 
-45 2 2 4 5 4 5 3 3 2 
-55 2 1 5 5 6 3 3 1 
-55 2 1 5 5 6 3 3 1 
-60 2 1 5 5 6 3 1 
-60 2 1 5 5 6 3 4 
-60 2 1 5 5 6 3 1 
-65 2 1 5 5 6 6 
-65 2 1 5 5 6 6 
-65 2 1 5 5 6 5 
-65 2 1 5 5 6 6 
-70 5 6 3 6 4 1 4 
-80 2 1 5 5 2 6 
-85 4 1 2 5 6 3 4 6 
-190 6 5 1 4 4 5 3 
-220 5 1 3 3 6 6 5 
-225 2 3 4 4 5 2 5 1 
-230 1 5 6 6 
-315 2 1 5 5 6 1 5 
-315 2 1 5 5 6 1 5 
-315 2 1 5 5 6 1 5 
-315 2 1 5 5 6 1 5 
-365 2 1 5 5 6 1 
-365 2 1 5 5 6 1 
-365 2 1 5 5 6 1 
-370 2 1 5 5 6 3 
-370 2 1 5 5 6 3 
-415 2 1 5 5 6 
-415 2 1 5 5 6 
-415 2 1 5 5 6 
-415 2 1 5 5 6 
-415 2 1 5 5 6 
-415 2 1 5 5 6 
-415 2 1 5 5 6 
-415 2 1 5 5 6 
-415 2 1 5 5 6 
-415 2 1 5 5 6 
-435 2 1 5 5 6 
-565 5 6 4 
-580 5 2 2 4 5 
-600 3 5 1 4 6 5 
-605 4 5 6 3 1 
