999999 2 4 3 2 3 2 6 6 4 5 6 6 2 3 3 3 6 
999999 2 4 3 2 3 2 6 6 4 5 6 6 2 3 3 6 2 
999999 2 4 3 2 3 2 6 6 4 5 6 6 5 4 5 3 1 
999999 2 4 3 2 3 2 6 6 4 5 6 6 2 3 3 6 1 
999999 2 4 3 2 3 2 6 6 4 5 6 6 5 4 5 3 5 
999994 2 4 3 2 3 2 6 6 4 5 6 6 5 6 4 
999994 2 4 3 2 3 2 6 6 4 5 6 6 5 6 5 
999994 2 4 3 2 3 2 6 6 4 5 6 6 5 4 5 6 
999994 2 4 3 2 3 2 6 6 4 5 6 6 2 3 1 6 
999994 2 4 3 2 3 2 6 6 4 5 6 6 5 4 6 
999994 2 4 3 2 3 2 6 6 4 5 6 6 2 3 6 1 
999994 2 4 3 2 3 2 6 6 4 5 6 6 5 4 5 6 
999994 2 4 3 2 3 2 6 6 4 5 6 6 2 3 6 6 
999994 2 4 3 2 3 2 6 6 4 5 6 6 5 1 3 6 
999619 2 4 3 2 3 2 6 6 4 5 6 6 5 
305 2 4 3 2 3 2 6 6 4 5 6 5 1 4 1 1 1 
300 2 4 3 2 3 2 6 6 4 5 6 6 1 1 4 3 4 
295 2 4 3 2 3 2 6 6 4 5 6 6 2 3 4 2 
295 2 4 3 2 3 2 6 6 4 5 6 6 2 3 4 3 
295 2 4 3 2 3 2 6 6 4 5 6 6 2 3 1 3 
295 2 4 3 2 3 2 6 6 4 5 6 6 1 3 2 3 
295 2 4 3 2 3 2 6 6 4 5 6 6 5 3 1 2 
295 2 4 3 2 3 2 6 6 4 5 6 6 2 3 1 1 
290 2 4 3 2 3 2 6 6 4 5 6 3 3 2 1 2 4 
290 2 4 3 2 3 2 6 6 4 5 6 6 5 4 1 
290 2 4 3 2 3 2 6 6 4 5 6 6 4 2 1 
290 2 4 3 2 3 2 6 6 4 5 6 6 5 4 2 
290 2 4 3 2 3 2 6 6 4 5 6 6 2 4 1 
285 2 4 3 2 3 2 6 6 4 5 6 6 3 6 3 
285 2 4 3 2 3 2 6 6 4 5 6 6 6 3 2 
280 2 4 3 2 3 2 6 6 4 5 6 6 2 3 3 5 
280 2 4 3 2 3 2 6 6 4 5 6 6 2 3 3 5 
280 2 4 3 2 3 2 6 6 4 5 6 6 2 3 3 5 
280 2 4 3 2 3 2 6 6 4 5 6 6 2 3 3 5 
280 2 4 3 2 3 2 6 6 4 5 6 6 2 3 3 5 
280 2 4 3 2 3 2 6 6 4 5 6 6 2 3 3 5 
280 2 4 3 2 3 2 6 6 4 5 6 6 2 3 3 5 
280 2 4 3 2 3 2 6 6 4 5 6 6 2 3 3 5 
280 2 4 3 2 3 2 6 6 4 5 6 6 2 3 3 5 
280 2 4 3 2 3 2 6 6 4 5 6 6 2 3 3 5 
280 2 4 3 2 3 2 6 6 4 5 6 6 6 4 
280 2 4 3 2 3 2 6 6 4 5 6 6 6 4 
275 2 4 3 2 3 2 6 6 4 5 6 6 2 3 3 1 
275 2 4 3 2 3 2 6 6 4 5 6 6 2 3 3 2 
275 2 4 3 2 3 2 6 6 4 5 6 6 2 3 3 5 
275 2 4 3 2 3 2 6 6 4 5 6 6 2 3 3 4 
275 2 4 3 2 3 2 6 6 4 5 6 6 3 5 3 4 
275 2 4 3 2 3 2 6 6 4 5 6 6 2 3 3 5 
275 2 4 3 2 3 2 6 6 4 5 6 6 2 3 3 2 
270 2 4 3 2 3 2 6 6 4 5 6 6 2 3 5 
265 2 4 3 2 3 2 6 6 4 5 6 6 5 2 
265 2 4 3 2 3 2 6 6 4 5 6 6 5 2 
265 2 4 3 2 3 2 6 6 4 5 6 6 5 5 
265 2 4 3 2 3 2 6 6 4 5 6 6 5 5 
265 2 4 3 2 3 2 6 6 4 5 6 6 5 2 
265 2 4 3 2 3 2 6 6 4 5 6 6 5 5 
250 2 4 3 2 3 2 6 6 4 5 6 5 5 6 
-100 2 4 3 2 3 2 6 6 4 5 6 6 2 3 
-100 2 4 3 2 3 2 6 6 4 5 6 6 2 3 
-100 2 4 3 2 3 2 6 6 4 5 6 6 2 3 
-100 2 4 3 2 3 2 6 6 4 5 6 6 2 3 
-100 2 4 3 2 3 2 6 6 4 5 6 6 2 3 
-105 2 4 3 2 3 2 6 6 4 5 6 6 2 
-110 2 4 3 2 3 2 6 6 4 5 6 6 
