-40 1 3 2 0 5 2 2 4 0 1 
-40 0 1 1 2 4 5 0 0 1 4 4 2 
-40 4 4 4 0 3 4 3 5 2 1 4 1 
-55 1 4 5 3 3 2 3 4 1 0 4 0 3 
-55 3 2 4 5 3 3 3 4 4 3 2 4 
-75 1 0 4 2 5 0 3 0 2 0 3 1 
-40 3 1 2 4 3 2 2 4 0 1 0 
-55 2 2 2 2 4 1 2 
-70 2 2 4 1 0 3 5 4 2 
-40 4 5 5 1 3 4 0 2 1 3 0 
-60 3 3 5 1 1 3 5 3 2 1 4 
-40 2 4 3 5 4 5 4 0 4 0 0 
-60 5 0 2 5 1 0 3 0 2 2 
-40 5 1 1 0 1 2 0 4 3 2 0 
15 3 4 1 1 4 1 1 2 0 2 0 5 0 3 
-75 0 5 5 2 1 4 4 2 
-55 5 1 4 3 0 3 0 3 4 1 1 2 3 
-60 2 0 1 4 1 5 2 3 0 3 4 
-45 5 3 2 2 4 0 1 5 4 
-70 1 4 2 0 4 1 4 3 5 2 
-85 3 2 3 3 1 5 1 0 2 5 
-25 4 1 1 1 1 1 5 4 5 0 3 
-50 4 5 1 5 5 3 2 5 
-70 1 2 1 3 5 3 5 4 5 
-65 3 4 5 4 0 1 4 3 2 4 5 
-85 0 0 5 4 1 2 0 3 1 4 5 
-60 4 0 5 4 2 1 0 3 5 0 1 
-75 4 3 3 4 4 3 1 1 0 4 3 5 0 4 
-60 0 1 2 5 3 1 4 4 4 0 0 5 
-30 5 1 4 2 2 1 2 0 
-60 5 1 1 1 2 1 3 1 3 3 0 5 
-25 5 1 2 3 1 4 5 5 2 
-75 0 1 3 2 5 3 4 3 0 0 2 2 
-45 1 2 1 2 4 3 2 4 0 1 
-25 3 1 4 1 5 2 4 2 1 2 
10 5 5 3 2 5 0 2 0 5 2 
-40 4 3 5 0 0 2 2 1 4 4 2 
-60 0 5 3 5 5 1 0 0 2 1 
10 4 4 2 2 3 2 2 3 3 5 1 
-65 5 4 1 5 3 0 5 1 0 2 
-25 5 4 2 1 0 2 4 2 0 
-65 2 5 0 0 0 0 0 0 5 0 2 0 3 
10 4 1 4 3 0 1 2 3 4 5 4 5 4 
-50 0 1 4 5 3 4 3 4 3 0 3 1 1 4 2 
-45 1 0 1 4 1 2 1 1 0 4 4 4 
-65 2 5 3 5 3 1 5 0 5 
60 2 3 2 2 0 2 2 5 5 0 3 
-100 3 5 3 2 3 0 5 4 0 3 5 
-60 2 0 1 0 5 1 4 3 4 4 3 4 
-55 0 0 5 5 3 0 1 1 1 2 0 3 
-40 5 4 0 5 3 3 2 2 1 0 
-55 3 2 0 0 5 3 1 2 2 0 2 
-95 2 0 1 5 3 1 0 0 3 3 3 4 5 
-30 4 1 5 1 1 4 4 2 4 2 
-55 3 5 4 4 5 0 0 3 0 5 4 4 
-45 3 5 4 2 2 1 3 5 1 
-40 1 5 5 1 2 5 3 3 3 1 
-25 4 4 5 1 4 3 1 1 5 4 2 
-60 3 1 4 0 5 0 4 1 4 3 2 2 
-45 3 2 1 2 0 2 4 5 2 
-60 1 1 2 3 5 1 5 3 3 3 5 
25 0 5 5 2 4 5 1 4 5 1 
-40 4 2 0 3 2 1 5 3 5 2 
-55 5 5 4 3 5 3 3 1 4 0 3 1 
-50 1 3 4 4 2 1 1 4 2 5 
-70 4 3 4 3 3 2 0 0 4 1 5 0 3 4 
-95 0 3 0 3 0 0 5 2 4 3 5 5 
-65 2 4 3 2 1 1 5 3 3 2 
-40 2 1 2 4 4 3 3 4 0 2 4 
-45 5 3 4 1 5 2 0 1 4 2 
10 2 2 3 0 4 2 1 0 1 1 5 1 
-45 1 4 1 0 2 5 2 0 1 1 
-85 2 3 0 4 0 1 4 0 3 2 3 3 0 0 4 
-55 4 0 3 2 1 3 3 1 2 3 2 4 
-40 2 0 5 5 2 3 1 3 4 3 
-40 4 3 5 1 4 0 3 4 5 2 1 
-85 4 2 5 0 3 1 1 3 4 3 2 
-15 3 2 5 3 1 0 4 2 0 0 3 0 5 3 4 
-60 3 2 0 3 4 5 1 2 0 1 5 
-55 3 0 3 1 0 0 2 1 2 5 4 3 
-85 3 1 0 4 1 3 1 4 5 4 0 2 
-65 5 1 5 1 1 4 3 4 3 0 5 
-65 1 3 0 3 1 0 3 4 0 2 3 0 4 4 1 4 
-55 1 3 0 1 5 1 3 4 0 0 1 2 4 
-55 2 2 2 2 2 2 
-55 4 1 5 0 5 1 0 0 3 5 3 3 
-40 1 4 2 3 0 4 4 4 1 3 5 3 
-65 1 1 5 3 5 0 1 5 0 5 
-80 4 0 0 2 0 4 3 5 5 0 5 
-45 2 5 5 5 1 3 3 1 1 
-60 1 0 4 4 3 3 1 3 1 2 5 1 
-100 3 4 3 0 3 4 3 3 1 3 4 0 1 3 0 4 5 
-95 0 4 3 3 0 0 4 2 4 5 3 0 2 
-100 4 0 3 2 0 5 0 0 0 1 4 2 
-70 5 5 3 3 2 2 4 5 
-25 5 4 5 5 5 5 0 1 
-65 5 3 1 2 5 1 3 4 0 2 
-60 0 3 2 1 2 5 5 3 3 1 
-40 5 4 0 3 5 4 0 2 5 3 
-70 0 5 1 2 1 0 1 5 2 
-40 5 3 5 1 1 5 1 0 1 3 2 
-40 5 1 2 0 1 5 5 0 3 1 
-40 2 1 0 1 2 3 0 2 1 4 0 
-60 4 0 3 3 4 0 2 4 5 1 1 5 
-95 3 4 0 4 3 4 5 0 3 3 2 3 2 
-75 1 2 2 3 2 5 5 
-40 3 1 0 5 4 4 1 2 3 4 4 2 
-5 0 1 2 2 1 4 0 3 5 3 3 5 1 
-45 1 5 5 2 2 4 0 0 1 
-65 2 5 3 4 5 0 3 5 5 
-95 1 5 0 1 3 0 3 3 0 4 3 5 5 
-70 0 4 1 0 3 5 0 1 4 3 2 0 3 4 
-40 4 5 0 4 5 4 0 1 1 4 3 0 
-60 5 1 3 2 4 4 3 3 0 4 4 2 
-40 1 5 0 5 1 0 5 5 3 0 
-55 4 1 3 3 2 5 3 2 0 0 1 2 
-70 0 4 0 1 2 5 2 4 5 
-65 2 3 2 5 2 3 3 4 2 
-55 4 3 3 2 3 2 5 3 3 1 4 4 
-65 0 0 5 3 3 0 0 2 3 2 4 1 0 1 
-45 4 2 0 2 1 4 4 3 2 1 
-65 4 5 3 2 3 2 3 2 2 
-65 1 2 0 0 1 4 3 5 2 5 
-70 2 2 1 0 2 2 0 5 
-30 5 4 1 4 4 5 4 1 1 2 
-25 2 5 2 4 2 0 5 0 
-50 2 4 1 5 5 5 0 5 
-30 5 2 2 1 2 5 0 
10 2 1 5 3 2 1 3 0 2 5 2 
115 2 1 5 3 2 1 3 0 2 5 5 5 0 0 
115 2 1 5 3 2 1 3 0 2 5 5 5 0 4 
10 2 1 5 3 2 1 3 0 2 5 2 
120 2 1 5 3 2 1 3 0 2 5 5 5 0 0 
60 2 1 5 3 2 1 3 0 2 5 5 3 
115 2 1 5 3 2 1 3 0 2 5 5 5 0 5 
65 2 1 5 3 2 1 3 0 2 5 5 3 2 
60 2 1 5 3 2 1 3 0 2 5 5 4 
110 2 1 5 3 2 1 3 0 2 5 5 5 4 
115 2 1 5 3 2 1 3 0 2 5 5 3 4 1 5 
115 2 1 5 3 2 1 3 0 2 5 5 5 0 2 
115 2 1 5 3 2 1 3 0 2 5 5 5 0 5 
115 2 1 5 3 2 1 3 0 2 5 5 5 3 4 
115 2 1 5 3 2 1 3 0 2 5 5 0 5 2 
115 2 1 5 3 2 1 3 0 2 5 5 5 0 2 
10 2 1 5 3 2 1 3 0 2 5 2 
110 2 1 5 3 2 1 3 0 2 5 5 5 4 
60 2 1 5 3 2 1 3 0 2 5 5 0 
60 2 1 5 3 2 1 3 0 2 5 5 1 
115 2 1 5 3 2 1 3 0 2 5 5 5 0 3 
60 2 1 5 3 2 1 3 0 2 5 5 2 
115 2 1 5 3 2 1 3 0 2 5 5 5 0 1 
115 2 1 5 3 2 1 3 0 2 5 5 5 0 1 
10 2 1 5 3 2 1 3 0 2 5 1 
60 2 1 5 3 2 1 3 0 2 5 5 2 
110 2 1 5 3 2 1 3 0 2 5 5 5 4 
115 2 1 5 3 2 1 3 0 2 5 5 5 0 4 
115 2 1 5 3 2 1 3 0 2 5 5 5 0 3 
110 2 1 5 3 2 1 3 0 2 5 5 5 1 
45 2 1 5 3 2 1 3 0 2 5 3 4 0 2 
60 2 1 5 3 2 1 3 0 2 5 5 1 
115 2 1 5 3 2 1 3 0 2 5 5 5 0 1 
60 2 1 5 3 2 1 3 0 2 5 5 4 
115 2 1 5 3 2 1 3 0 2 5 5 5 0 0 
115 2 1 5 3 2 1 3 0 2 5 5 5 0 2 
115 2 1 5 3 2 1 3 0 2 5 5 5 0 2 
10 2 1 5 3 2 1 3 0 2 5 2 
110 2 1 5 3 2 1 3 0 2 5 5 5 2 
15 2 1 5 3 2 1 3 0 2 5 0 3 
115 2 1 5 3 2 1 3 0 2 5 5 5 0 0 
10 2 1 5 3 2 1 3 0 2 5 2 
115 2 1 5 3 2 1 3 0 2 5 5 5 5 
115 2 1 5 3 2 1 3 0 2 5 5 5 3 1 
65 2 1 5 3 2 1 3 0 2 5 5 3 0 
110 2 1 5 3 2 1 3 0 2 5 5 5 5 
65 2 1 5 3 2 1 3 0 2 5 0 5 0 
110 2 1 5 3 2 1 3 0 2 5 5 5 1 
110 2 1 5 3 2 1 3 0 2 5 5 5 1 
110 2 1 5 3 2 1 3 0 2 5 5 5 5 
110 2 1 5 3 2 1 3 0 2 5 5 5 2 
115 2 1 5 3 2 1 3 0 2 5 5 5 3 3 
15 2 1 5 3 2 1 3 0 2 5 3 3 
10 2 1 5 3 2 1 3 0 2 5 1 
110 2 1 5 3 2 1 3 0 2 5 5 5 4 
110 2 1 5 3 2 1 3 0 2 5 5 5 1 
115 2 1 5 3 2 1 3 0 2 5 5 5 0 4 
115 2 1 5 3 2 1 3 0 2 5 5 5 0 3 
110 2 1 5 3 2 1 3 0 2 5 5 5 2 
110 2 1 5 3 2 1 3 0 2 5 5 5 1 
110 2 1 5 3 2 1 3 0 2 5 5 5 5 
60 2 1 5 3 2 1 3 0 2 5 5 1 
15 2 1 5 3 2 1 3 0 2 5 3 2 
60 2 1 5 3 2 1 3 0 2 5 5 2 
165 2 1 5 3 2 1 3 0 2 5 5 5 0 2 
115 2 1 5 3 2 1 3 0 2 5 5 5 0 1 
60 2 1 5 3 2 1 3 0 2 5 5 4 
10 2 1 5 3 2 1 3 0 2 5 2 
60 2 1 5 3 2 1 3 0 2 5 5 4 
115 2 1 5 3 2 1 3 0 2 5 5 5 0 2 
60 2 1 5 3 2 1 3 0 2 5 5 4 
10 2 1 5 3 2 1 3 0 2 5 1 
65 2 1 5 3 2 1 3 0 2 5 5 3 3 
10 2 1 5 3 2 1 3 0 2 5 2 
115 2 1 5 3 2 1 3 0 2 5 5 5 0 1 
115 2 1 5 3 2 1 3 0 2 5 5 5 0 4 
115 2 1 5 3 2 1 3 0 2 5 5 5 0 4 
115 2 1 5 3 2 1 3 0 2 5 5 5 0 4 
70 2 1 5 3 2 1 3 0 2 5 5 5 3 
10 2 1 5 3 2 1 3 0 2 5 1 
115 2 1 5 3 2 1 3 0 2 5 5 5 0 5 
115 2 1 5 3 2 1 3 0 2 5 5 5 0 3 
15 2 1 5 3 2 1 3 0 2 5 3 3 
60 2 1 5 3 2 1 3 0 2 5 5 2 
115 2 1 5 3 2 1 3 0 2 5 5 5 0 3 
10 2 1 5 3 2 1 3 0 2 5 4 
10 2 1 5 3 2 1 3 0 2 5 2 
110 2 1 5 3 2 1 3 0 2 5 5 5 1 
115 2 1 5 3 2 1 3 0 2 5 5 5 5 
115 2 1 5 3 2 1 3 0 2 5 5 5 0 1 
115 2 1 5 3 2 1 3 0 2 5 5 5 0 2 
110 2 1 5 3 2 1 3 0 2 5 5 5 2 
115 2 1 5 3 2 1 3 0 2 5 5 5 0 1 
115 2 1 5 3 2 1 3 0 2 5 5 5 0 3 
15 2 1 5 3 2 1 3 0 2 5 3 0 
65 2 1 5 3 2 1 3 0 2 5 5 0 3 
115 2 1 5 3 2 1 3 0 2 5 5 5 0 0 
115 2 1 5 3 2 1 3 0 2 5 5 5 0 0 
15 2 1 5 3 2 1 3 0 2 5 3 3 
60 2 1 5 3 2 1 3 0 2 5 5 1 
115 2 1 5 3 2 1 3 0 2 5 5 5 0 3 
115 2 1 5 3 2 1 3 0 2 5 5 5 0 0 
115 2 1 5 3 2 1 3 0 2 5 5 5 0 1 
110 2 1 5 3 2 1 3 0 2 5 5 5 1 
10 2 1 5 3 2 1 3 0 2 5 4 
115 2 1 5 3 2 1 3 0 2 5 5 5 0 1 
65 2 1 5 3 2 1 3 0 2 5 5 0 4 
10 2 1 5 3 2 1 3 0 2 5 1 
115 2 1 5 3 2 1 3 0 2 5 5 5 0 5 
60 2 1 5 3 2 1 3 0 2 5 5 2 
115 2 1 5 3 2 1 3 0 2 5 5 5 0 3 
60 2 1 5 3 2 1 3 0 2 5 5 2 
10 2 1 5 3 2 1 3 0 2 5 4 
60 2 1 5 3 2 1 3 0 2 5 5 2 
110 2 1 5 3 2 1 3 0 2 5 5 5 4 
10 2 1 5 3 2 1 3 0 2 5 1 
110 2 1 5 3 2 1 3 0 2 5 5 5 4 
60 2 1 5 3 2 1 3 0 2 5 5 1 
110 2 1 5 3 2 1 3 0 2 5 5 5 4 
115 2 1 5 3 2 1 3 0 2 5 5 5 0 1 
10 2 1 5 3 2 1 3 0 2 5 2 
115 2 1 5 3 2 1 3 0 2 5 5 5 0 0 
10 2 1 5 3 2 1 3 0 2 5 1 
60 2 1 5 3 2 1 3 0 2 5 5 4 
65 2 1 5 3 2 1 3 0 2 5 5 0 0 
60 2 1 5 3 2 1 3 0 2 5 5 4 
65 2 1 5 3 2 1 3 0 2 5 5 0 2 
140 2 1 5 3 2 1 3 0 2 5 5 5 0 1 
