310 6 3 6 1 5 5 6 4 3 5 6 6 4 2 3 
295 6 3 6 1 5 5 6 4 3 5 6 5 5 4 5 
280 6 3 6 1 5 5 6 4 3 5 6 2 6 5 
270 6 3 6 1 5 5 6 4 5 6 5 4 4 3 2 
165 6 3 6 1 5 5 6 4 3 5 6 4 
110 6 3 6 1 5 5 6 4 6 2 
105 6 3 6 1 5 5 6 4 3 5 3 5 
105 6 3 6 1 5 5 6 4 3 5 3 4 
100 6 3 6 1 5 5 6 4 3 5 5 
100 6 3 6 1 5 5 6 4 3 5 4 
100 6 3 6 1 5 5 6 4 3 5 5 
100 6 3 6 1 5 5 6 4 3 5 4 
100 6 3 6 1 5 5 6 4 3 5 1 
100 6 3 6 1 5 5 6 4 3 5 4 
100 6 3 6 1 5 5 6 4 3 5 1 
100 6 3 6 1 5 5 6 4 3 5 2 
95 6 3 6 1 5 5 6 4 5 5 
75 4 1 1 4 5 6 5 6 5 3 
50 6 3 6 1 5 5 6 4 3 6 
50 6 3 6 1 5 5 6 4 3 4 
50 6 3 6 1 5 5 6 4 3 6 
50 6 3 6 1 5 5 6 4 3 4 
50 6 3 6 1 5 5 6 4 3 2 
50 6 3 6 1 5 5 6 4 3 1 
50 6 3 6 1 5 5 6 4 3 6 
50 6 3 6 1 5 5 6 4 3 6 
50 6 3 6 1 5 5 6 4 3 6 
50 6 3 6 1 5 5 6 4 3 3 
50 6 3 6 1 5 5 6 4 3 1 
45 6 3 6 1 5 5 6 4 2 
45 6 3 6 1 5 5 6 4 1 
45 6 3 6 1 5 5 6 4 4 
45 6 3 6 1 5 5 6 4 1 
45 6 3 6 1 5 5 6 4 1 
45 6 3 6 1 5 5 6 4 1 
45 6 3 6 1 5 5 6 4 1 
20 6 3 6 1 5 5 6 2 
15 6 3 6 1 5 3 1 4 5 3 6 
15 1 5 4 3 5 6 5 5 1 
10 4 6 5 3 6 3 5 5 1 
-15 2 6 1 4 5 4 5 2 
-20 1 6 5 4 5 3 1 1 4 4 
-35 5 3 1 3 5 4 4 2 3 3 4 2 
-40 5 4 5 2 6 1 4 
-40 6 3 6 1 5 5 3 2 
-45 6 3 6 1 5 2 2 
-65 6 3 6 1 5 3 4 2 
-70 6 3 6 1 5 1 5 
-85 3 3 3 6 4 6 5 2 
-140 6 3 6 1 3 4 
-145 4 5 5 4 3 3 2 
-185 2 3 3 3 4 3 4 1 
-325 6 3 6 1 5 5 6 4 
-400 6 5 6 1 3 3 
-400 5 4 5 1 3 5 3 4 
-405 1 4 5 2 6 5 3 
-415 6 3 6 1 5 1 3 
-415 6 3 6 1 5 5 
-420 6 3 6 1 5 
-420 6 3 6 1 5 
-420 6 3 6 1 5 5 5 
-420 3 4 5 1 5 3 4 4 
-420 6 3 6 1 5 5 5 
-420 6 3 6 1 5 5 5 
-425 4 2 5 6 
-435 1 3 3 6 1 4 6 3 
-440 2 6 5 5 1 
-455 1 6 3 6 6 6 
-470 6 3 6 1 
-505 2 1 1 4 1 1 3 2 
