300 4 4 4 2 3 1 5 5 6 5 5 6 5 6 2 
115 4 4 4 2 3 1 5 5 6 5 5 4 
115 4 4 4 2 3 1 5 5 6 5 5 4 
115 4 4 4 2 3 1 5 5 6 5 5 2 
115 4 4 4 2 3 1 5 5 6 5 5 1 
115 4 4 4 2 3 1 5 5 6 5 5 3 
115 4 4 4 2 3 1 5 5 6 5 5 1 
115 4 4 4 2 3 1 5 5 6 5 5 3 
115 4 4 4 2 3 1 5 5 6 5 5 3 
115 4 4 4 2 3 1 5 5 6 5 5 3 
115 4 4 4 2 3 1 5 5 6 5 5 5 
115 4 4 4 2 3 1 5 5 6 5 5 3 
115 4 4 4 2 3 1 5 5 6 5 5 5 
95 4 4 4 2 3 1 5 5 6 3 4 5 1 
65 4 4 4 2 3 1 5 5 6 5 1 
65 4 4 4 2 3 1 5 5 6 5 4 
65 4 4 4 2 3 1 5 5 6 5 1 
65 4 4 4 2 3 1 5 5 6 5 6 
65 4 4 4 2 3 1 5 5 6 5 2 
65 4 4 4 2 3 1 5 5 6 5 1 
65 4 4 4 2 3 1 5 5 6 5 1 
65 4 4 4 2 3 1 5 5 6 5 3 
50 4 4 4 2 3 1 5 5 6 3 4 3 4 
45 4 4 4 2 3 1 5 5 3 6 4 6 
45 5 6 3 6 5 6 5 3 
20 4 4 4 2 3 1 5 5 6 3 1 
20 1 2 4 1 2 5 2 5 2 
20 4 4 4 2 3 1 5 5 6 3 5 
20 2 1 1 3 5 5 4 3 4 6 6 
15 4 4 4 2 3 1 5 5 6 6 
15 4 4 4 2 3 1 5 5 6 6 
15 4 4 4 2 3 1 5 5 6 2 
15 4 4 4 2 3 1 5 5 6 1 
15 4 4 4 2 3 1 5 5 6 2 
15 6 6 1 1 1 5 6 5 
15 4 4 4 2 3 1 5 5 6 2 
-30 1 5 5 2 2 5 4 
-45 4 4 4 2 3 1 5 5 3 2 
-45 4 4 4 2 3 1 5 5 1 5 
-45 1 5 5 3 5 4 4 1 4 
-50 2 4 2 4 3 4 1 5 5 
-50 4 4 4 2 3 1 5 5 1 
-50 4 4 4 2 3 1 5 5 1 
-60 6 5 2 5 3 4 5 
-60 3 6 4 1 6 3 1 3 1 1 
-70 4 4 4 2 3 1 5 4 3 5 
-260 4 4 4 2 3 1 5 5 6 5 
-260 4 4 4 2 3 1 5 5 6 5 
-260 4 4 4 2 3 1 5 5 6 5 
-260 4 4 4 2 3 1 5 5 6 5 
-260 4 4 4 2 3 1 5 5 6 5 
-310 4 4 4 2 3 1 5 5 6 
-310 4 4 4 2 3 1 5 5 6 
-310 4 4 4 2 3 1 5 5 6 
-310 4 4 4 2 3 1 5 5 6 
-360 4 4 4 2 3 1 5 5 
-360 4 4 4 2 3 1 5 5 
-360 4 4 4 2 3 1 5 5 
-360 4 4 4 2 3 1 5 5 
-360 4 4 4 2 3 1 5 5 
-425 4 4 4 2 3 1 5 
-425 4 4 4 2 3 1 5 
-430 2 3 3 6 2 2 
-475 4 4 4 2 3 1 
