-70 2 0 1 5 2 3 2 5 
-75 5 4 0 0 0 2 4 3 3 3 2 1 
-60 4 4 0 4 4 4 1 5 4 3 0 2 
-60 2 5 3 4 4 4 2 0 3 3 0 
-90 1 5 1 0 4 3 5 1 3 2 
-70 1 3 5 0 5 5 2 5 
-85 5 4 0 0 0 2 4 0 4 1 5 
-60 5 4 0 0 0 2 4 0 4 1 1 2 
40 2 0 1 5 0 3 5 2 0 5 5 4 
-60 2 0 1 5 0 3 5 2 0 0 
-10 2 0 1 5 0 3 5 2 0 5 1 
-60 2 0 1 5 0 3 5 2 0 1 
-60 2 0 1 5 0 3 5 2 0 2 
-60 2 0 1 5 0 3 5 2 0 2 
-60 2 0 1 5 0 3 5 2 0 1 
40 2 0 1 5 0 3 5 2 0 5 5 4 
