10 4 0 1 1 4 3 3 5 4 5 4 5 2 
10 4 0 1 1 4 3 3 5 4 5 4 5 1 
60 4 0 1 1 4 3 3 5 4 5 4 5 5 4 
115 4 0 1 1 4 3 3 5 4 5 4 5 5 3 5 
65 4 0 1 1 4 3 3 5 4 5 4 5 5 3 
115 4 0 1 1 4 3 3 5 4 5 4 5 5 3 5 
60 4 0 1 1 4 3 3 5 4 5 4 5 5 3 
65 4 0 1 1 4 3 3 5 4 5 4 5 5 3 2 
65 4 0 1 1 4 3 3 5 4 5 4 5 5 3 
10 4 0 1 1 4 3 3 5 4 5 4 5 1 
115 4 0 1 1 4 3 3 5 4 5 4 5 5 3 5 3 
60 4 0 1 1 4 3 3 5 4 5 4 5 5 1 
10 4 0 1 1 4 3 3 5 4 5 4 5 1 
60 4 0 1 1 4 3 3 5 4 5 4 5 5 2 
115 4 0 1 1 4 3 3 5 4 5 4 5 5 3 5 
60 4 0 1 1 4 3 3 5 4 5 4 5 5 2 
115 4 0 1 1 4 3 3 5 4 5 4 5 5 3 5 
110 4 0 1 1 4 3 3 5 4 5 4 5 5 5 2 
115 4 0 1 1 4 3 3 5 4 5 4 5 5 3 5 1 
60 4 0 1 1 4 3 3 5 4 5 4 5 5 4 
60 4 0 1 1 4 3 3 5 4 5 4 5 5 4 
40 4 0 1 1 4 3 3 5 4 5 4 5 3 4 2 
60 4 0 1 1 4 3 3 5 4 5 4 5 5 4 
65 4 0 1 1 4 3 3 5 4 5 4 5 5 3 0 
60 4 0 1 1 4 3 3 5 4 5 4 5 5 1 
10 4 0 1 1 4 3 3 5 4 5 4 5 2 
60 4 0 1 1 4 3 3 5 4 5 4 5 5 3 
110 4 0 1 1 4 3 3 5 4 5 4 5 5 5 5 
60 4 0 1 1 4 3 3 5 4 5 4 5 5 2 
115 4 0 1 1 4 3 3 5 4 5 4 5 5 3 5 
65 4 0 1 1 4 3 3 5 4 5 4 5 5 3 1 
115 4 0 1 1 4 3 3 5 4 5 4 5 5 3 5 
60 4 0 1 1 4 3 3 5 4 5 4 5 5 3 
115 4 0 1 1 4 3 3 5 4 5 4 5 5 3 5 
60 4 0 1 1 4 3 3 5 4 5 4 5 5 3 
115 4 0 1 1 4 3 3 5 4 5 4 5 5 3 5 
60 4 0 1 1 4 3 3 5 4 5 4 5 5 1 
65 4 0 1 1 4 3 3 5 4 5 4 5 5 3 
15 4 0 1 1 4 3 3 5 4 5 4 5 0 3 
10 4 0 1 1 4 3 3 5 4 5 4 5 1 
65 4 0 1 1 4 3 3 5 4 5 4 5 5 3 
115 4 0 1 1 4 3 3 5 4 5 4 5 5 3 5 
65 4 0 1 1 4 3 3 5 4 5 4 5 5 3 
115 4 0 1 1 4 3 3 5 4 5 4 5 5 3 5 
15 4 0 1 1 4 3 3 5 4 5 4 5 3 3 
10 4 0 1 1 4 3 3 5 4 5 4 5 2 
10 4 0 1 1 4 3 3 5 4 5 4 5 2 
10 4 0 1 1 4 3 3 5 4 5 4 5 1 
115 4 0 1 1 4 3 3 5 4 5 4 5 5 3 5 
60 4 0 1 1 4 3 3 5 4 5 4 5 5 0 
115 4 0 1 1 4 3 3 5 4 5 4 5 5 3 5 
60 4 0 1 1 4 3 3 5 4 5 4 5 5 1 
40 4 0 1 1 4 3 3 5 4 5 4 5 5 
45 4 0 1 1 4 3 3 5 4 5 4 5 5 3 
60 4 0 1 1 4 3 3 5 4 5 4 5 5 3 
65 4 0 1 1 4 3 3 5 4 5 4 5 5 3 
65 4 0 1 1 4 3 3 5 4 5 4 5 5 3 
65 4 0 1 1 4 3 3 5 4 5 4 5 5 3 1 
115 4 0 1 1 4 3 3 5 4 5 4 5 5 3 5 
10 4 0 1 1 4 3 3 5 4 5 4 5 1 
15 4 0 1 1 4 3 3 5 4 5 4 5 3 5 
40 4 0 1 1 4 3 3 5 4 5 4 5 5 
115 4 0 1 1 4 3 3 5 4 5 4 5 5 3 5 1 
60 4 0 1 1 4 3 3 5 4 5 4 5 5 0 
65 4 0 1 1 4 3 3 5 4 5 4 5 5 3 
110 4 0 1 1 4 3 3 5 4 5 4 5 5 5 5 
10 4 0 1 1 4 3 3 5 4 5 4 5 1 
65 4 0 1 1 4 3 3 5 4 5 4 5 5 3 
65 4 0 1 1 4 3 3 5 4 5 4 5 5 3 
15 4 0 1 1 4 3 3 5 4 5 4 5 0 1 
65 4 0 1 1 4 3 3 5 4 5 4 5 5 3 
110 4 0 1 1 4 3 3 5 4 5 4 5 5 5 4 
115 4 0 1 1 4 3 3 5 4 5 4 5 5 5 0 0 
60 4 0 1 1 4 3 3 5 4 5 4 5 5 2 
60 4 0 1 1 4 3 3 5 4 5 4 5 5 1 
110 4 0 1 1 4 3 3 5 4 5 4 5 5 5 5 
10 4 0 1 1 4 3 3 5 4 5 4 5 4 
40 4 0 1 1 4 3 3 5 4 5 4 5 0 4 2 
115 4 0 1 1 4 3 3 5 4 5 4 5 5 3 5 
10 4 0 1 1 4 3 3 5 4 5 4 5 1 
115 4 0 1 1 4 3 3 5 4 5 4 5 5 5 0 1 
65 4 0 1 1 4 3 3 5 4 5 4 5 5 3 
115 4 0 1 1 4 3 3 5 4 5 4 5 5 3 5 
10 4 0 1 1 4 3 3 5 4 5 4 5 4 
65 4 0 1 1 4 3 3 5 4 5 4 5 5 3 
10 4 0 1 1 4 3 3 5 4 5 4 5 2 
60 4 0 1 1 4 3 3 5 4 5 4 5 5 0 
115 4 0 1 1 4 3 3 5 4 5 4 5 5 3 5 
65 4 0 1 1 4 3 3 5 4 5 4 5 5 3 
15 4 0 1 1 4 3 3 5 4 5 4 5 0 1 
60 4 0 1 1 4 3 3 5 4 5 4 5 5 3 
110 4 0 1 1 4 3 3 5 4 5 4 5 5 5 2 
115 4 0 1 1 4 3 3 5 4 5 4 5 5 3 5 
60 4 0 1 1 4 3 3 5 4 5 4 5 5 0 
60 4 0 1 1 4 3 3 5 4 5 4 5 5 3 
65 4 0 1 1 4 3 3 5 4 5 4 5 5 3 
10 4 0 1 1 4 3 3 5 4 5 4 5 1 
65 4 0 1 1 4 3 3 5 4 5 4 5 5 3 
10 4 0 1 1 4 3 3 5 4 5 4 5 4 
40 4 0 1 1 4 3 3 5 4 5 4 5 0 4 1 
115 4 0 1 1 4 3 3 5 4 5 4 5 5 3 5 
115 4 0 1 1 4 3 3 5 4 5 4 5 5 3 5 
115 4 0 1 1 4 3 3 5 4 5 4 5 5 3 5 
60 4 0 1 1 4 3 3 5 4 5 4 5 5 3 
60 4 0 1 1 4 3 3 5 4 5 4 5 5 2 
60 4 0 1 1 4 3 3 5 4 5 4 5 5 1 
65 4 0 1 1 4 3 3 5 4 5 4 5 5 3 
115 4 0 1 1 4 3 3 5 4 5 4 5 5 3 5 5 
65 4 0 1 1 4 3 3 5 4 5 4 5 5 3 
65 4 0 1 1 4 3 3 5 4 5 4 5 5 3 
15 4 0 1 1 4 3 3 5 4 5 4 5 0 2 
60 4 0 1 1 4 3 3 5 4 5 4 5 5 4 
60 4 0 1 1 4 3 3 5 4 5 4 5 5 1 
15 4 0 1 1 4 3 3 5 4 5 4 5 0 0 
60 4 0 1 1 4 3 3 5 4 5 4 5 5 2 
60 4 0 1 1 4 3 3 5 4 5 4 5 5 2 
115 4 0 1 1 4 3 3 5 4 5 4 5 5 3 5 4 
105 4 0 1 1 4 3 3 5 4 5 4 5 5 3 4 3 0 0 
60 4 0 1 1 4 3 3 5 4 5 4 5 5 3 
10 4 0 1 1 4 3 3 5 4 5 4 5 2 
115 4 0 1 1 4 3 3 5 4 5 4 5 5 3 5 
10 4 0 1 1 4 3 3 5 4 5 4 5 4 
65 4 0 1 1 4 3 3 5 4 5 4 5 5 3 
65 4 0 1 1 4 3 3 5 4 5 4 5 5 3 
65 4 0 1 1 4 3 3 5 4 5 4 5 5 3 
15 4 0 1 1 4 3 3 5 4 5 4 5 3 3 
10 4 0 1 1 4 3 3 5 4 5 4 5 4 
60 4 0 1 1 4 3 3 5 4 5 4 5 5 4 
-50 0 5 0 1 3 1 1 3 4 4 3 5 0 
-50 4 5 0 2 2 3 0 3 1 0 4 0 
-55 1 1 0 4 0 1 1 2 1 3 0 4 1 
-55 3 0 3 2 5 5 1 5 3 4 
-55 4 4 3 2 3 0 1 2 4 4 0 4 
-55 4 3 3 3 0 2 2 5 5 4 
-55 0 5 1 3 3 2 5 0 5 4 
-55 2 4 5 2 0 0 3 2 3 1 
-55 3 2 1 2 0 5 0 1 4 3 2 
40 4 1 0 5 3 2 4 5 3 3 5 4 4 1 
-55 3 2 2 2 0 4 3 2 0 1 
-55 0 4 0 1 2 1 1 4 0 5 0 2 
-55 0 5 3 3 1 5 1 1 0 5 5 
-55 5 4 2 4 3 3 5 3 0 1 1 
-55 3 0 1 1 5 3 4 0 5 2 5 
-55 3 1 0 5 4 2 3 5 3 4 2 
-55 4 5 3 4 2 1 0 0 0 5 2 
-55 3 4 5 2 5 0 0 5 0 2 
-55 0 1 4 1 3 3 3 2 5 2 5 
-55 3 2 0 0 4 1 1 1 5 1 0 4 
-55 4 1 2 0 3 5 4 1 4 3 0 5 
-50 4 0 1 1 4 3 3 5 4 5 0 3 2 
-50 4 0 1 1 4 3 3 5 4 5 3 3 1 
-60 0 5 0 5 5 0 1 2 5 
-60 4 5 1 3 5 4 5 3 0 2 
-60 1 5 1 1 1 4 3 3 4 0 4 5 
-60 4 5 3 2 2 5 0 3 2 
-60 1 4 3 5 0 1 5 5 0 5 
-60 2 0 4 1 5 0 5 1 3 2 
-60 4 3 5 0 0 2 2 2 5 
-60 5 5 3 0 5 1 1 4 3 2 
-60 3 2 2 3 4 0 2 2 2 
-60 3 3 0 4 1 3 5 0 3 2 0 2 0 1 
-60 5 3 3 4 4 1 5 1 0 1 2 
-60 0 3 0 4 5 1 2 4 2 2 
-60 0 5 1 4 3 0 3 3 3 3 2 4 0 1 2 
-60 0 5 3 5 4 0 2 4 4 2 
-60 5 1 5 3 5 0 5 3 5 
-60 3 1 3 4 1 5 0 1 4 2 2 
60 4 0 1 1 4 3 3 5 4 5 4 5 5 0 
-55 4 0 1 1 4 3 3 5 4 5 0 5 
-40 4 0 1 1 4 3 3 5 4 5 4 0 
-55 4 0 1 1 4 3 3 5 4 5 3 1 
-65 2 1 5 4 2 0 3 1 5 
-65 1 5 5 0 1 0 1 4 1 2 
-65 0 4 4 0 3 4 2 0 4 0 3 5 0 4 
-65 0 2 3 2 1 4 4 2 2 
-40 4 3 1 0 0 1 4 3 3 5 5 3 3 3 1 
-60 3 0 0 1 1 1 0 0 4 5 3 3 5 0 0 
-65 2 0 2 1 3 4 3 3 0 2 3 3 1 
-65 3 4 2 2 1 5 3 4 2 
-65 3 4 3 3 3 3 4 0 2 3 2 2 4 
-65 3 3 1 2 4 5 1 4 1 2 
-65 5 1 1 2 1 0 0 2 5 
-65 1 1 5 3 2 0 5 4 5 
-65 4 1 4 0 4 4 0 2 1 4 2 
-65 2 0 0 3 0 4 5 0 0 4 2 0 1 
-65 4 1 4 0 2 3 2 2 5 
-65 4 3 2 5 4 4 1 3 1 2 
-60 4 0 1 1 4 3 3 5 4 5 2 
-60 3 4 3 3 0 2 1 3 0 3 0 2 2 4 
-60 4 0 1 1 4 3 3 5 4 5 2 
-60 4 0 1 1 4 3 3 5 4 5 5 
-60 4 0 1 1 4 3 3 5 4 5 2 
-60 4 0 1 1 4 3 3 5 4 5 2 
-60 4 0 1 1 4 3 3 5 4 5 2 
-60 4 0 1 1 4 3 3 5 4 5 2 
-60 4 0 1 1 4 3 3 5 4 5 2 
-60 4 0 1 1 4 3 3 5 4 5 5 
-60 4 0 1 1 4 3 3 5 4 5 5 
-60 4 0 1 1 4 3 3 5 4 5 5 
-65 2 3 4 4 4 4 4 1 4 3 5 
-65 1 1 1 3 1 4 1 1 3 2 5 
-65 0 4 0 3 0 0 0 1 3 5 5 5 2 
-65 0 1 1 3 0 5 3 1 3 5 0 1 3 4 
-65 3 0 5 5 0 3 0 1 3 3 1 2 2 
-60 4 0 1 1 4 3 3 5 4 5 2 
-65 3 5 2 2 0 2 3 3 0 0 0 4 
-65 0 0 4 0 4 2 2 3 0 4 0 3 1 4 
-65 5 1 3 2 2 2 3 5 
-65 5 1 4 3 2 5 1 3 2 
-65 4 1 4 2 2 0 5 3 2 
-70 0 3 0 4 2 3 2 1 0 5 3 1 
-70 2 3 2 1 3 3 5 1 0 3 3 4 
-70 5 3 3 3 1 4 1 3 0 2 1 3 5 
-70 0 0 1 3 2 3 5 4 4 1 0 0 2 
-70 3 3 2 2 0 1 0 0 5 3 1 4 
-70 3 5 5 4 4 2 4 5 
-70 1 2 0 1 1 5 4 3 0 0 0 0 1 
-70 4 3 1 3 5 3 4 5 0 3 1 0 5 
-70 1 0 2 5 4 1 5 2 
-70 4 1 4 5 5 2 3 5 
-70 2 2 0 3 3 0 4 4 3 0 1 4 1 
-70 0 2 5 2 1 2 2 
-70 5 3 5 0 5 1 3 4 0 0 3 5 
-25 2 1 2 0 2 2 5 4 
-70 5 5 5 4 2 0 5 
-75 2 3 0 0 4 0 4 5 3 2 5 
-75 3 3 1 3 5 5 4 2 3 0 2 
-75 0 4 0 0 2 3 4 2 5 3 5 
-75 1 3 2 1 3 0 0 4 5 4 0 5 
-75 3 0 1 1 1 5 1 3 3 4 4 3 5 
-75 2 1 0 0 3 4 3 5 5 3 2 
-80 3 1 5 4 0 3 3 2 5 5 
-80 2 0 4 0 2 0 1 3 2 5 
-80 2 4 3 1 4 3 0 3 2 4 5 
-80 2 2 2 3 1 3 1 0 0 5 
-80 4 1 3 2 0 0 4 3 0 3 5 3 3 3 4 
-80 5 3 4 5 1 3 3 1 4 3 2 
-80 2 2 2 3 0 2 3 3 5 
-80 5 2 3 3 3 2 0 4 4 2 
-80 1 4 3 3 1 3 1 1 2 1 0 2 
-80 2 5 3 0 4 3 3 3 3 1 3 0 4 0 1 
-80 3 3 3 5 1 2 1 0 2 5 
-80 3 1 0 4 4 4 5 3 5 3 2 
-80 3 1 3 0 5 5 4 3 5 2 
-80 1 2 4 3 0 0 2 3 5 5 
-80 2 3 3 0 4 4 3 3 0 2 3 1 0 3 2 
-80 0 4 2 2 1 3 0 3 5 2 
-80 2 4 5 2 0 3 0 0 4 5 
-80 4 5 3 3 5 2 0 0 1 2 
-80 0 1 0 0 2 0 1 2 5 5 
-85 3 1 3 0 3 2 3 0 2 4 1 3 3 5 
-85 5 3 1 3 0 1 0 3 0 3 1 3 2 2 
-90 1 5 0 1 2 0 3 0 4 3 0 3 5 
-95 5 0 4 3 0 2 4 1 3 0 3 2 
-95 3 0 3 2 5 4 4 1 3 0 0 5 
-95 4 4 3 0 3 4 4 2 1 0 3 0 5 
