220 3 0 2 3 2 1 3 1 4 1 3 3 
235 0 4 4 2 2 3 4 2 3 5 
250 4 5 3 1 2 2 5 1 
210 5 2 3 4 4 0 5 0 5 
245 4 1 2 5 5 1 4 0 0 
210 1 0 5 0 5 0 4 1 0 0 3 3 2 
220 4 5 0 3 0 1 5 2 3 3 5 
235 3 0 1 1 5 5 3 4 2 4 
