999999 6 3 6 1 5 5 6 4 3 5 6 6 4 3 4 5 4 
999994 6 3 6 1 5 5 6 4 3 5 6 6 2 6 4 
999994 6 3 6 1 5 5 6 4 3 5 6 6 1 1 6 1 
999994 6 3 6 1 5 5 6 4 3 5 6 6 4 4 6 6 
999994 6 3 6 1 5 5 6 4 3 5 6 6 4 4 6 2 
999994 6 3 6 1 5 5 6 4 3 5 6 6 5 6 2 
999994 6 3 6 1 5 5 6 4 3 5 6 6 1 1 6 5 
300 6 3 6 1 5 5 6 4 5 6 5 4 4 3 1 3 2 
295 6 3 6 1 5 5 6 4 3 5 6 6 4 3 3 1 4 
285 6 3 6 1 5 5 6 4 3 5 6 6 4 3 1 1 
280 6 3 6 1 5 5 6 4 3 5 6 6 4 1 2 
280 6 3 6 1 5 5 6 4 3 5 6 6 5 1 
280 6 3 6 1 5 5 6 4 3 5 6 6 4 4 4 
280 6 3 6 1 5 5 6 4 3 5 6 6 2 1 
280 6 3 6 1 5 5 6 4 3 5 6 6 4 4 4 
275 6 3 6 1 5 5 6 4 3 5 6 6 4 3 3 3 1 
265 6 3 6 1 5 5 6 4 3 5 6 2 4 1 6 
255 6 3 6 1 5 5 6 4 3 5 6 6 4 5 
255 6 3 6 1 5 5 6 4 3 5 6 6 4 2 6 
255 6 3 6 1 5 5 6 4 3 5 6 6 4 2 
255 6 3 6 1 5 5 6 4 3 5 6 6 4 2 6 
255 6 3 6 1 5 5 6 4 3 5 6 6 4 6 
255 6 3 6 1 5 5 6 4 3 5 6 6 4 2 3 
255 6 3 6 1 5 5 6 4 3 5 6 6 4 2 4 
255 6 3 6 1 5 5 6 4 3 5 6 6 4 5 
255 6 3 6 1 5 5 6 4 3 5 6 6 4 2 2 
255 6 3 6 1 5 5 6 4 3 5 6 6 4 2 
230 6 3 6 1 5 5 6 4 3 5 6 6 6 
230 6 3 6 1 5 5 6 4 3 5 6 6 6 
105 6 3 6 1 5 5 6 4 3 5 3 1 
100 6 3 6 1 5 5 6 4 3 5 5 
100 6 3 6 1 5 5 6 4 3 5 2 
100 6 3 6 1 5 5 6 4 5 3 2 
100 6 3 6 1 5 5 6 4 5 3 5 
50 6 3 6 1 5 5 6 4 3 2 
50 6 3 6 1 5 5 6 4 3 1 
50 6 3 6 1 5 5 6 4 3 1 
50 6 3 6 1 5 5 6 4 3 2 
50 6 3 6 1 5 5 6 4 3 4 
50 6 3 6 1 5 5 6 4 3 2 
50 6 3 6 1 5 5 6 4 3 6 
45 6 3 6 1 5 5 6 4 4 
45 6 3 6 1 5 5 6 4 1 
45 6 3 6 1 5 5 6 4 6 
45 6 3 6 1 5 5 6 4 4 
20 6 3 6 1 5 5 6 3 
20 6 3 6 1 5 5 6 1 
20 6 3 6 1 5 5 6 6 
-40 6 3 6 1 5 5 3 4 
-45 6 3 6 1 5 5 2 
-110 6 3 6 1 5 5 6 4 3 5 6 5 
-120 6 3 6 1 5 5 6 4 3 5 6 6 4 
-120 6 3 6 1 5 5 6 4 3 5 6 6 4 
-120 6 3 6 1 5 5 6 4 3 5 6 6 4 
-120 6 3 6 1 5 5 6 4 3 5 6 6 
-120 6 3 6 1 5 5 6 4 3 5 6 6 
-120 6 3 6 1 5 5 6 4 3 5 6 6 4 
-120 6 3 6 1 5 5 6 4 3 5 6 6 4 
-120 6 3 6 1 5 5 6 4 3 5 6 6 4 
-120 6 3 6 1 5 5 6 4 3 5 6 6 4 
-210 6 3 6 1 5 5 6 4 3 5 
-270 6 3 6 1 5 5 6 4 3 5 
-275 6 3 6 1 5 5 6 4 3 
-275 6 3 6 1 5 5 6 4 3 
-300 4 1 1 4 5 6 5 6 
-325 6 3 6 1 5 5 6 4 
-325 6 3 6 1 5 5 6 4 
-330 6 3 6 1 5 5 6 4 
-330 6 3 6 1 5 5 6 
-355 6 3 6 1 5 5 
