305 6 1 5 2 4 1 2 5 3 4 5 3 6 2 6 5 
280 5 6 6 2 6 5 5 6 5 1 1 4 5 
155 5 6 6 2 6 5 5 6 3 
155 5 6 6 2 6 5 5 6 3 
155 5 6 6 2 6 5 5 6 3 
90 5 6 6 2 6 5 5 5 
90 5 6 6 2 6 5 5 2 
90 5 6 6 2 6 5 5 5 
90 5 6 6 2 6 5 5 1 
90 5 6 6 2 6 5 5 5 
90 5 6 6 2 6 5 5 2 
90 5 6 6 2 6 5 5 2 
90 5 6 6 2 6 5 5 3 
90 5 6 6 2 6 5 5 4 
90 5 6 6 2 6 5 5 2 
90 5 6 6 2 6 5 5 5 
90 5 6 6 2 6 5 5 1 
90 5 6 6 2 6 5 5 5 
40 5 6 6 2 6 5 2 
40 5 6 6 2 6 5 1 
40 5 6 6 2 6 5 4 
40 5 6 6 2 6 5 6 
40 5 6 6 2 6 5 2 
40 5 6 6 2 6 5 6 
40 5 6 6 2 6 5 6 
40 5 6 6 2 6 5 3 
15 4 5 3 2 1 6 4 1 5 2 
15 4 5 3 2 1 6 4 1 5 6 
15 4 5 3 2 1 6 4 1 5 6 
15 4 5 3 2 1 6 2 5 2 
-10 5 6 6 2 6 1 
-10 5 6 6 2 6 6 
-10 5 6 6 2 6 6 
-10 5 6 6 2 6 6 
-10 5 6 6 2 6 6 
-10 5 6 6 2 6 3 
-10 5 6 6 2 6 2 3 
-30 3 2 3 6 4 4 2 2 2 
-35 4 5 3 2 1 6 4 1 4 
-35 4 5 3 2 1 6 4 1 6 4 4 4 
-35 4 5 3 2 1 6 4 1 6 4 3 6 
-35 4 5 3 2 1 6 4 1 6 1 
-35 4 5 3 2 1 6 4 1 6 4 1 
-35 4 5 3 2 1 6 4 1 6 4 5 6 
-35 4 5 3 2 1 6 4 1 6 6 6 
-35 4 5 3 2 1 6 4 1 6 4 6 
-35 4 5 3 2 1 6 4 1 6 4 1 
-35 4 5 3 2 1 6 4 1 6 
-35 4 5 3 2 1 6 4 1 6 4 3 
-35 4 5 3 2 1 6 4 1 6 1 
-35 4 5 3 2 1 6 4 1 6 4 6 
-35 4 5 3 2 1 6 4 1 6 4 2 
-35 4 5 3 2 1 6 4 1 6 4 2 
-35 4 5 3 2 1 6 4 1 6 4 4 
-35 4 5 3 2 1 6 4 1 1 5 
-35 4 5 3 2 1 6 4 1 6 2 
-35 4 5 3 2 1 6 4 1 6 4 3 3 
-35 4 5 3 2 1 6 4 1 3 
-35 4 5 3 2 1 6 4 1 1 
-60 4 5 3 2 1 6 4 5 
-335 5 6 6 2 6 
-335 5 6 6 2 6 
-335 5 6 6 2 6 
-335 5 6 6 2 6 
-360 4 5 3 2 1 6 4 1 
-370 6 1 2 6 4 1 5 
-410 4 5 3 2 1 6 4 
-410 1 2 2 6 4 5 
-435 4 5 3 2 1 6 4 
-440 3 2 6 4 3 6 
