-40 2 0 1 5 1 4 1 4 1 3 2 
-90 2 0 1 5 0 3 4 2 5 
-65 2 0 1 5 0 2 0 2 4 
-90 4 4 0 4 4 4 1 3 3 1 4 5 
-75 2 5 3 4 4 4 2 2 
-60 5 4 0 0 0 2 4 0 4 2 1 
-65 2 0 1 5 0 3 5 2 1 
-60 2 0 1 5 0 3 5 2 0 1 
-60 2 0 1 5 0 3 5 2 0 2 
-5 2 0 1 5 0 3 5 2 0 5 0 0 
-65 2 0 1 5 0 3 5 2 1 
-65 2 0 1 5 0 3 5 2 2 
-10 2 0 1 5 0 3 5 2 3 5 2 
-60 2 0 1 5 0 3 5 2 0 2 
40 2 0 1 5 0 3 5 2 0 5 5 4 
40 2 0 1 5 0 3 5 2 0 5 5 2 
