999999 5 5 3 2 6 4 6 5 5 6 6 3 2 5 2 
999994 5 5 3 2 6 4 6 5 5 6 6 3 2 6 
999994 5 5 3 2 6 4 6 5 5 6 6 5 6 3 
999994 5 5 3 2 6 4 6 5 5 6 6 3 5 6 
305 5 5 3 2 6 4 6 5 5 6 5 1 3 2 4 
295 5 5 3 2 6 4 6 5 5 6 6 1 3 4 1 
290 5 5 3 2 6 4 6 5 5 6 6 5 3 1 
290 5 5 3 2 6 4 6 5 5 6 6 5 3 2 
290 5 5 3 2 6 4 6 5 5 6 6 5 3 2 
290 5 5 3 2 6 4 6 5 5 6 6 5 3 4 
290 5 5 3 2 6 4 6 5 5 6 6 5 3 2 
290 5 5 3 2 6 4 6 5 5 6 6 5 3 1 
290 5 5 3 2 6 4 6 5 5 6 6 5 3 3 
285 5 5 3 2 6 4 6 5 5 6 6 5 5 
285 5 5 3 2 6 4 6 5 5 6 6 5 5 
285 5 5 3 2 6 4 6 5 5 6 6 5 2 
285 5 5 3 2 6 4 6 5 5 6 6 5 2 
285 5 5 3 2 6 4 6 5 5 6 6 5 5 
285 5 5 3 2 6 4 6 5 5 6 6 5 2 
285 5 5 3 2 6 4 6 5 5 6 6 1 4 2 
285 5 5 3 2 6 4 6 5 5 6 6 5 2 
285 5 5 3 2 6 4 6 5 5 6 6 2 1 
285 5 5 3 2 6 4 6 5 5 6 6 5 4 
270 5 5 3 2 6 4 6 5 5 6 2 4 1 5 
260 5 5 3 2 6 4 6 5 5 6 6 4 2 
235 5 5 3 2 6 4 6 5 5 6 6 6 
235 5 5 3 2 6 4 6 5 5 6 6 6 
170 5 5 3 2 6 4 6 5 5 6 3 
170 5 5 3 2 6 4 6 5 5 6 3 
170 5 5 3 2 6 4 6 5 5 6 3 
170 5 5 3 2 6 4 6 5 5 6 4 
170 5 5 3 2 6 4 6 5 5 6 1 
110 5 5 3 2 6 4 6 5 5 3 
105 5 5 3 2 6 4 6 5 5 5 
105 5 5 3 2 6 4 6 5 5 3 
55 5 5 3 2 6 4 6 5 2 
55 5 5 3 2 6 4 6 5 3 
55 5 5 3 2 6 4 6 5 4 
55 5 5 3 2 6 4 6 5 4 
55 5 5 3 2 6 4 6 5 4 
55 5 5 3 2 6 4 6 5 1 
30 1 3 2 2 2 4 3 1 1 5 1 1 
5 5 5 3 2 6 4 6 6 
5 5 5 3 2 6 4 6 1 
5 5 5 3 2 6 4 6 4 
0 5 5 3 2 6 4 3 3 5 1 
-50 5 5 3 2 6 4 3 3 2 
-50 5 6 4 6 2 4 
-55 5 5 3 2 6 4 3 1 
-60 5 5 3 2 6 4 5 
-205 5 5 3 2 6 4 6 5 5 
-270 5 5 3 2 6 4 6 5 
-320 5 5 3 2 6 4 6 
-320 5 5 3 2 6 4 6 
-320 5 5 3 2 6 4 6 
-365 5 5 3 2 6 4 3 
-370 5 5 3 2 6 4 
-370 5 5 3 2 6 4 
-370 5 5 3 2 6 4 
-370 5 5 3 2 6 4 
-370 5 5 3 2 6 4 
-370 5 5 3 2 6 4 
-435 5 5 3 2 6 
-435 5 5 3 2 6 
