-65 5 0 4 2 3 2 3 2 2 
60 4 4 2 2 4 5 3 0 4 5 1 4 0 1 
-55 5 2 0 0 4 0 1 3 1 3 5 3 
-70 4 3 4 1 0 3 5 0 3 4 3 2 0 1 
-30 1 2 1 5 4 2 5 4 
-55 2 4 3 2 5 0 2 3 3 0 4 
-40 1 3 1 2 3 0 1 4 5 2 3 
20 1 3 5 0 3 3 0 5 2 2 5 1 1 
-85 2 4 0 5 3 2 3 0 1 2 
-65 5 3 3 0 5 5 2 1 5 
-5 0 1 3 0 3 1 2 2 2 3 4 5 1 
-70 3 5 1 0 5 5 5 2 
-45 1 5 1 0 3 1 4 1 1 5 4 
-45 4 3 5 1 4 5 3 2 1 1 
-65 1 5 3 2 1 0 5 1 0 5 
-80 0 1 5 3 0 3 1 4 1 3 0 0 0 4 3 3 3 
-85 5 3 5 3 2 4 0 3 1 2 
-45 2 5 1 5 5 3 4 0 1 
-70 3 1 5 1 0 5 5 1 5 
-70 2 2 3 3 3 0 3 1 3 5 4 0 2 
-55 5 5 0 0 3 5 1 0 5 3 1 
-80 1 1 5 5 0 0 4 3 0 1 3 2 
0 5 0 2 3 0 3 0 1 1 5 4 5 0 4 
-40 0 4 1 4 3 1 2 1 2 4 0 3 
-50 0 0 1 4 5 3 2 1 1 4 3 3 3 4 
-40 0 5 4 3 3 1 2 2 2 0 
-55 0 3 3 1 0 1 0 4 4 4 5 5 2 
30 2 5 0 3 2 5 2 5 1 1 
-70 4 3 0 0 0 4 5 3 0 4 2 1 3 2 
-75 4 5 3 1 1 4 0 0 0 0 1 3 1 2 
-55 2 5 5 3 5 0 4 0 3 0 2 
-55 3 0 2 4 3 4 5 3 3 4 1 1 3 
-75 3 1 2 0 2 3 0 1 4 3 4 3 2 
-45 5 5 3 5 3 2 4 1 1 
30 2 2 4 5 1 0 5 4 5 0 3 
-40 1 2 3 2 4 0 1 2 1 3 3 
-25 2 3 1 2 2 5 2 3 
-55 1 5 1 5 5 2 2 
0 1 0 2 1 3 3 3 3 0 1 2 3 0 1 5 3 0 5 
-50 1 5 2 1 5 3 4 4 2 
-85 4 5 4 3 0 3 1 4 2 3 2 
-75 4 0 2 1 1 1 1 2 2 
-65 2 3 3 2 2 3 5 1 2 
-70 3 4 2 5 0 5 2 5 
-40 5 1 1 5 0 0 2 1 4 0 2 
-45 1 2 1 0 2 2 5 0 2 
-75 5 2 1 4 1 0 4 4 2 
-85 4 0 3 5 5 3 0 4 2 5 
-60 0 3 4 3 4 3 2 2 1 5 4 
-5 4 5 5 3 0 0 3 1 5 3 4 5 2 
-75 4 1 1 0 4 1 2 2 2 
-40 5 3 4 0 0 1 2 5 1 4 0 
-60 1 4 5 0 3 2 2 3 1 3 2 
-75 0 2 5 4 1 3 0 3 3 0 5 1 
-85 5 5 4 3 3 2 1 0 3 5 
-40 3 4 4 0 3 2 1 2 4 5 2 
-70 1 0 1 4 1 1 2 2 0 2 
-65 1 3 0 0 0 3 2 4 1 0 4 0 4 0 4 2 
-65 4 1 3 0 0 2 4 1 2 4 2 
-55 5 5 4 0 0 0 4 4 0 0 5 0 
-65 3 1 2 1 5 0 0 2 1 2 
-40 1 2 5 2 1 3 3 0 5 1 
-45 3 2 4 5 2 3 4 2 1 
-25 0 2 5 4 2 2 4 4 3 
-60 3 4 2 4 4 0 1 0 5 0 1 1 
-85 0 4 0 1 1 3 4 1 5 0 1 2 
-70 1 4 0 2 3 5 2 4 5 
-55 1 5 2 5 4 2 5 
-65 3 4 2 1 5 4 3 3 4 1 5 
-65 3 1 0 5 4 3 2 4 1 1 2 
-70 0 0 0 3 4 1 1 3 1 5 0 5 3 4 
15 3 0 5 2 1 1 4 1 2 3 5 0 5 
-70 5 2 1 0 0 0 0 0 1 0 3 2 1 
-70 0 1 2 4 4 5 1 4 0 2 
-40 2 4 0 5 5 5 0 3 4 4 
-45 5 2 3 5 1 4 0 2 4 
-50 5 1 0 0 4 1 2 0 3 4 0 0 4 1 
-50 3 3 1 4 4 1 2 0 4 2 3 0 0 4 
-55 3 3 2 2 3 1 2 2 0 0 2 
-60 5 1 4 3 3 0 5 3 2 1 4 
-55 3 4 3 5 4 3 4 1 5 3 4 0 1 
-85 3 2 0 0 5 0 5 1 1 2 
-70 5 0 4 3 4 2 5 4 2 
-60 3 1 2 3 4 5 4 3 1 0 1 2 
-40 2 5 4 0 1 0 3 4 1 5 1 
-40 5 5 2 3 0 2 2 0 1 
-45 0 2 2 4 1 2 3 2 1 
-40 3 2 2 2 2 5 3 0 4 
-70 3 5 0 4 5 4 1 2 2 
10 1 5 3 3 5 2 3 4 1 4 5 2 
-55 2 1 4 3 3 1 2 3 2 3 3 0 
-45 4 1 1 5 3 3 1 2 5 2 
-70 1 0 5 5 1 0 1 2 2 
-40 5 0 0 3 1 1 4 2 1 4 1 0 
-85 1 5 0 5 0 1 0 2 0 5 
-70 2 1 5 4 1 5 3 0 5 
-40 3 2 2 3 5 5 0 5 0 
-70 3 3 0 0 3 2 0 3 0 3 2 3 1 2 3 0 
-40 2 2 1 3 5 3 5 1 0 3 
-90 0 0 3 3 2 1 0 1 1 5 0 3 0 4 
-40 0 5 1 5 0 5 4 4 3 4 3 
-55 0 4 0 4 3 3 5 4 0 1 1 2 3 
-70 3 1 3 0 1 0 3 4 1 1 0 4 3 2 0 
-30 4 1 1 5 1 5 5 4 3 
-55 2 4 3 1 4 4 0 0 2 3 3 4 3 
-50 4 2 2 5 0 4 5 2 
-55 5 1 4 5 4 0 0 3 2 3 3 0 
-50 2 4 5 3 2 1 4 4 2 
-60 0 5 4 1 2 5 3 4 3 0 2 
-50 4 2 2 5 4 3 5 4 
-80 1 1 2 0 2 3 5 0 0 0 5 
-40 5 4 5 3 1 3 2 3 4 1 2 
100 5 5 1 5 4 4 1 0 3 5 0 0 4 5 3 2 
-50 0 2 5 5 2 1 1 5 
-40 4 2 2 5 0 4 2 0 0 2 
-55 0 5 3 1 5 1 0 4 0 0 2 2 
-60 0 2 1 2 3 2 0 3 5 1 
-80 0 5 1 4 5 0 2 0 0 3 2 
-50 2 1 1 4 3 2 1 4 1 5 
-60 2 1 0 3 1 5 1 3 2 0 1 
-45 2 1 5 2 3 2 4 3 2 
-75 2 1 5 3 5 5 5 
-50 2 1 5 3 2 4 5 1 
-65 2 1 5 3 2 1 0 0 4 2 
-70 2 1 5 3 2 1 3 4 2 
-60 2 1 5 3 2 1 3 0 0 4 4 
-40 2 1 5 3 2 1 3 0 2 3 
60 2 1 5 3 2 1 3 0 2 5 5 4 
110 2 1 5 3 2 1 3 0 2 5 5 5 5 
15 2 1 5 3 2 1 3 0 2 5 0 5 
110 2 1 5 3 2 1 3 0 2 5 5 5 1 
65 2 1 5 3 2 1 3 0 2 5 5 3 0 
115 2 1 5 3 2 1 3 0 2 5 5 5 3 5 
110 2 1 5 3 2 1 3 0 2 5 5 5 2 
110 2 1 5 3 2 1 3 0 2 5 5 5 2 
15 2 1 5 3 2 1 3 0 2 5 0 5 
140 2 1 5 3 2 1 3 0 2 5 5 5 0 1 
110 2 1 5 3 2 1 3 0 2 5 5 5 5 
60 2 1 5 3 2 1 3 0 2 5 5 1 
115 2 1 5 3 2 1 3 0 2 5 5 5 0 1 
115 2 1 5 3 2 1 3 0 2 5 5 5 0 0 
110 2 1 5 3 2 1 3 0 2 5 5 5 4 
60 2 1 5 3 2 1 3 0 2 5 5 1 
60 2 1 5 3 2 1 3 0 2 5 5 1 
115 2 1 5 3 2 1 3 0 2 5 5 5 0 1 
110 2 1 5 3 2 1 3 0 2 5 5 5 5 
60 2 1 5 3 2 1 3 0 2 5 5 2 
115 2 1 5 3 2 1 3 0 2 5 5 5 3 0 
15 2 1 5 3 2 1 3 0 2 5 3 2 
115 2 1 5 3 2 1 3 0 2 5 5 5 0 5 
60 2 1 5 3 2 1 3 0 2 5 5 1 
120 2 1 5 3 2 1 3 0 2 5 5 5 0 3 
115 2 1 5 3 2 1 3 0 2 5 5 5 0 2 
115 2 1 5 3 2 1 3 0 2 5 5 5 0 3 
60 2 1 5 3 2 1 3 0 2 5 5 3 
110 2 1 5 3 2 1 3 0 2 5 5 5 0 
60 2 1 5 3 2 1 3 0 2 5 5 2 
10 2 1 5 3 2 1 3 0 2 5 4 
110 2 1 5 3 2 1 3 0 2 5 5 5 5 
10 2 1 5 3 2 1 3 0 2 5 2 
110 2 1 5 3 2 1 3 0 2 5 5 5 1 
115 2 1 5 3 2 1 3 0 2 5 5 5 0 1 
10 2 1 5 3 2 1 3 0 2 5 1 
110 2 1 5 3 2 1 3 0 2 5 5 5 5 
60 2 1 5 3 2 1 3 0 2 5 5 3 
115 2 1 5 3 2 1 3 0 2 5 5 5 0 0 
110 2 1 5 3 2 1 3 0 2 5 5 5 5 
65 2 1 5 3 2 1 3 0 2 5 5 0 0 
10 2 1 5 3 2 1 3 0 2 5 2 
60 2 1 5 3 2 1 3 0 2 5 5 1 
115 2 1 5 3 2 1 3 0 2 5 5 5 0 4 
110 2 1 5 3 2 1 3 0 2 5 5 5 4 
110 2 1 5 3 2 1 3 0 2 5 5 5 4 
115 2 1 5 3 2 1 3 0 2 5 5 5 0 5 
115 2 1 5 3 2 1 3 0 2 5 5 5 0 2 
110 2 1 5 3 2 1 3 0 2 5 5 5 2 
110 2 1 5 3 2 1 3 0 2 5 5 5 1 
110 2 1 5 3 2 1 3 0 2 5 5 5 1 
60 2 1 5 3 2 1 3 0 2 5 5 3 
60 2 1 5 3 2 1 3 0 2 5 5 4 
115 2 1 5 3 2 1 3 0 2 5 5 5 0 1 
10 2 1 5 3 2 1 3 0 2 5 4 
115 2 1 5 3 2 1 3 0 2 5 5 5 0 2 
15 2 1 5 3 2 1 3 0 2 5 0 2 
60 2 1 5 3 2 1 3 0 2 5 5 2 
115 2 1 5 3 2 1 3 0 2 5 5 5 0 4 
60 2 1 5 3 2 1 3 0 2 5 5 2 
15 2 1 5 3 2 1 3 0 2 5 0 0 
60 2 1 5 3 2 1 3 0 2 5 5 3 
110 2 1 5 3 2 1 3 0 2 5 5 5 4 
140 2 1 5 3 2 1 3 0 2 5 5 5 0 1 
115 2 1 5 3 2 1 3 0 2 5 5 5 0 5 
15 2 1 5 3 2 1 3 0 2 5 3 5 
110 2 1 5 3 2 1 3 0 2 5 5 5 2 
115 2 1 5 3 2 1 3 0 2 5 5 5 3 5 
110 2 1 5 3 2 1 3 0 2 5 5 5 5 
10 2 1 5 3 2 1 3 0 2 5 4 
60 2 1 5 3 2 1 3 0 2 5 5 4 
60 2 1 5 3 2 1 3 0 2 5 5 2 
60 2 1 5 3 2 1 3 0 2 5 5 0 
65 2 1 5 3 2 1 3 0 2 5 5 3 2 
15 2 1 5 3 2 1 3 0 2 5 3 0 
275 2 1 5 3 2 1 3 0 2 5 5 5 0 5 0 2 0 1 1 2 
60 2 1 5 3 2 1 3 0 2 5 5 2 
110 2 1 5 3 2 1 3 0 2 5 5 5 1 
60 2 1 5 3 2 1 3 0 2 5 5 2 
110 2 1 5 3 2 1 3 0 2 5 5 5 1 
115 2 1 5 3 2 1 3 0 2 5 5 5 0 0 
15 2 1 5 3 2 1 3 0 2 5 3 3 
110 2 1 5 3 2 1 3 0 2 5 5 5 2 
60 2 1 5 3 2 1 3 0 2 5 5 2 
10 2 1 5 3 2 1 3 0 2 5 4 
115 2 1 5 3 2 1 3 0 2 5 5 5 0 1 
15 2 1 5 3 2 1 3 0 2 5 0 5 
115 2 1 5 3 2 1 3 0 2 5 5 5 3 5 
115 2 1 5 3 2 1 3 0 2 5 5 5 0 4 
60 2 1 5 3 2 1 3 0 2 5 5 2 
10 2 1 5 3 2 1 3 0 2 5 1 
110 2 1 5 3 2 1 3 0 2 5 5 5 5 
60 2 1 5 3 2 1 3 0 2 5 5 4 
115 2 1 5 3 2 1 3 0 2 5 5 5 0 1 
15 2 1 5 3 2 1 3 0 2 5 3 0 
10 2 1 5 3 2 1 3 0 2 5 1 
115 2 1 5 3 2 1 3 0 2 5 5 5 0 5 
115 2 1 5 3 2 1 3 0 2 5 5 5 0 0 
60 2 1 5 3 2 1 3 0 2 5 5 1 
60 2 1 5 3 2 1 3 0 2 5 5 4 
110 2 1 5 3 2 1 3 0 2 5 5 5 1 
115 2 1 5 3 2 1 3 0 2 5 5 5 0 5 
165 2 1 5 3 2 1 3 0 2 5 5 5 0 2 
60 2 1 5 3 2 1 3 0 2 5 5 0 
60 2 1 5 3 2 1 3 0 2 5 5 1 
60 2 1 5 3 2 1 3 0 2 5 5 4 
40 2 1 5 3 2 1 3 0 2 5 0 4 1 
10 2 1 5 3 2 1 3 0 2 5 1 
115 2 1 5 3 2 1 3 0 2 5 5 5 0 4 
10 2 1 5 3 2 1 3 0 2 5 1 
115 2 1 5 3 2 1 3 0 2 5 5 5 0 5 
110 2 1 5 3 2 1 3 0 2 5 5 5 2 
115 2 1 5 3 2 1 3 0 2 5 5 5 3 0 
110 2 1 5 3 2 1 3 0 2 5 5 5 5 
115 2 1 5 3 2 1 3 0 2 5 5 5 0 5 
115 2 1 5 3 2 1 3 0 2 5 5 5 3 3 
115 2 1 5 3 2 1 3 0 2 5 5 5 3 3 
60 2 1 5 3 2 1 3 0 2 5 5 4 
110 2 1 5 3 2 1 3 0 2 5 5 5 0 
65 2 1 5 3 2 1 3 0 2 5 5 3 0 
60 2 1 5 3 2 1 3 0 2 5 5 1 
115 2 1 5 3 2 1 3 0 2 5 5 5 3 1 
20 2 1 5 3 2 1 3 0 2 5 0 0 2 
110 2 1 5 3 2 1 3 0 2 5 5 5 3 
60 2 1 5 3 2 1 3 0 2 5 5 4 
115 2 1 5 3 2 1 3 0 2 5 5 5 0 5 
115 2 1 5 3 2 1 3 0 2 5 5 5 0 1 
115 2 1 5 3 2 1 3 0 2 5 5 5 0 1 
110 2 1 5 3 2 1 3 0 2 5 5 5 0 2 
