999999 2 4 3 2 3 2 6 6 4 5 6 6 2 3 3 3 5 3 6 
999999 2 4 3 2 3 2 6 6 4 5 6 6 2 3 3 3 5 3 5 
999994 2 4 3 2 3 2 6 6 4 5 6 6 2 3 6 5 
999994 2 4 3 2 3 2 6 6 4 5 6 6 2 3 3 6 6 
999994 2 4 3 2 3 2 6 6 4 5 6 6 2 3 3 5 1 5 
999994 2 4 3 2 3 2 6 6 4 5 6 6 2 3 3 3 6 
999994 2 4 3 2 3 2 6 6 4 5 6 6 2 3 3 3 5 6 
999994 2 4 3 2 3 2 6 6 4 5 6 6 2 3 3 6 2 
999994 2 4 3 2 3 2 6 6 4 5 6 6 2 3 3 5 5 
999994 2 4 3 2 3 2 6 6 4 5 6 6 2 3 3 6 2 
999994 2 4 3 2 3 2 6 6 4 5 6 6 2 3 3 3 5 2 
999994 2 4 3 2 3 2 6 6 4 5 6 6 2 3 3 3 5 6 
999994 2 4 3 2 3 2 6 6 4 5 6 6 2 3 3 3 5 6 
999994 2 4 3 2 3 2 6 6 4 5 6 6 6 5 3 6 
999994 2 4 3 2 3 2 6 6 4 5 6 6 2 1 5 2 
999994 2 4 3 2 3 2 6 6 4 5 6 6 4 4 6 5 
999994 2 4 3 2 3 2 6 6 4 5 6 6 5 6 3 1 
999994 2 4 3 2 3 2 6 6 4 5 6 6 5 6 2 
999994 2 4 3 2 3 2 6 6 4 5 6 6 5 3 6 4 
999994 2 4 3 2 3 2 6 6 4 5 6 6 5 4 5 2 
999994 2 4 3 2 3 2 6 6 4 5 6 6 2 3 3 6 1 
999619 2 4 3 2 3 2 6 6 4 5 6 6 5 4 
300 2 4 3 2 3 2 6 6 4 5 6 5 1 4 1 4 4 
295 2 4 3 2 3 2 6 6 4 5 6 6 1 1 4 3 
290 2 4 3 2 3 2 6 6 4 5 6 6 5 4 4 
290 2 4 3 2 3 2 6 6 4 5 6 6 5 1 3 
290 2 4 3 2 3 2 6 6 4 5 6 6 5 1 2 
280 2 4 3 2 3 2 6 6 4 5 6 6 2 3 3 3 1 
280 2 4 3 2 3 2 6 6 4 5 6 6 2 3 3 3 4 
275 2 4 3 2 3 2 6 6 4 5 6 6 2 3 3 1 
275 2 4 3 2 3 2 6 6 4 5 6 6 2 3 3 4 
275 2 4 3 2 3 2 6 6 4 5 6 6 2 3 3 4 
275 2 4 3 2 3 2 6 6 4 5 6 6 2 3 3 2 
275 2 4 3 2 3 2 6 6 4 5 6 6 2 3 3 1 
275 2 4 3 2 3 2 6 6 4 5 6 6 2 3 3 1 
270 2 4 3 2 3 2 6 6 4 5 6 6 2 3 1 
270 2 4 3 2 3 2 6 6 4 5 6 6 2 3 2 
270 2 4 3 2 3 2 6 6 4 5 6 6 1 3 4 1 
270 2 4 3 2 3 2 6 6 4 5 6 6 2 3 1 
270 2 4 3 2 3 2 6 6 4 5 6 6 2 3 1 
270 2 4 3 2 3 2 6 6 4 5 6 6 2 3 2 
265 2 4 3 2 3 2 6 6 4 5 6 6 2 5 
265 2 4 3 2 3 2 6 6 4 5 6 6 5 5 
265 2 4 3 2 3 2 6 6 4 5 6 6 2 5 
260 2 4 3 2 3 2 6 6 4 5 6 6 1 3 3 3 3 4 
245 2 4 3 2 3 2 6 6 4 5 6 6 3 1 6 
160 2 4 3 2 3 2 6 6 4 5 6 3 3 2 1 2 
150 2 4 3 2 3 2 6 6 4 5 6 1 
-85 2 4 3 2 3 2 6 6 4 5 6 6 5 
-85 2 4 3 2 3 2 6 6 4 5 6 6 5 
-95 2 4 3 2 3 2 6 6 4 5 6 6 2 3 3 
-95 2 4 3 2 3 2 6 6 4 5 6 6 2 3 3 
-95 2 4 3 2 3 2 6 6 4 5 6 6 2 3 3 
-95 2 4 3 2 3 2 6 6 4 5 6 6 2 3 3 
-100 2 4 3 2 3 2 6 6 4 5 6 6 2 3 
-100 2 4 3 2 3 2 6 6 4 5 6 6 2 3 
-100 2 4 3 2 3 2 6 6 4 5 6 6 2 3 
-100 2 4 3 2 3 2 6 6 4 5 6 6 2 3 
-105 2 4 3 2 3 2 6 6 4 5 6 6 2 
-105 2 4 3 2 3 2 6 6 4 5 6 6 2 
-105 2 4 3 2 3 2 6 6 4 5 6 6 2 
-105 2 4 3 2 3 2 6 6 4 5 6 6 2 
-105 2 4 3 2 3 2 6 6 4 5 6 6 2 
-110 2 4 3 2 3 2 6 6 4 5 6 6 
