220 5 3 4 3 5 1 3 5 1 1 5 5 5 6 3 5 2 5 
210 5 3 4 3 5 1 3 5 1 1 5 5 5 6 2 2 6 
115 5 3 4 3 5 1 3 5 1 1 5 5 3 5 3 
115 5 3 4 3 5 1 3 5 1 1 5 5 5 3 5 
115 5 3 4 3 5 1 3 5 1 1 5 5 5 3 5 
110 5 3 4 3 5 1 3 5 1 1 5 5 5 4 
110 5 3 4 3 5 1 3 5 1 1 5 5 5 6 4 
110 5 3 4 3 5 1 3 5 1 1 5 5 5 4 
65 5 3 4 3 5 1 3 5 1 1 5 3 5 4 
60 5 3 4 3 5 1 3 5 1 1 5 5 2 
60 5 3 4 3 5 1 3 5 1 1 5 5 1 
60 5 3 4 3 5 1 3 5 1 1 5 5 4 
60 5 3 4 3 5 1 3 5 1 1 5 5 1 
60 5 3 4 3 5 1 3 5 1 1 5 5 2 
60 5 3 4 3 5 1 3 5 1 1 5 5 4 
60 5 3 4 3 5 1 3 5 1 1 5 5 2 
60 5 3 4 3 5 1 3 5 1 1 5 5 1 
60 5 3 4 3 5 1 3 5 1 1 5 5 4 
45 5 3 4 3 5 1 3 5 1 1 5 3 4 5 
10 5 3 4 3 5 1 3 5 1 1 5 6 
10 5 3 4 3 5 1 3 5 1 1 5 6 
10 5 3 4 3 5 1 3 5 1 1 5 4 
10 5 3 4 3 5 1 3 5 1 1 5 4 
10 5 3 4 3 5 1 3 5 1 1 5 4 
5 5 3 1 2 2 1 1 1 3 6 4 1 1 
-10 5 3 1 2 2 1 1 1 3 6 4 3 3 1 
-15 5 3 1 2 2 1 1 1 3 6 4 5 6 5 4 2 4 
-15 5 3 1 2 2 1 1 1 3 6 4 5 6 5 4 
-15 5 3 1 2 2 1 1 1 3 6 4 5 6 5 4 
-15 5 3 1 2 2 1 1 1 3 6 4 5 6 5 4 
-15 5 3 1 2 2 1 1 1 3 6 4 5 6 5 4 
-15 5 3 1 2 2 1 1 1 3 6 4 5 6 5 4 2 4 
-15 5 3 1 2 2 1 1 1 3 6 4 5 6 5 4 2 
-15 5 3 1 2 2 1 1 1 3 6 4 5 6 5 4 
-15 5 3 1 2 2 1 1 1 3 6 4 5 6 5 4 2 
-15 5 3 1 2 2 1 1 1 3 6 4 5 6 5 4 
-15 5 3 1 2 2 1 1 1 3 6 4 5 6 5 4 2 
-15 5 3 1 2 2 1 1 1 3 6 4 5 6 5 4 2 
-15 5 3 1 2 2 1 1 1 3 6 4 5 6 5 4 
-15 5 3 1 2 2 1 1 1 3 6 4 5 6 5 4 2 4 
-15 5 3 1 2 2 1 1 1 3 6 4 5 6 5 4 2 
-15 5 3 1 2 2 1 1 1 3 6 4 5 6 5 4 2 
-15 5 3 1 2 2 1 1 1 3 6 4 5 6 5 4 
-15 5 3 1 2 2 1 1 1 3 6 4 5 6 5 4 2 
-15 5 3 1 2 2 1 1 1 3 6 4 5 6 5 4 
-15 5 3 1 2 2 1 1 1 3 6 4 5 6 5 4 2 
-15 5 3 1 2 2 1 1 1 3 6 4 5 3 6 
-15 5 3 1 2 2 1 1 1 3 6 4 5 
-15 5 3 1 2 2 1 1 1 3 6 4 5 6 5 4 
-15 5 3 1 2 2 1 1 1 3 6 4 5 6 5 4 
-15 5 3 1 2 2 1 1 1 3 6 4 5 6 5 4 2 
-15 5 3 1 2 2 1 1 1 3 6 4 5 6 5 4 2 4 
-15 5 3 1 2 2 1 1 1 3 6 4 5 6 5 4 2 
-15 5 3 1 2 2 1 1 1 3 6 4 5 6 5 4 2 
-15 5 3 1 2 2 1 1 1 3 6 4 5 6 5 4 2 
-15 5 3 1 2 2 1 1 1 3 6 4 5 6 5 4 2 4 
-15 5 3 1 2 2 1 1 1 3 6 4 5 6 5 4 
-15 5 3 1 2 2 1 1 1 3 6 4 5 6 5 4 2 
-15 5 3 1 2 2 1 1 1 3 6 4 5 6 5 4 2 4 
-15 5 3 1 2 2 1 1 1 3 6 4 5 6 5 4 2 4 
-15 5 3 1 2 2 1 1 1 3 6 4 5 6 5 4 2 4 
-25 4 3 5 1 2 2 4 1 1 4 
-30 4 4 4 5 4 2 4 1 1 6 1 
-40 5 3 4 3 5 1 3 5 1 1 2 
