85 4 3 1 3 1 6 5 2 6 4 5 1 
85 4 3 1 3 1 6 5 2 6 4 5 1 
45 5 1 4 3 3 4 1 4 2 1 6 4 1 
40 4 3 1 3 1 6 5 2 6 4 3 2 
40 4 3 1 3 1 6 5 2 6 4 3 3 
35 4 3 1 3 1 6 5 2 6 4 2 
35 4 3 1 3 1 6 5 2 6 4 6 
35 4 3 1 3 1 6 5 2 6 4 4 
25 1 2 1 5 1 4 2 4 5 3 6 
20 4 3 1 3 1 6 5 2 5 4 1 
20 4 3 1 3 1 6 5 2 5 4 6 
20 4 4 3 5 4 4 2 1 3 1 5 3 3 2 
10 4 3 1 3 1 6 5 2 6 1 
10 4 2 5 1 2 6 5 1 
10 4 3 1 3 1 6 5 2 6 1 
10 4 3 1 3 1 6 5 2 6 5 
10 4 3 1 3 1 6 5 2 6 5 
-55 5 4 6 1 3 4 2 1 5 5 
-55 5 4 6 1 3 4 2 1 5 5 
-55 5 4 6 1 3 4 2 1 5 5 
-55 5 4 6 1 3 4 2 1 5 5 5 
-55 5 4 6 1 3 4 2 1 5 5 5 
-55 5 4 6 1 3 4 2 1 5 5 5 
-55 5 4 6 1 3 4 2 1 5 5 5 
-55 5 4 6 1 3 4 2 1 5 5 
-55 5 4 6 1 3 4 2 1 5 5 
-55 5 4 6 1 3 4 2 1 5 5 5 
-55 5 4 6 1 3 4 2 1 5 
-55 5 4 6 1 3 4 2 1 5 5 
-55 5 4 6 1 3 4 2 1 5 5 5 
-55 5 4 6 1 3 4 2 1 5 
-55 5 4 6 1 3 4 2 1 5 5 5 
-55 5 4 6 1 3 4 2 1 5 5 5 
-55 5 4 6 1 3 4 2 1 5 
-55 5 4 6 1 3 4 2 1 5 5 5 
-55 5 4 6 1 3 4 2 1 5 5 5 
-55 5 4 6 1 3 4 2 1 5 5 
-55 5 4 6 1 3 4 2 1 5 5 
-55 5 4 6 1 3 4 2 1 5 5 
-55 5 4 6 1 3 4 2 1 5 
-55 5 4 6 1 3 4 2 1 5 
-55 4 3 1 3 1 6 5 2 1 
-55 4 3 1 3 1 6 5 2 1 
-55 5 4 6 1 3 4 2 1 5 
-55 5 4 6 1 3 4 2 1 5 5 5 
-55 5 4 6 1 3 4 2 1 5 5 5 
-55 5 4 6 1 3 4 2 1 5 5 
-55 5 4 6 1 3 4 2 1 5 5 5 
-55 5 4 6 1 3 4 2 1 5 5 
-55 5 4 6 1 3 4 2 1 5 
-55 5 4 6 1 3 4 2 1 5 5 
-55 5 4 6 1 3 4 2 1 5 
-70 5 2 4 5 3 1 4 2 5 3 
-80 4 3 1 3 1 6 5 4 2 
-90 1 3 3 2 4 5 5 3 6 
-90 3 1 6 4 6 1 2 5 5 
-355 4 1 2 5 2 2 4 
-365 4 3 1 3 1 6 5 2 
-365 4 3 1 3 1 6 5 2 
-365 4 3 1 3 1 6 5 2 
-365 4 3 1 3 1 6 5 2 
-430 4 3 1 3 1 6 5 
-430 4 3 1 3 1 6 5 
-430 4 3 1 3 1 6 5 
