999994 2 1 5 5 6 1 5 5 5 6 5 4 3 1 6 6 
999994 2 1 5 5 6 1 5 5 5 6 2 5 3 6 2 
999994 2 1 5 5 6 1 5 5 5 6 2 3 2 1 6 
295 2 1 5 5 6 1 5 5 5 6 6 3 1 4 3 
290 2 1 5 5 6 1 5 5 5 6 6 5 2 
290 2 1 5 5 6 1 5 5 5 6 6 3 3 3 3 4 2 
275 2 1 5 5 6 1 5 5 5 6 2 2 6 
260 2 1 5 5 6 1 5 5 5 6 2 1 3 3 2 
245 2 1 5 5 6 1 5 5 5 6 6 3 6 
175 2 1 5 5 6 1 5 5 5 6 3 
175 2 1 5 5 6 1 5 5 5 6 3 
175 2 1 5 5 6 1 5 5 5 6 3 
175 2 1 5 5 6 1 5 5 5 6 1 
175 2 1 5 5 6 1 5 5 5 6 1 
175 2 1 5 5 6 1 5 5 5 6 4 
110 2 1 5 5 6 1 5 5 5 5 
110 2 1 5 5 6 1 5 5 5 5 
110 2 1 5 5 6 1 5 5 5 4 
110 2 1 5 5 6 1 5 5 5 1 
110 2 1 5 5 6 1 5 5 5 2 
110 2 1 5 5 6 1 5 5 5 1 
110 2 1 5 5 6 1 5 5 5 5 
110 2 1 5 5 6 1 5 5 5 1 
110 2 1 5 5 6 1 5 5 5 2 
105 2 1 5 5 6 3 6 5 4 4 1 
60 2 1 5 5 6 1 5 5 1 
60 2 1 5 5 6 1 5 5 4 
60 2 1 5 5 6 1 5 5 1 
60 2 1 5 5 6 1 5 5 6 
60 2 1 5 5 6 1 5 5 1 
40 2 1 5 5 6 1 5 3 4 4 
35 2 1 5 5 6 3 6 4 3 2 
10 2 1 5 5 6 1 5 4 
10 2 1 5 5 6 1 5 2 
5 2 1 5 5 6 3 6 3 
-30 2 1 5 5 2 2 1 
-30 2 1 5 5 5 5 6 
-40 2 1 5 5 6 1 4 
-40 2 1 5 5 6 1 4 
-40 2 1 5 5 6 4 2 
-45 2 2 4 5 4 5 3 3 2 
-55 2 1 5 5 2 4 6 
-55 2 1 5 5 6 3 3 4 
-60 2 1 5 5 6 3 5 
-75 2 1 5 5 5 3 2 
-265 2 1 5 5 6 1 5 5 
-265 2 1 5 5 6 1 5 5 
-315 2 1 5 5 6 1 5 
-315 2 1 5 5 6 1 5 
-315 2 1 5 5 6 1 5 
-365 2 1 5 5 6 1 
-370 2 1 5 5 6 3 
-415 2 1 5 5 6 
-415 2 1 5 5 6 
-415 2 1 5 5 6 
-415 1 5 1 6 2 
-415 2 1 5 5 6 
-415 2 1 5 5 6 
-430 2 1 5 5 6 3 
-440 2 1 5 5 
-440 2 1 5 5 
-440 2 1 5 5 
-440 2 1 5 5 
-440 2 1 5 5 
