5 2 4 3 5 3 2 4 5 5 2 
55 2 4 3 5 3 2 4 5 5 5 1 
-45 2 4 3 5 3 2 4 5 1 
80 2 4 3 5 3 2 4 5 5 5 4 3 
80 2 4 3 5 3 2 4 5 5 5 4 6 
5 2 4 3 5 3 2 4 5 5 2 
-45 2 4 3 5 3 2 4 5 3 
5 2 4 3 5 3 2 4 5 5 1 
30 2 4 3 5 3 2 4 5 5 4 1 
-45 2 4 3 5 3 2 4 5 4 
60 2 4 3 5 3 2 4 5 5 5 3 3 
105 2 4 3 5 3 2 4 5 5 5 5 2 
80 2 4 3 5 3 2 4 5 5 5 4 3 
80 2 4 3 5 3 2 4 5 5 5 4 3 
80 2 4 3 5 3 2 4 5 5 5 4 2 
-45 2 4 3 5 3 2 4 5 4 
-45 2 4 3 5 3 2 4 5 2 
60 2 4 3 5 3 2 4 5 5 5 3 3 
10 2 4 3 5 3 2 4 5 5 3 2 
30 2 4 3 5 3 2 4 5 5 4 5 
-45 2 4 3 5 3 2 4 5 6 4 
80 2 4 3 5 3 2 4 5 5 5 4 6 
105 2 4 3 5 3 2 4 5 5 5 5 2 
80 2 4 3 5 3 2 4 5 5 5 4 2 
80 2 4 3 5 3 2 4 5 5 5 4 3 
80 2 4 3 5 3 2 4 5 5 5 4 5 
80 2 4 3 5 3 2 4 5 5 5 4 2 
135 2 4 3 5 3 2 4 5 5 5 5 4 6 
5 2 4 3 5 3 2 4 5 5 2 
-45 2 4 3 5 3 2 4 5 2 
60 2 4 3 5 3 2 4 5 5 5 6 6 
65 2 4 3 5 3 2 4 5 5 5 3 6 
-125 6 2 2 1 4 1 5 
-125 4 6 2 2 5 6 
-125 6 2 4 5 2 5 
-125 6 5 5 6 1 5 6 6 
-125 4 2 2 2 6 2 
-135 3 5 2 6 3 4 4 3 5 
-140 4 4 4 1 3 3 6 2 6 
-140 2 5 6 2 3 3 6 
-140 6 3 5 6 3 2 5 6 4 
-140 5 3 5 6 2 3 6 
-140 3 2 1 3 6 1 1 4 6 
-140 1 1 3 4 4 3 6 6 5 6 3 
-140 3 6 2 2 5 3 2 
-145 4 1 2 1 6 1 3 6 
-145 3 6 2 5 5 2 
-145 2 5 3 6 5 2 
-155 3 6 3 4 3 5 3 4 4 5 
-160 3 5 3 6 5 3 4 6 
-170 1 3 6 2 5 6 
-175 2 6 4 4 6 4 2 
-175 6 5 5 6 1 6 6 
-175 1 4 5 6 1 6 2 
-175 4 4 6 1 1 4 6 4 
-190 6 6 3 2 1 4 3 2 
-190 1 5 3 3 6 1 6 4 
-190 4 4 6 5 6 3 3 3 
-200 5 6 6 6 5 1 
-210 6 3 2 3 4 6 3 5 
-215 4 6 2 6 3 3 5 
-220 1 3 6 6 4 1 5 
-240 4 3 1 3 6 6 6 
-250 6 1 6 6 4 3 
