20 2 4 3 3 5 1 2 3 2 5 3 3 3 
65 2 4 3 3 5 1 2 3 2 5 5 3 3 
-40 2 4 3 3 5 1 2 3 2 6 
-40 2 4 3 3 5 1 2 3 2 4 
60 2 4 3 3 5 1 2 3 2 5 5 2 
60 2 4 3 3 5 1 2 3 2 5 5 4 
60 2 4 3 3 5 1 2 3 2 5 5 4 
10 2 4 3 3 5 1 2 3 5 5 4 
-40 2 4 3 3 5 1 2 3 2 1 
-40 2 4 3 3 5 1 2 3 2 2 
60 2 4 3 3 5 1 2 3 2 5 5 4 
60 2 4 3 3 5 1 2 3 2 5 5 2 
15 2 4 3 3 5 1 2 3 2 5 3 2 
65 2 4 3 3 5 1 2 3 2 5 5 3 6 
10 2 4 3 3 5 1 2 3 2 5 6 
-60 2 4 3 3 5 1 2 3 4 3 1 
10 2 4 3 3 5 1 2 3 2 5 6 
-40 2 4 3 3 5 1 2 3 2 2 
-90 2 4 3 3 5 1 2 3 6 
-40 2 4 3 3 5 1 2 3 2 1 
-40 2 4 3 3 5 1 2 3 2 4 
-40 2 4 3 3 5 1 2 3 2 1 
60 2 4 3 3 5 1 2 3 2 5 5 2 
55 2 4 3 3 5 1 2 3 2 5 3 4 3 3 1 
60 2 4 3 3 5 1 2 3 2 5 5 2 
10 2 4 3 3 5 1 2 3 2 5 6 
-40 2 4 3 3 5 1 2 3 5 3 
-60 2 4 3 3 5 1 2 3 4 3 2 
-85 2 4 3 3 5 1 2 3 3 6 
-40 2 4 3 3 5 1 2 3 2 1 
-40 2 4 3 3 5 1 2 3 2 3 
-85 2 4 3 3 5 1 2 3 3 6 
-125 2 4 4 4 6 5 2 
-125 1 4 4 4 4 6 2 2 
-125 1 2 4 4 5 6 6 
-125 4 5 1 5 4 6 2 
-125 5 1 4 6 1 4 1 6 
-135 4 3 6 4 5 5 3 3 2 
-190 4 3 6 1 3 4 6 4 5 3 3 6 
-140 2 4 3 1 4 3 4 6 6 
-140 5 3 3 4 6 4 5 5 
-140 6 2 3 1 4 3 2 5 
-140 1 1 3 4 4 3 5 6 5 
-150 1 3 4 4 3 4 3 6 1 3 3 5 
-165 4 6 3 3 5 2 6 
-170 4 2 5 3 6 6 3 
-175 1 6 5 4 1 6 2 
-175 1 4 5 4 6 6 2 
-180 3 3 3 2 3 5 6 6 
-185 1 6 3 3 4 2 3 6 2 
-190 1 6 6 5 3 3 1 2 
-190 6 5 3 6 3 2 4 
-195 6 6 3 6 5 5 6 
-200 6 2 4 6 4 2 
-200 5 4 1 6 6 6 
-200 1 6 2 4 6 2 
-215 3 5 3 4 6 6 2 
-215 5 1 3 6 6 3 5 
-225 6 4 6 5 6 
-225 6 1 5 6 6 
-225 6 4 2 6 6 
-245 6 2 6 6 3 3 
-270 1 6 3 6 6 5 
-300 6 6 6 6 
