20 6 6 5 3 3 1 5 1 4 3 2 
20 6 6 5 3 3 1 5 1 4 3 6 
0 6 6 5 3 3 1 6 4 6 
-15 6 6 5 3 3 1 5 1 3 
-15 6 6 5 3 3 1 5 1 3 
-15 6 6 5 3 3 1 5 1 2 
-35 6 6 5 3 3 1 5 3 1 
-35 6 6 5 3 3 1 5 3 2 
-35 6 6 5 3 3 1 5 3 6 
-35 6 6 5 3 3 1 5 3 2 
-40 6 6 5 3 3 1 5 2 
-85 6 6 5 3 3 1 3 6 
-90 6 6 5 3 3 1 2 
-90 6 6 5 3 3 1 4 
-90 6 6 5 3 3 1 2 
-90 6 6 5 3 3 1 2 
-155 1 4 4 5 4 2 
-155 1 3 4 3 4 6 2 
-155 2 4 4 5 1 2 5 1 
-155 2 4 4 5 1 2 3 
-155 2 4 4 5 1 4 
-155 2 4 4 5 1 2 5 5 2 
-155 2 4 4 5 1 2 5 1 
-155 2 4 4 5 1 2 5 1 
-155 2 4 4 5 1 2 2 
-155 2 4 4 5 1 2 5 
-155 2 4 4 5 1 6 
-155 2 4 4 5 1 1 
-155 2 4 4 5 2 
-155 2 4 4 5 1 2 6 
