999999 5 5 3 2 6 4 6 5 5 6 6 3 3 3 6 3 5 
999994 5 5 3 2 6 4 6 5 5 6 6 3 2 5 2 
999994 5 5 3 2 6 4 6 5 5 6 6 3 2 5 2 
999994 5 5 3 2 6 4 6 5 5 6 6 3 2 5 2 
999994 5 5 3 2 6 4 6 5 5 6 6 3 2 5 4 
999994 5 5 3 2 6 4 6 5 5 6 6 3 2 5 5 
999994 5 5 3 2 6 4 6 5 5 6 6 3 4 6 4 
999994 5 5 3 2 6 4 6 5 5 6 6 3 5 5 1 
999994 5 5 3 2 6 4 6 5 5 6 6 3 2 6 
999994 5 5 3 2 6 4 6 5 5 6 6 3 2 5 1 
999994 5 5 3 2 6 4 6 5 5 6 6 3 2 5 6 
999994 5 5 3 2 6 4 6 5 5 6 6 2 6 1 
999994 5 5 3 2 6 4 6 5 5 6 6 1 3 6 5 
999994 5 5 3 2 6 4 6 5 5 6 6 3 2 6 
999994 5 5 3 2 6 4 6 5 5 6 6 3 4 6 6 
999994 5 5 3 2 6 4 6 5 5 6 5 1 3 2 6 
999619 5 5 3 2 6 4 6 5 5 6 6 3 2 
999619 5 5 3 2 6 4 6 5 5 6 6 3 2 
999619 5 5 3 2 6 4 6 5 5 6 6 3 2 
290 5 5 3 2 6 4 6 5 5 6 6 3 2 1 
290 5 5 3 2 6 4 6 5 5 6 6 5 3 3 
290 5 5 3 2 6 4 6 5 5 6 6 3 5 4 
290 5 5 3 2 6 4 6 5 5 6 6 3 1 4 1 
290 5 5 3 2 6 4 6 5 5 6 6 3 1 4 2 
290 5 5 3 2 6 4 6 5 5 6 6 5 3 4 
290 5 5 3 2 6 4 6 5 5 6 6 3 2 3 
290 5 5 3 2 6 4 6 5 5 6 2 3 6 1 
290 5 5 3 2 6 4 6 5 5 6 6 3 2 4 
290 5 5 3 2 6 4 6 5 5 6 6 3 5 1 
290 5 5 3 2 6 4 6 5 5 6 6 3 2 2 
290 5 5 3 2 6 4 6 5 5 6 6 5 3 2 
290 5 5 3 2 6 4 6 5 5 6 6 3 5 3 
290 5 5 3 2 6 4 6 5 5 6 6 3 2 3 
290 5 5 3 2 6 4 6 5 5 6 6 5 3 3 
285 5 5 3 2 6 4 6 5 5 6 6 4 1 1 
285 5 5 3 2 6 4 6 5 5 6 6 5 1 
285 5 5 3 2 6 4 6 5 5 6 6 5 1 
285 5 5 3 2 6 4 6 5 5 6 6 2 5 
285 5 5 3 2 6 4 6 5 5 6 6 5 5 
285 5 5 3 2 6 4 6 5 5 6 6 5 4 
285 5 5 3 2 6 4 6 5 5 6 6 5 4 
285 5 5 3 2 6 4 6 5 5 6 6 2 5 
270 5 5 3 2 6 4 6 5 5 6 6 3 3 1 4 
270 5 5 3 2 6 4 6 5 5 6 6 3 4 3 4 
270 5 5 3 2 6 4 6 5 5 6 2 4 4 2 
270 5 5 3 2 6 4 6 5 5 6 6 3 3 4 4 
265 5 5 3 2 6 4 6 5 5 6 6 3 1 5 
265 5 5 3 2 6 4 6 5 5 6 6 3 1 5 
260 5 5 3 2 6 4 6 5 5 6 6 1 5 
260 5 5 3 2 6 4 6 5 5 6 6 4 2 
245 5 5 3 2 6 4 6 5 5 6 6 3 3 5 
245 5 5 3 2 6 4 6 5 5 6 2 1 6 
240 5 5 3 2 6 4 6 5 5 6 6 3 6 
170 5 5 3 2 6 4 6 5 5 6 4 
170 5 5 3 2 6 4 6 5 5 6 3 
-85 5 5 3 2 6 4 6 5 5 6 6 3 
-85 5 5 3 2 6 4 6 5 5 6 6 3 
-85 5 5 3 2 6 4 6 5 5 6 6 3 
-85 5 5 3 2 6 4 6 5 5 6 6 3 
-90 5 5 3 2 6 4 6 5 5 6 6 
-205 5 5 3 2 6 4 6 5 5 
-205 5 5 3 2 6 4 6 5 5 
-270 5 5 3 2 6 4 6 5 
-270 5 5 3 2 6 4 6 5 
