-60 2 0 1 5 3 4 5 1 3 2 
-105 2 0 1 5 0 0 0 3 2 2 
-65 2 0 1 5 0 3 5 2 2 
-60 2 0 1 5 0 3 2 0 2 3 
-50 2 0 1 5 1 4 1 2 1 
-5 5 4 0 0 0 2 4 0 1 4 4 5 1 
-65 2 0 1 5 0 3 5 2 2 
-60 2 0 1 5 0 3 5 2 0 2 
-5 2 0 1 5 0 3 5 2 0 5 3 1 
-65 2 0 1 5 0 3 5 2 5 
-260 2 0 1 5 0 3 5 2 0 1 
-160 2 0 1 5 0 3 5 2 0 5 5 2 
40 2 0 1 5 0 3 5 2 0 5 5 4 
-5 2 0 1 5 0 3 5 2 0 5 0 1 
40 2 0 1 5 0 3 5 2 0 5 5 4 
-10 2 0 1 5 0 3 5 2 0 5 1 
