999999 2 1 5 5 6 1 5 5 5 6 6 3 3 3 6 3 6 
999999 2 1 5 5 6 1 5 5 5 6 5 4 3 1 6 3 6 
999999 2 1 5 5 6 1 5 5 5 6 5 4 3 1 6 3 6 
999999 2 1 5 5 6 1 5 5 5 6 5 4 3 1 6 3 2 
999999 2 1 5 5 6 1 5 5 5 6 5 4 3 4 1 5 4 
999994 2 1 5 5 6 1 5 5 5 6 5 4 3 1 6 4 
999994 2 1 5 5 6 1 5 5 5 6 5 4 3 1 6 5 
999994 2 1 5 5 6 1 5 5 5 6 5 4 3 1 6 5 
999994 2 1 5 5 6 1 5 5 5 6 5 4 3 1 6 1 
999994 2 1 5 5 6 1 5 5 5 6 5 4 3 1 6 5 
999994 2 1 5 5 6 1 5 5 5 6 5 4 3 1 6 5 
999994 2 1 5 5 6 1 5 5 5 6 5 4 3 1 4 6 
999994 2 1 5 5 6 1 5 5 5 6 5 4 3 1 6 4 
999994 2 1 5 5 6 1 5 5 5 6 5 4 3 1 6 2 
999994 2 1 5 5 6 1 5 5 5 6 5 4 3 1 6 6 
999994 2 1 5 5 6 1 5 5 5 6 2 3 6 5 1 
999994 2 1 5 5 6 1 5 5 5 6 2 3 5 1 6 
999994 2 1 5 5 6 1 5 5 5 6 2 5 3 6 1 
999994 2 1 5 5 6 1 5 5 5 6 5 4 3 1 6 4 
999619 2 1 5 5 6 1 5 5 5 6 5 4 3 1 
305 2 1 5 5 6 1 5 5 5 6 5 4 3 5 1 
305 2 1 5 5 6 1 5 5 5 6 5 4 3 1 4 2 
305 2 1 5 5 6 1 5 5 5 6 5 4 3 2 3 
305 2 1 5 5 6 1 5 5 5 6 5 4 3 1 4 3 
295 2 1 5 5 6 1 5 5 5 6 5 4 3 4 3 3 2 
295 2 1 5 5 6 1 5 5 5 6 6 3 1 1 1 
285 2 1 5 5 6 1 5 5 5 6 5 4 3 1 3 5 
285 2 1 5 5 6 1 5 5 5 6 5 4 3 1 3 5 
280 2 1 5 5 6 1 5 5 5 6 5 4 3 1 2 
280 2 1 5 5 6 1 5 5 5 6 5 4 3 1 5 
280 2 1 5 5 6 1 5 5 5 6 5 4 3 1 5 
280 2 1 5 5 6 1 5 5 5 6 5 4 3 1 2 
280 2 1 5 5 6 1 5 5 5 6 5 4 3 1 2 
265 2 1 5 5 6 1 5 5 5 6 6 1 6 
265 2 1 5 5 6 1 5 5 5 6 5 4 3 3 3 5 
260 2 1 5 5 6 1 5 5 5 6 5 4 3 3 6 
255 2 1 5 5 6 1 5 5 5 6 5 4 3 6 
255 2 1 5 5 6 1 5 5 5 6 5 4 3 6 
255 2 1 5 5 6 1 5 5 5 6 2 1 3 6 
255 2 1 5 5 6 1 5 5 5 6 5 4 3 6 
255 2 1 5 5 6 1 5 5 5 6 2 1 3 6 
245 2 1 5 5 6 1 5 5 5 6 6 3 6 
240 2 1 5 5 6 1 5 5 5 6 6 6 
110 2 1 5 5 6 1 5 5 5 4 
110 2 1 5 5 6 1 5 5 5 1 
110 2 1 5 5 6 1 5 5 5 3 
110 2 1 5 5 6 1 5 5 5 4 
110 2 1 5 5 6 1 5 5 5 1 
110 2 1 5 5 6 1 5 5 5 1 
110 2 1 5 5 6 1 5 5 5 5 
110 2 1 5 5 6 1 5 5 5 5 
110 2 1 5 5 6 1 5 5 5 5 
105 2 1 5 5 6 3 6 5 4 4 2 
60 2 1 5 5 6 1 5 5 4 
60 2 1 5 5 6 1 5 5 2 
60 2 1 5 5 6 1 5 5 3 
60 2 1 5 5 6 1 5 5 6 
35 2 1 5 5 6 3 6 4 3 2 
10 2 1 5 5 6 1 5 2 
10 2 1 5 5 6 1 5 2 
10 2 1 5 5 6 1 5 1 
10 2 1 5 5 6 1 5 4 
10 2 1 5 5 6 1 5 1 
-365 2 1 5 5 6 1 
