999994 5 3 4 3 5 1 3 5 1 1 5 5 5 6 3 5 2 3 6 5 
999994 5 3 4 3 5 1 3 5 1 1 5 5 5 6 3 5 2 3 6 1 
999994 5 3 4 3 5 1 3 5 1 1 5 5 5 6 3 2 6 3 5 2 
245 5 3 4 3 5 1 3 5 1 1 5 5 5 6 3 5 2 3 1 3 
245 5 3 4 3 5 1 3 5 1 1 5 5 5 6 3 5 1 5 3 2 
245 5 3 4 3 5 1 3 5 1 1 5 5 5 6 3 5 2 3 1 4 
240 5 3 4 3 5 1 3 5 1 1 5 5 5 6 3 5 4 2 2 
240 5 3 4 3 5 1 3 5 1 1 5 5 5 6 3 5 2 1 4 
240 5 3 4 3 5 1 3 5 1 1 5 5 5 6 3 5 1 5 5 
240 5 3 4 3 5 1 3 5 1 1 5 5 5 6 3 5 2 1 1 
240 5 3 4 3 5 1 3 5 1 1 5 5 5 6 3 5 4 4 4 5 
230 5 3 4 3 5 1 3 5 1 1 5 5 5 6 3 5 4 4 3 3 4 
220 5 3 4 3 5 1 3 5 1 1 5 5 5 6 3 5 3 5 5 
215 5 3 4 3 5 1 3 5 1 1 5 5 5 6 3 5 2 6 
215 5 3 4 3 5 1 3 5 1 1 5 5 5 6 3 5 2 5 
215 5 3 4 3 5 1 3 5 1 1 5 5 5 6 3 5 4 1 2 
215 5 3 4 3 5 1 3 5 1 1 5 5 5 6 3 5 2 2 
215 5 3 4 3 5 1 3 5 1 1 5 5 5 6 3 5 4 1 2 
215 5 3 4 3 5 1 3 5 1 1 5 5 5 6 3 5 2 5 
215 5 3 4 3 5 1 3 5 1 1 5 5 5 6 3 5 2 5 
185 5 3 1 2 2 1 1 1 3 6 4 5 6 5 3 1 2 4 3 
170 5 3 4 3 5 1 3 5 1 1 5 5 5 6 3 5 6 3 1 
170 5 3 4 3 5 1 3 5 1 1 5 5 5 6 3 6 3 5 1 
165 5 3 4 3 5 1 3 5 1 1 5 5 5 6 3 5 6 5 
165 5 3 4 3 5 1 3 5 1 1 5 5 5 6 3 5 6 4 
165 5 3 4 3 5 1 3 5 1 1 5 5 5 6 3 6 4 1 4 
160 5 3 4 3 5 1 3 5 1 1 5 5 5 6 2 6 2 
115 5 3 4 3 5 1 3 5 1 1 5 5 5 3 1 
115 5 3 4 3 5 1 3 5 1 1 5 5 5 6 3 1 
115 5 3 4 3 5 1 3 5 1 1 5 5 5 6 3 1 
115 5 3 4 3 5 1 3 5 1 1 5 5 5 6 3 1 
115 5 3 4 3 5 1 3 5 1 1 5 5 5 6 3 1 
115 5 3 4 3 5 1 3 5 1 1 5 5 5 3 1 
115 5 3 4 3 5 1 3 5 1 1 5 5 5 3 4 
115 5 3 4 3 5 1 3 5 1 1 5 5 5 6 3 4 
115 5 3 4 3 5 1 3 5 1 1 5 5 5 6 3 5 2 
115 5 3 4 3 5 1 3 5 1 1 5 5 5 6 3 5 
115 5 3 4 3 5 1 3 5 1 1 5 5 5 6 3 3 
110 5 3 4 3 5 1 3 5 1 1 5 5 5 1 
110 5 3 4 3 5 1 3 5 1 1 5 5 5 6 4 
110 5 3 4 3 5 1 3 5 1 1 5 5 5 4 
105 5 3 1 2 2 1 1 1 3 6 4 5 6 6 1 5 1 
65 5 3 4 3 5 1 3 5 1 1 5 5 3 6 
60 5 3 4 3 5 1 3 5 1 1 5 5 4 
60 5 3 4 3 5 1 3 5 1 1 5 5 4 
60 5 3 4 3 5 1 3 5 1 1 5 5 4 
30 5 3 1 2 2 1 1 1 3 6 4 5 6 1 
30 5 3 1 2 2 1 1 1 3 6 4 5 6 4 
30 5 3 1 2 2 1 1 1 3 6 4 5 5 
15 5 3 4 3 5 1 3 5 1 1 5 5 5 6 3 5 2 5 
15 5 3 4 3 5 1 3 5 1 1 5 3 2 
10 5 3 4 3 5 1 3 5 1 1 5 2 
10 5 3 4 3 5 1 3 5 1 1 5 1 
10 5 3 4 3 5 1 3 5 1 1 5 1 
-15 5 3 1 2 2 1 1 1 3 6 4 3 2 
-40 5 3 4 3 5 1 3 5 1 1 6 
-40 5 3 4 3 5 1 3 5 1 1 2 
-40 5 3 4 3 5 1 3 5 1 1 6 
-40 5 3 4 3 5 1 3 5 1 4 4 
-40 5 3 4 3 5 1 3 5 1 1 3 
-45 5 3 1 2 2 1 1 1 3 6 3 
-45 5 3 1 2 2 1 1 1 3 6 2 
-265 5 3 4 3 5 1 3 5 1 6 
-265 5 3 4 3 5 1 3 5 1 2 
