999994 5 6 6 2 6 5 5 6 5 1 1 4 6 4 
999994 6 1 5 2 4 1 2 5 3 4 5 3 6 2 6 6 4 
999994 6 1 5 2 4 1 2 5 3 4 5 3 6 2 6 3 5 2 
999994 6 1 5 2 4 1 2 5 3 4 5 3 6 2 6 6 4 
999994 6 1 5 2 4 1 2 5 3 4 5 3 6 2 6 3 6 1 
315 6 1 5 2 4 1 2 5 3 4 5 3 6 2 1 3 5 2 
315 6 1 5 2 4 1 2 5 3 4 5 3 6 2 1 2 3 1 
310 6 1 5 2 4 1 2 5 3 4 5 3 6 2 4 2 1 
310 6 1 5 2 4 1 2 5 3 4 5 3 6 2 2 1 4 
310 6 1 5 2 4 1 2 5 3 4 5 3 6 5 3 2 3 3 3 4 
310 6 1 5 2 4 1 2 5 3 4 5 3 6 2 4 2 1 
305 6 1 5 2 4 1 2 5 3 4 5 3 6 2 6 3 2 
305 6 1 5 2 4 1 2 5 3 4 5 3 6 2 6 3 1 
305 6 1 5 2 4 1 2 5 3 4 5 3 6 2 6 3 2 
300 6 1 5 2 4 1 2 5 3 4 5 3 6 2 6 4 
300 6 1 5 2 4 1 2 5 3 4 5 3 6 2 6 5 
300 6 1 5 2 4 1 2 5 3 4 5 3 6 2 6 1 
300 6 1 5 2 4 1 2 5 3 4 5 3 6 2 6 5 
300 6 1 5 2 4 1 2 5 3 4 5 3 6 2 6 1 
300 6 1 5 2 4 1 2 5 3 4 5 3 6 2 6 4 
285 6 1 5 2 4 1 2 5 3 4 5 3 6 5 2 6 
285 6 1 5 2 4 1 2 5 3 4 5 3 6 2 1 1 6 
280 5 6 6 2 6 5 5 6 2 2 4 2 
275 6 1 5 2 4 1 2 5 3 4 5 3 6 6 1 6 
250 6 1 5 2 4 1 2 5 3 4 5 3 6 6 6 
185 6 1 5 2 4 1 2 5 3 4 5 3 6 1 
185 6 1 5 2 4 1 2 5 3 4 5 3 6 1 
185 6 1 5 2 4 1 2 5 3 4 5 3 6 3 
185 6 1 5 2 4 1 2 5 3 4 5 3 6 4 
185 6 1 5 2 4 1 2 5 3 4 5 3 6 3 
185 6 1 5 2 4 1 2 5 3 4 5 3 6 3 
185 6 1 5 2 4 1 2 5 3 4 5 3 6 3 
185 6 1 5 2 4 1 2 5 3 4 5 3 6 1 
185 6 1 5 2 4 1 2 5 3 4 5 3 6 3 
185 6 1 5 2 4 1 2 5 3 4 5 3 6 1 
185 6 1 5 2 4 1 2 5 3 4 5 3 6 4 
185 6 1 5 2 4 1 2 5 3 4 5 3 6 3 
90 5 6 6 2 6 5 5 5 
90 5 6 6 2 6 5 5 2 
90 5 6 6 2 6 5 5 2 
90 5 6 6 2 6 5 5 1 
40 5 6 6 2 6 5 4 
40 5 6 6 2 6 5 3 
40 5 6 6 2 6 5 4 
40 5 6 6 2 6 5 3 
40 5 6 6 2 6 5 2 
40 5 6 6 2 6 5 4 
40 5 6 6 2 6 4 1 1 
20 5 6 6 2 6 4 3 1 
15 5 6 6 2 6 4 5 
15 4 5 3 2 1 6 4 1 5 1 
10 4 5 3 2 1 6 4 6 3 3 
-10 5 6 6 2 6 6 
-10 5 6 6 2 6 2 6 
-10 5 6 6 2 6 3 
-10 5 6 6 2 6 3 
-10 5 6 6 2 6 6 
-10 5 6 6 2 6 6 
-10 5 6 6 2 6 1 
-35 4 5 3 2 1 6 4 1 4 
-75 5 6 6 2 5 
-75 5 6 6 2 5 
-190 6 1 5 2 4 1 2 5 3 4 5 3 
-220 5 6 6 2 6 5 5 
-285 5 6 6 2 6 5 
-285 5 6 6 2 6 5 
-335 5 6 6 2 6 
-335 5 6 6 2 6 
-335 5 6 6 2 6 
-360 4 5 3 2 1 6 2 
