20 1 2 1 2 5 2 4 5 3 6 
120 1 2 1 2 5 2 4 5 3 5 5 5 
125 1 2 1 2 5 2 4 5 3 5 5 6 4 
125 1 2 1 2 5 2 4 5 3 5 5 6 1 
225 1 2 1 2 5 2 4 5 3 5 5 6 5 4 4 6 
125 1 2 1 2 5 2 4 5 3 5 5 6 4 
-125 1 2 1 2 5 2 4 5 3 5 3 
-75 1 2 1 2 5 2 4 5 3 5 5 3 
125 1 2 1 2 5 2 4 5 3 5 5 5 
260 1 2 1 2 5 2 4 5 3 5 5 6 2 1 3 5 4 
200 1 2 1 2 5 2 4 5 3 5 5 6 2 4 6 
-75 1 2 1 2 5 2 4 5 3 5 5 6 1 
125 1 2 1 2 5 2 4 5 3 5 5 6 1 
-125 1 2 1 2 5 2 4 5 3 5 1 
225 1 2 1 2 5 2 4 5 3 5 5 6 5 2 5 
75 1 2 1 2 5 2 4 5 3 5 6 
125 1 2 1 2 5 2 4 5 3 5 5 6 1 
-75 1 2 1 2 5 2 4 5 3 5 5 6 3 
-75 1 2 1 2 5 2 4 5 3 5 5 2 
175 1 2 1 2 5 2 4 5 3 5 5 6 6 2 4 
75 1 2 1 2 5 2 4 5 3 5 2 
75 1 2 1 2 5 2 4 5 3 5 3 
75 1 2 1 2 5 2 4 5 3 5 6 
225 1 2 1 2 5 2 4 5 3 5 5 6 5 1 1 2 
75 1 2 1 2 5 2 4 5 3 5 6 
125 1 2 1 2 5 2 4 5 3 5 5 1 
-125 1 2 1 2 5 2 4 5 3 5 2 
-75 1 2 1 2 5 2 4 5 3 5 5 4 
-125 1 2 1 2 5 2 4 5 3 5 1 
125 1 2 1 2 5 2 4 5 3 5 5 6 4 
-125 1 2 1 2 5 2 4 5 3 5 6 
125 1 2 1 2 5 2 4 5 3 5 5 6 3 
-120 6 4 5 3 1 4 2 5 
-120 6 3 2 5 1 4 4 2 
-120 1 4 1 6 2 3 5 5 
-120 2 5 6 5 4 3 6 6 
-120 3 6 1 1 2 6 1 5 4 
-125 1 5 2 1 1 6 6 
-125 1 4 5 6 5 4 2 
-125 5 1 1 2 4 6 5 
-130 6 2 3 2 3 2 3 3 4 
-135 4 3 5 2 6 1 3 3 2 
-140 5 3 3 2 1 6 4 2 
-140 6 2 4 3 1 4 1 3 2 
-145 2 2 6 2 3 6 
-150 6 1 4 4 4 5 6 
-150 5 5 1 1 6 6 
-150 4 1 5 6 5 6 
-160 5 1 2 3 3 3 6 6 
-165 3 5 6 4 2 3 6 
-170 5 1 6 6 5 3 4 
-170 3 6 6 2 4 5 4 
-175 2 4 6 6 4 1 6 3 
-190 1 3 6 1 3 1 4 6 1 
-195 6 1 6 3 2 1 6 4 
-195 1 5 3 6 4 6 6 4 
-195 6 6 4 3 1 5 2 
-195 5 1 1 6 6 3 2 
-195 6 6 2 3 2 6 2 
-195 3 1 5 6 6 1 6 2 
-200 5 3 3 3 6 6 4 3 3 1 
-225 6 4 5 6 6 
-245 6 3 6 4 6 1 6 
-290 6 6 3 6 3 2 
