-40 0 4 0 2 4 3 4 2 5 4 3 
-40 4 4 2 0 5 0 3 5 5 3 
-45 0 1 1 4 5 5 0 5 1 4 
-65 2 2 0 3 0 3 0 2 0 0 5 3 2 
-70 4 0 2 5 3 3 0 4 3 5 3 0 1 
15 5 0 4 2 1 3 5 2 5 0 0 0 
-30 5 4 2 4 1 2 1 1 2 
-60 3 1 1 1 5 0 1 0 1 3 5 5 
-50 1 2 5 0 1 2 2 2 
-45 1 5 2 0 3 1 2 2 1 
-45 5 4 2 4 3 5 2 0 2 
-70 4 0 3 0 1 3 5 0 3 5 3 5 4 
-70 0 1 0 4 5 1 0 2 1 0 3 0 0 1 
-40 0 1 4 2 2 3 3 5 2 1 
-60 0 1 2 5 5 0 5 0 0 5 
10 1 1 2 2 5 5 0 3 0 5 2 
-25 0 5 5 4 1 5 2 1 1 
-40 2 4 0 2 1 0 3 2 5 0 
-75 0 5 1 0 3 3 1 2 3 2 3 5 
-75 3 4 5 0 2 3 0 2 0 0 1 2 
-65 5 0 5 2 2 4 3 3 5 
-85 3 3 2 5 5 3 2 0 5 
-30 5 1 2 4 1 5 2 0 
-65 0 4 2 1 1 3 5 2 3 5 
-85 0 3 3 5 2 4 1 4 4 3 5 
-40 3 2 3 5 4 5 0 1 5 2 
-70 4 4 2 3 5 4 0 2 2 
-50 0 5 4 5 2 1 2 2 
-30 1 2 4 2 5 4 5 2 
35 3 4 3 1 0 5 4 3 3 0 4 5 0 5 0 5 1 
-45 4 3 5 0 4 4 4 2 1 1 1 
-80 0 0 3 2 0 5 3 2 5 5 
-40 5 1 3 0 5 5 2 1 3 1 
-40 0 5 0 5 4 3 5 1 2 2 
-50 5 2 5 3 4 5 1 4 
-70 1 0 3 3 4 2 2 3 3 4 4 0 3 1 
75 5 0 2 2 2 4 5 5 5 3 
-85 1 3 0 5 2 1 1 1 3 3 5 
-75 0 1 3 3 5 1 0 5 0 3 5 1 
-25 3 5 5 1 5 4 4 1 1 1 
-65 5 4 0 3 1 0 2 4 5 2 
-50 0 2 4 2 2 4 5 5 
-80 1 0 3 0 5 5 4 0 2 3 2 
-60 3 5 5 1 2 4 3 0 4 0 2 
-45 4 2 0 1 5 2 4 0 1 1 
-40 5 2 4 0 2 3 5 3 4 4 
-60 0 2 3 4 3 4 1 1 1 3 5 2 
-65 2 5 0 3 0 0 0 3 3 1 2 1 3 4 
-75 0 0 3 3 4 1 0 2 3 2 2 2 
-75 0 3 3 4 5 4 5 3 0 3 2 1 
-75 0 3 2 5 1 4 0 4 1 0 3 3 4 
-80 3 3 4 5 0 1 0 4 1 5 3 2 
15 3 2 0 3 2 2 2 3 4 5 4 3 
-80 4 3 0 3 5 3 3 4 5 2 2 
-75 4 1 3 1 4 3 0 1 2 1 0 0 3 4 
-55 1 1 5 1 1 4 1 2 5 
-45 1 2 3 0 5 4 5 1 1 1 
-100 0 4 4 0 5 0 0 4 3 0 2 2 
-50 0 2 1 5 1 5 2 5 
-65 1 0 5 0 2 0 1 4 5 5 
-40 2 5 1 3 1 2 3 5 0 0 
-60 0 1 5 0 0 2 0 5 1 1 5 
-60 1 1 1 4 1 0 2 3 0 4 1 0 1 
-70 0 1 4 0 2 5 1 5 2 
-100 1 1 3 0 0 5 1 3 5 0 0 5 
-40 3 0 1 5 4 4 3 1 1 1 5 1 
-60 0 3 0 2 4 4 5 1 4 1 3 4 
-60 5 1 0 4 0 1 5 3 2 0 4 
-60 2 3 4 5 5 3 1 0 4 3 1 
-80 4 1 4 0 2 0 3 2 1 0 0 2 
-45 0 5 0 5 4 2 1 2 5 
-40 2 5 0 4 0 5 3 1 5 3 
-45 4 0 2 4 3 5 5 2 4 
-55 4 2 3 0 3 1 4 0 1 4 3 4 1 1 
-45 4 2 4 4 3 1 2 4 3 1 4 
-25 2 3 1 2 2 5 5 0 
-70 4 5 0 4 2 4 2 0 5 
-30 2 5 4 1 2 1 2 2 
-65 1 0 1 2 3 4 0 5 5 2 
-50 3 1 4 4 4 4 2 4 5 1 
-25 4 5 2 2 3 5 5 3 
-45 5 4 1 2 2 3 2 0 2 
-50 5 1 5 4 0 2 2 4 
-75 4 0 1 0 3 4 1 5 5 3 3 0 2 
-65 4 2 0 3 3 2 4 1 2 2 
-75 3 1 2 2 5 2 2 
-70 2 3 4 3 1 5 1 5 5 
-40 0 1 2 3 5 1 3 5 4 1 2 
-60 1 0 1 3 1 1 2 1 4 4 0 0 1 
10 4 5 4 3 4 5 1 2 0 0 5 2 
-75 5 3 5 0 0 5 3 3 5 0 2 
-40 0 2 4 0 2 5 0 5 4 1 
-80 0 3 1 1 3 5 1 5 0 0 1 5 
-55 0 5 5 5 1 0 0 3 3 2 1 
-55 5 5 5 5 2 5 
-45 4 0 1 2 3 1 5 1 2 4 
-40 2 5 5 3 4 0 4 0 2 1 
-85 1 3 3 4 0 5 4 3 2 1 2 
-75 2 0 4 2 1 1 5 5 
-55 4 3 0 5 4 0 4 2 2 3 3 1 
-55 1 1 0 5 3 4 3 3 3 2 4 4 0 
-65 5 2 2 3 3 3 0 4 3 0 3 3 1 2 
-65 1 3 2 3 4 1 3 2 4 1 5 
-60 0 2 0 1 0 5 4 4 0 5 2 
-55 2 0 1 4 3 0 5 4 1 1 0 3 2 
-50 5 1 5 4 5 5 0 2 
-70 3 3 1 5 4 5 2 4 5 
50 4 0 0 4 1 2 4 3 0 2 0 4 5 3 5 3 
-80 3 4 3 5 4 0 0 5 3 4 4 5 
-60 0 1 3 3 2 4 5 0 5 4 5 
-65 4 0 3 4 4 0 2 2 1 4 5 
-55 3 1 1 5 1 3 0 5 0 0 2 1 
-55 3 0 3 1 0 0 2 2 4 5 4 1 
-80 0 1 3 1 3 4 2 4 4 0 4 3 5 
-25 5 4 5 2 4 1 5 0 1 
-40 3 2 4 0 1 5 2 3 1 1 1 
-45 3 2 2 5 0 5 5 1 
-25 2 5 2 4 2 2 3 2 
-45 2 1 2 2 1 3 2 3 2 
-60 2 1 5 0 5 4 3 3 1 0 4 
-45 2 1 5 3 1 1 0 1 5 4 
-60 2 1 5 3 2 5 0 0 3 1 
-40 2 1 5 3 2 1 0 3 5 3 
5 2 1 5 3 2 1 3 5 5 2 
-70 2 1 5 3 2 1 3 1 2 
-85 2 1 5 3 2 1 3 0 0 5 
-40 2 1 5 3 2 1 3 0 2 2 
-10 1 5 3 3 5 2 3 4 1 4 5 4 
305 2 1 5 3 2 1 3 0 2 5 5 5 0 5 0 2 0 1 3 5 3 
300 2 1 5 3 2 1 3 0 2 5 5 5 0 5 0 2 0 1 1 4 4 
1000669 2 1 5 3 2 1 3 0 2 5 5 5 0 5 0 2 2 5 5 5 
1000654 2 1 5 3 2 1 3 0 2 5 5 5 0 5 0 2 0 1 2 3 5 1 
230 2 1 5 3 2 1 3 0 2 5 5 5 0 5 0 2 0 5 
300 2 1 5 3 2 1 3 0 2 5 5 5 0 5 0 2 0 1 1 4 4 
300 2 1 5 3 2 1 3 0 2 5 5 5 0 5 0 2 0 2 1 1 
280 2 1 5 3 2 1 3 0 2 5 5 5 0 5 0 2 0 1 1 3 2 
295 2 1 5 3 2 1 3 0 2 5 5 5 0 5 0 2 0 0 3 4 0 3 1 4 
305 2 1 5 3 2 1 3 0 2 5 5 5 0 5 0 2 0 1 4 3 4 3 
280 2 1 5 3 2 1 3 0 2 5 5 5 0 5 0 2 0 1 1 3 2 
310 2 1 5 3 2 1 3 0 2 5 5 5 0 5 0 2 0 1 1 0 3 4 1 
275 2 1 5 3 2 1 3 0 2 5 5 5 0 5 0 2 0 1 1 5 
285 2 1 5 3 2 1 3 0 2 5 5 5 0 5 0 2 0 1 4 0 0 1 
305 2 1 5 3 2 1 3 0 2 5 5 5 0 5 0 2 0 0 5 1 0 
305 2 1 5 3 2 1 3 0 2 5 5 5 0 5 0 2 5 4 3 3 4 
275 2 1 5 3 2 1 3 0 2 5 5 5 0 5 0 2 0 0 0 4 0 3 3 2 
320 2 1 5 3 2 1 3 0 2 5 5 5 0 5 0 2 5 5 0 
305 2 1 5 3 2 1 3 0 2 5 5 5 0 5 0 2 0 0 4 5 0 
300 2 1 5 3 2 1 3 0 2 5 5 5 0 5 0 2 0 1 2 4 
290 2 1 5 3 2 1 3 0 2 5 5 5 0 5 0 2 0 5 0 3 3 2 
280 2 1 5 3 2 1 3 0 2 5 5 5 0 5 0 2 0 4 1 3 2 
280 2 1 5 3 2 1 3 0 2 5 5 5 0 5 0 2 0 3 1 1 5 
280 2 1 5 3 2 1 3 0 2 5 5 5 0 5 0 2 0 1 1 3 2 
320 2 1 5 3 2 1 3 0 2 5 5 5 0 5 0 2 5 5 0 
300 2 1 5 3 2 1 3 0 2 5 5 5 0 5 0 2 0 2 4 5 
305 2 1 5 3 2 1 3 0 2 5 5 5 0 5 0 2 2 3 3 4 0 
285 2 1 5 3 2 1 3 0 2 5 5 5 0 5 0 2 0 1 3 0 1 1 
320 2 1 5 3 2 1 3 0 2 5 5 5 0 5 0 2 5 2 2 
320 2 1 5 3 2 1 3 0 2 5 5 5 0 5 0 2 1 1 1 1 3 
280 2 1 5 3 2 1 3 0 2 5 5 5 0 5 0 2 0 1 4 3 2 
275 2 1 5 3 2 1 3 0 2 5 5 5 0 5 0 2 0 1 1 5 
300 2 1 5 3 2 1 3 0 2 5 5 5 0 5 0 2 0 2 1 5 
285 2 1 5 3 2 1 3 0 2 5 5 5 0 5 0 2 0 1 1 0 0 4 
300 2 1 5 3 2 1 3 0 2 5 5 5 0 5 0 2 0 1 1 4 2 
300 2 1 5 3 2 1 3 0 2 5 5 5 0 5 0 2 0 4 2 4 
300 2 1 5 3 2 1 3 0 2 5 5 5 0 5 0 2 0 1 1 4 4 
285 2 1 5 3 2 1 3 0 2 5 5 5 0 5 0 2 0 1 1 3 3 4 
275 2 1 5 3 2 1 3 0 2 5 5 5 0 5 0 2 0 5 5 
245 2 1 5 3 2 1 3 0 2 5 5 5 0 5 0 2 1 
300 2 1 5 3 2 1 3 0 2 5 5 5 0 5 0 2 0 1 2 
305 2 1 5 3 2 1 3 0 2 5 5 5 0 5 0 2 0 1 4 1 3 2 
300 2 1 5 3 2 1 3 0 2 5 5 5 0 5 0 2 0 2 1 1 
280 2 1 5 3 2 1 3 0 2 5 5 5 0 5 0 2 0 1 1 3 
275 2 1 5 3 2 1 3 0 2 5 5 5 0 5 0 2 0 1 1 2 
275 2 1 5 3 2 1 3 0 2 5 5 5 0 5 0 2 0 1 1 2 
295 2 1 5 3 2 1 3 0 2 5 5 5 0 5 0 2 1 2 2 
275 2 1 5 3 2 1 3 0 2 5 5 5 0 5 0 2 0 1 1 2 
295 2 1 5 3 2 1 3 0 2 5 5 5 0 5 0 2 5 4 2 
260 2 1 5 3 2 1 3 0 2 5 5 5 0 5 0 2 0 1 3 0 5 
320 2 1 5 3 2 1 3 0 2 5 5 5 0 5 0 2 5 1 1 3 
300 2 1 5 3 2 1 3 0 2 5 5 5 0 5 0 2 0 2 1 5 
275 2 1 5 3 2 1 3 0 2 5 5 5 0 5 0 2 0 4 4 5 
300 2 1 5 3 2 1 3 0 2 5 5 5 0 5 0 2 5 1 0 1 
305 2 1 5 3 2 1 3 0 2 5 5 5 0 5 0 2 0 1 1 0 4 4 
300 2 1 5 3 2 1 3 0 2 5 5 5 0 5 0 2 0 1 1 4 1 
305 2 1 5 3 2 1 3 0 2 5 5 5 0 5 0 2 0 1 3 2 4 
300 2 1 5 3 2 1 3 0 2 5 5 5 0 5 0 2 0 2 4 2 
1000659 2 1 5 3 2 1 3 0 2 5 5 5 0 5 0 2 1 0 5 3 5 0 5 
275 2 1 5 3 2 1 3 0 2 5 5 5 0 5 0 2 0 1 1 2 
280 2 1 5 3 2 1 3 0 2 5 5 5 0 5 0 2 0 1 1 0 2 
1000639 2 1 5 3 2 1 3 0 2 5 5 5 0 5 0 2 0 1 1 0 0 3 5 2 
260 2 1 5 3 2 1 3 0 2 5 5 5 0 5 0 2 0 1 0 3 5 
285 2 1 5 3 2 1 3 0 2 5 5 5 0 5 0 2 0 0 4 3 1 1 
320 2 1 5 3 2 1 3 0 2 5 5 5 0 5 0 2 4 2 4 2 
300 2 1 5 3 2 1 3 0 2 5 5 5 0 5 0 2 2 3 1 1 
230 2 1 5 3 2 1 3 0 2 5 5 5 0 5 0 2 0 5 
305 2 1 5 3 2 1 3 0 2 5 5 5 0 5 0 2 0 1 1 1 3 0 
1000639 2 1 5 3 2 1 3 0 2 5 5 5 0 5 0 2 3 2 0 3 0 5 4 
295 2 1 5 3 2 1 3 0 2 5 5 5 0 5 0 2 4 2 5 
300 2 1 5 3 2 1 3 0 2 5 5 5 0 5 0 2 3 4 0 1 0 0 3 2 
285 2 1 5 3 2 1 3 0 2 5 5 5 0 5 0 2 0 0 4 4 0 5 
305 2 1 5 3 2 1 3 0 2 5 5 5 0 5 0 2 0 3 4 5 2 
305 2 1 5 3 2 1 3 0 2 5 5 5 0 5 0 2 0 1 1 0 1 3 
320 2 1 5 3 2 1 3 0 2 5 5 5 0 5 0 2 1 4 2 3 
320 2 1 5 3 2 1 3 0 2 5 5 5 0 5 0 2 1 2 4 3 
300 2 1 5 3 2 1 3 0 2 5 5 5 0 5 0 2 0 1 1 4 1 
275 2 1 5 3 2 1 3 0 2 5 5 5 0 5 0 2 0 1 1 5 
305 2 1 5 3 2 1 3 0 2 5 5 5 0 5 0 2 1 3 3 1 1 0 
275 2 1 5 3 2 1 3 0 2 5 5 5 0 5 0 2 0 2 5 
275 2 1 5 3 2 1 3 0 2 5 5 5 0 5 0 2 3 2 2 
275 2 1 5 3 2 1 3 0 2 5 5 5 0 5 0 2 0 1 1 5 
305 2 1 5 3 2 1 3 0 2 5 5 5 0 5 0 2 0 3 4 5 3 
275 2 1 5 3 2 1 3 0 2 5 5 5 0 5 0 2 0 2 2 
280 2 1 5 3 2 1 3 0 2 5 5 5 0 5 0 2 0 1 1 3 2 
300 2 1 5 3 2 1 3 0 2 5 5 5 0 5 0 2 5 1 0 4 
275 2 1 5 3 2 1 3 0 2 5 5 5 0 5 0 2 0 1 4 2 
305 2 1 5 3 2 1 3 0 2 5 5 5 0 5 0 2 0 1 4 1 3 2 
300 2 1 5 3 2 1 3 0 2 5 5 5 0 5 0 2 0 1 5 4 
1000654 2 1 5 3 2 1 3 0 2 5 5 5 0 5 0 2 3 2 4 3 5 1 
280 2 1 5 3 2 1 3 0 2 5 5 5 0 5 0 2 0 1 4 3 2 
300 2 1 5 3 2 1 3 0 2 5 5 5 0 5 0 2 0 1 5 4 
275 2 1 5 3 2 1 3 0 2 5 5 5 0 5 0 2 0 5 5 
305 2 1 5 3 2 1 3 0 2 5 5 5 0 5 0 2 0 1 1 1 0 1 
270 2 1 5 3 2 1 3 0 2 5 5 5 0 5 0 2 2 
300 2 1 5 3 2 1 3 0 2 5 5 5 0 5 0 2 0 4 2 5 
275 2 1 5 3 2 1 3 0 2 5 5 5 0 5 0 2 0 1 1 2 
305 2 1 5 3 2 1 3 0 2 5 5 5 0 5 0 2 0 1 5 0 3 
300 2 1 5 3 2 1 3 0 2 5 5 5 0 5 0 2 0 1 2 5 
260 2 1 5 3 2 1 3 0 2 5 5 5 0 5 0 2 0 1 3 0 2 
305 2 1 5 3 2 1 3 0 2 5 5 5 0 5 0 2 0 1 3 5 4 
280 2 1 5 3 2 1 3 0 2 5 5 5 0 5 0 2 0 1 1 3 5 
300 2 1 5 3 2 1 3 0 2 5 5 5 0 5 0 2 0 1 2 4 
275 2 1 5 3 2 1 3 0 2 5 5 5 0 5 0 2 0 1 1 2 
305 2 1 5 3 2 1 3 0 2 5 5 5 0 5 0 2 2 3 1 3 2 
280 2 1 5 3 2 1 3 0 2 5 5 5 0 5 0 2 0 1 4 0 5 
275 2 1 5 3 2 1 3 0 2 5 5 5 0 5 0 2 0 2 
280 2 1 5 3 2 1 3 0 2 5 5 5 0 5 0 2 0 1 1 0 2 
285 2 1 5 3 2 1 3 0 2 5 5 5 0 5 0 2 0 3 0 2 4 
1000669 2 1 5 3 2 1 3 0 2 5 5 5 0 5 0 2 5 4 4 5 5 
275 2 1 5 3 2 1 3 0 2 5 5 5 0 5 0 2 0 1 1 5 
310 2 1 5 3 2 1 3 0 2 5 5 5 0 5 0 2 0 0 4 0 5 3 
300 2 1 5 3 2 1 3 0 2 5 5 5 0 5 0 2 0 2 4 4 
300 2 1 5 3 2 1 3 0 2 5 5 5 0 5 0 2 0 4 2 5 
280 2 1 5 3 2 1 3 0 2 5 5 5 0 5 0 2 0 1 0 1 2 
300 2 1 5 3 2 1 3 0 2 5 5 5 0 5 0 2 4 0 5 1 
305 2 1 5 3 2 1 3 0 2 5 5 5 0 5 0 2 0 1 1 3 4 3 
305 2 1 5 3 2 1 3 0 2 5 5 5 0 5 0 2 0 1 1 0 1 2 
300 2 1 5 3 2 1 3 0 2 5 5 5 0 5 0 2 0 1 1 1 4 
280 2 1 5 3 2 1 3 0 2 5 5 5 0 5 0 2 0 1 4 3 5 
300 2 1 5 3 2 1 3 0 2 5 5 5 0 5 0 2 0 1 1 1 
285 2 1 5 3 2 1 3 0 2 5 5 5 0 5 0 2 0 1 3 3 1 1 
300 2 1 5 3 2 1 3 0 2 5 5 5 0 5 0 2 0 1 3 3 4 0 3 4 
300 2 1 5 3 2 1 3 0 2 5 5 5 0 5 0 2 0 1 4 4 4 
275 2 1 5 3 2 1 3 0 2 5 5 5 0 5 0 2 0 1 1 2 
275 2 1 5 3 2 1 3 0 2 5 5 5 0 5 0 2 0 1 1 2 
275 2 1 5 3 2 1 3 0 2 5 5 5 0 5 0 2 0 1 4 2 
300 2 1 5 3 2 1 3 0 2 5 5 5 0 5 0 2 0 1 2 1 
