999999 6 3 6 1 5 5 6 4 3 5 6 6 4 3 4 5 3 3 2 
999994 6 3 6 1 5 5 6 4 3 5 6 5 6 6 5 
999994 6 3 6 1 5 5 6 4 5 6 6 1 4 4 6 
999994 6 3 6 1 5 5 6 4 3 5 6 6 4 3 4 5 3 1 
999994 6 3 6 1 5 5 6 4 3 5 6 6 4 3 4 5 4 
999994 6 3 6 1 5 5 6 4 3 5 6 6 4 3 4 5 3 5 
999994 6 3 6 1 5 5 6 4 3 5 6 6 4 3 4 5 1 
999994 6 3 6 1 5 5 6 4 3 5 6 6 4 3 4 5 2 
999994 6 3 6 1 5 5 6 4 3 5 6 6 4 3 4 5 4 
999994 6 3 6 1 5 5 6 4 3 5 6 6 4 3 4 5 5 
999994 6 3 6 1 5 5 6 4 3 5 6 6 4 3 6 3 4 
999994 6 3 6 1 5 5 6 4 3 5 6 6 4 3 3 6 5 
999994 6 3 6 1 5 5 6 4 3 5 6 6 4 3 4 5 2 
999994 6 3 6 1 5 5 6 4 3 5 6 6 5 6 2 
999994 6 3 6 1 5 5 6 4 3 5 6 6 4 3 4 5 1 
999994 6 3 6 1 5 5 6 4 3 5 6 6 3 1 1 6 
999994 6 3 6 1 5 5 6 4 3 5 6 6 4 1 3 5 4 
999994 6 3 6 1 5 5 6 4 3 5 6 6 4 3 6 4 
999994 6 3 6 1 5 5 6 4 5 6 5 4 4 3 1 3 5 5 
999994 6 3 6 1 5 5 6 4 3 5 6 6 4 3 4 5 4 
999994 6 3 6 1 5 5 6 4 3 5 6 6 4 3 4 5 6 
999994 6 3 6 1 5 5 6 4 3 5 6 6 4 3 6 4 
999994 6 3 6 1 5 5 6 4 3 5 6 6 4 3 4 5 4 
999994 6 3 6 1 5 5 6 4 3 5 6 6 4 3 4 5 1 
999994 6 3 6 1 5 5 6 4 3 5 6 6 4 3 4 3 6 
999994 6 3 6 1 5 5 6 4 3 5 6 6 4 3 4 5 5 
999619 6 3 6 1 5 5 6 4 3 5 6 6 4 3 4 
999619 6 3 6 1 5 5 6 4 3 5 6 6 4 3 4 
999619 6 3 6 1 5 5 6 4 3 5 6 6 4 3 3 
999619 6 3 6 1 5 5 6 4 3 5 6 6 1 1 
999619 6 3 6 1 5 5 6 4 3 5 6 6 1 1 
295 6 3 6 1 5 5 6 4 3 5 6 2 1 3 2 1 
290 6 3 6 1 5 5 6 4 3 5 6 6 4 3 4 3 2 
290 6 3 6 1 5 5 6 4 3 5 6 6 4 3 4 3 4 
290 6 3 6 1 5 5 6 4 3 5 6 6 4 3 4 3 3 
285 6 3 6 1 5 5 6 4 3 5 6 6 4 3 4 1 
285 6 3 6 1 5 5 6 4 3 5 6 6 2 3 2 
285 6 3 6 1 5 5 6 4 3 5 6 6 4 3 1 4 
285 6 3 6 1 5 5 6 4 3 5 6 6 4 3 1 2 
285 6 3 6 1 5 5 6 4 3 5 6 6 4 3 4 2 
285 6 3 6 1 5 5 6 4 3 5 6 6 4 3 4 4 
285 6 3 6 1 5 5 6 4 3 5 6 6 4 3 4 4 
285 6 3 6 1 5 5 6 4 3 5 6 6 4 3 4 1 
285 6 3 6 1 5 5 6 4 3 5 6 6 4 3 4 1 
285 6 3 6 1 5 5 6 4 3 5 6 6 4 3 4 1 
280 6 3 6 1 5 5 6 4 3 5 6 6 4 4 1 
280 6 3 6 1 5 5 6 4 3 5 6 6 5 2 
280 6 3 6 1 5 5 6 4 3 5 6 6 2 4 
265 6 3 6 1 5 5 6 4 3 5 6 6 4 3 3 2 
265 6 3 6 1 5 5 6 4 3 5 6 2 2 5 
260 6 3 6 1 5 5 6 4 3 5 6 6 3 1 2 
260 6 3 6 1 5 5 6 4 3 5 6 6 4 3 5 
260 6 3 6 1 5 5 6 4 3 5 6 6 4 3 5 
260 6 3 6 1 5 5 6 4 3 5 6 6 4 3 2 
255 6 3 6 1 5 5 6 4 3 5 6 6 4 2 6 
255 6 3 6 1 5 5 6 4 3 5 6 6 4 2 1 
255 6 3 6 1 5 5 6 4 3 5 6 6 4 2 6 
230 6 3 6 1 5 5 6 4 3 5 6 6 6 
165 6 3 6 1 5 5 6 4 3 5 6 1 
165 6 3 6 1 5 5 6 4 3 5 6 4 
100 6 3 6 1 5 5 6 4 5 3 1 
100 6 3 6 1 5 5 6 4 3 5 1 
50 6 3 6 1 5 5 6 4 3 3 
45 6 3 6 1 5 5 6 4 6 
-90 6 3 6 1 5 5 6 4 3 5 6 6 4 3 
-95 6 3 6 1 5 5 6 4 3 5 6 6 
-95 6 3 6 1 5 5 6 4 3 5 6 6 
-145 6 3 6 1 5 5 6 4 3 5 6 
-325 6 3 6 1 5 5 6 4 
-325 6 3 6 1 5 5 6 4 
