130 6 6 5 3 3 1 5 1 4 5 6 1 
15 6 6 5 3 3 1 5 1 4 3 6 
15 6 6 5 3 3 1 5 1 4 3 1 
15 6 6 5 3 3 1 5 1 4 3 6 
15 6 6 5 3 3 1 5 1 4 3 2 
15 6 6 5 3 3 1 5 1 4 3 3 
10 6 6 5 3 3 1 5 1 4 6 
10 6 6 5 3 3 1 5 1 4 1 
10 6 6 5 3 3 1 5 1 4 6 
10 6 6 5 3 3 1 5 1 4 1 
10 6 6 5 3 3 1 5 1 4 6 
10 6 6 5 3 3 1 5 1 4 1 
0 6 6 5 3 3 1 6 4 2 
-15 6 6 5 3 3 1 5 1 5 
-15 6 6 5 3 3 1 5 1 6 
-15 6 6 5 3 3 1 5 1 6 
-15 6 6 5 3 3 1 5 1 2 
-25 6 6 5 3 3 1 6 6 
-25 6 6 5 3 3 1 6 6 
-25 6 6 5 3 3 1 6 3 
-30 6 6 5 3 3 1 5 3 3 6 
-35 6 6 5 3 3 1 5 3 4 
-85 6 6 5 3 3 3 1 1 
-85 6 6 5 3 3 1 3 4 
-90 6 6 5 3 3 4 2 
-120 6 6 5 3 6 
-365 6 6 5 3 3 1 5 1 
-390 6 6 5 3 3 1 5 
-415 6 6 5 3 3 1 
-490 6 6 5 3 
