210 1 5 5 3 0 1 3 2 2 
210 3 0 3 1 4 1 5 4 5 5 
210 0 2 4 2 0 5 0 1 5 
235 1 3 2 5 2 4 4 3 0 4 
215 1 1 0 3 0 3 0 4 2 3 0 5 0 2 
245 4 2 2 4 5 1 4 3 0 
235 1 1 3 3 2 5 1 0 2 4 
235 2 0 1 2 2 3 0 5 5 
