-45 2 0 1 5 0 5 1 5 3 
-70 2 0 1 5 0 4 2 4 5 
-120 5 4 0 0 0 2 4 0 0 0 3 2 
-80 2 0 1 5 0 3 5 0 3 1 4 
-65 2 0 1 5 0 3 5 2 5 
-65 2 0 1 5 0 3 5 2 4 
-45 2 0 1 5 1 4 1 1 0 1 3 
-65 2 0 1 5 3 4 5 1 3 1 
-65 2 0 1 5 0 3 5 2 4 
-260 2 0 1 5 0 3 5 2 0 3 
95 2 0 1 5 0 3 5 2 0 5 5 5 1 
-265 2 0 1 5 0 3 5 2 5 
-10 2 0 1 5 0 3 5 2 0 5 1 
-60 2 0 1 5 0 3 5 2 0 4 
-65 2 0 1 5 0 3 5 2 2 
-65 2 0 1 5 0 3 5 2 4 
