30 5 5 3 2 4 5 2 5 0 5 
20 5 2 1 4 4 2 5 5 2 
-70 4 4 3 5 1 3 1 0 3 4 4 3 0 3 4 
-40 2 3 3 2 4 5 0 1 4 4 1 
-45 5 1 4 4 3 4 4 1 3 5 3 
-60 4 5 5 3 0 4 1 2 3 3 1 
-70 2 5 3 1 0 0 0 3 1 5 0 0 1 
-65 5 1 1 1 5 3 0 2 0 5 
60 5 2 1 1 1 3 4 0 4 4 5 5 3 1 
-45 1 5 0 2 1 5 5 0 4 
-65 0 4 3 1 4 5 3 4 5 4 5 
-45 2 5 1 2 4 2 3 0 1 
-65 4 2 0 0 1 5 3 1 2 5 
-50 4 4 5 1 4 4 3 5 4 2 
-45 4 2 4 5 3 2 4 0 1 4 
-85 5 4 3 0 1 3 0 3 0 4 3 2 0 3 4 
-40 2 3 5 5 0 4 0 4 2 3 
-65 2 0 0 1 3 0 3 1 1 3 3 4 3 4 1 4 
-40 1 1 4 0 2 4 3 3 1 5 4 3 
-45 4 5 0 5 2 1 0 2 2 
-45 1 4 2 1 5 5 3 1 0 2 
-85 0 2 4 3 4 2 5 0 3 2 
-75 1 3 1 2 2 4 4 1 5 
-70 4 0 2 2 0 5 1 1 5 
-45 5 1 1 2 3 5 3 2 2 
-70 0 2 1 2 1 4 1 0 1 5 
-50 2 0 2 5 2 1 4 1 
-45 4 0 3 1 2 5 2 5 5 
-55 2 2 4 2 2 4 2 
-5 0 5 4 0 3 1 5 2 3 0 4 5 1 
-60 0 4 5 0 0 5 5 3 5 2 
-40 3 5 2 3 1 5 5 3 1 4 
-55 1 4 2 5 5 2 2 
-80 0 1 5 3 0 4 3 4 2 3 4 2 
-50 2 3 5 4 4 4 5 4 4 
-75 5 0 0 4 5 2 0 3 4 0 0 5 
-55 1 0 1 3 2 3 3 5 4 0 2 3 
-40 3 1 5 2 2 3 5 0 1 2 
-50 5 4 4 4 5 3 5 1 2 
-55 4 0 2 0 3 4 0 2 2 0 4 0 
-80 4 4 0 2 3 3 3 5 5 3 5 
-70 3 1 3 1 3 4 0 0 0 1 1 3 1 5 1 
-85 4 3 4 4 4 0 1 0 0 4 4 4 5 
-55 5 4 4 2 5 2 2 
-100 5 3 3 2 5 0 3 4 3 3 5 
-30 2 5 2 2 1 1 1 2 
-55 1 3 4 4 2 3 1 3 4 3 5 0 3 
-70 3 3 0 1 5 3 4 0 2 0 5 0 2 
-55 2 1 4 4 4 1 4 1 1 0 2 
-45 5 0 3 1 5 4 2 2 1 
30 1 5 4 2 5 3 5 0 5 4 0 
15 4 3 3 4 4 2 3 4 5 4 1 5 0 0 
-55 0 5 0 1 0 2 0 3 4 4 2 2 
-40 2 3 3 4 3 5 2 1 4 1 4 
-70 5 2 2 0 0 2 4 2 
-55 2 2 1 3 3 0 4 0 2 4 3 1 
25 1 3 1 1 2 4 4 4 5 1 5 2 
-50 5 1 1 2 3 5 5 5 
-100 0 2 2 1 1 3 3 0 0 4 3 2 
-65 0 1 2 2 1 0 1 0 5 2 
-55 5 4 0 0 2 0 4 0 1 0 1 1 4 
-65 1 3 4 3 5 2 5 4 0 2 
-75 2 1 4 5 4 0 5 2 
-50 3 4 4 5 4 4 4 4 4 4 1 
-55 1 0 3 2 3 1 5 0 2 4 0 4 
-60 1 4 4 1 5 3 4 5 0 3 0 2 
-60 3 1 4 2 0 3 5 1 5 0 4 
-40 5 4 3 3 3 2 4 2 5 4 
-45 1 4 4 5 4 2 0 5 3 4 
-30 4 5 4 1 5 2 5 4 
-40 5 1 3 5 3 3 5 1 1 4 0 
-80 1 3 3 2 2 0 2 0 4 0 2 
-55 2 1 5 3 0 3 5 4 3 0 4 2 
-55 4 0 4 0 1 1 0 2 0 4 2 3 1 
-75 0 0 3 2 0 4 2 3 4 3 2 2 
-75 4 3 3 0 0 2 1 3 0 2 1 1 4 
-40 4 1 3 0 2 4 2 1 2 0 3 
-30 1 1 1 2 4 4 1 5 1 1 
40 0 1 4 0 2 5 5 0 1 1 5 3 4 2 
30 2 5 3 0 2 1 2 1 5 1 5 
-50 2 4 0 2 1 2 4 4 5 
-40 2 3 5 4 0 4 2 5 0 2 
-50 4 1 0 2 2 5 2 1 
-25 0 1 4 4 2 5 4 5 1 3 
-55 3 3 5 2 3 4 4 0 0 5 1 3 
-40 4 0 4 5 5 1 1 2 0 3 2 
-65 4 5 0 4 2 3 1 3 5 5 
-60 0 1 4 4 0 3 1 4 1 5 4 3 1 
-60 1 3 3 2 0 1 5 3 5 4 5 
-75 1 1 3 3 4 0 2 3 2 4 3 3 5 
-60 0 0 3 2 5 1 1 0 4 1 1 4 
-55 4 1 5 1 2 1 1 4 5 
-60 0 1 2 1 1 1 5 3 4 3 3 1 
-55 2 2 0 1 4 0 0 0 4 2 3 2 
-65 0 0 1 2 4 5 0 2 4 5 
55 2 0 2 2 5 5 0 5 4 4 1 
-40 0 5 1 1 1 3 2 3 1 2 0 
-45 3 2 2 4 0 4 4 5 1 2 
-45 2 0 5 4 0 1 4 4 5 1 
-65 0 3 3 3 3 0 2 0 2 2 5 3 2 
-75 0 1 4 1 0 5 0 4 0 0 3 2 1 
-45 5 2 4 5 3 4 4 3 1 4 
-40 5 1 0 5 2 0 3 4 2 0 
-100 3 1 1 4 3 1 2 3 3 0 1 3 5 
-55 5 3 3 0 0 2 4 4 4 3 2 1 
30 5 4 5 4 2 3 1 3 1 5 1 5 
-65 2 1 4 0 1 2 2 0 3 2 
-40 3 2 1 0 4 3 4 4 5 4 1 4 
-30 2 2 5 1 5 5 4 
-70 2 2 3 4 0 1 1 2 5 
-40 2 3 3 1 2 4 5 1 4 3 3 
-45 2 1 4 1 1 5 3 5 3 1 
-40 2 1 5 3 2 3 3 1 5 1 
-45 2 1 5 3 2 5 3 4 4 
-50 2 1 5 3 2 1 2 4 
-70 2 1 5 3 2 1 3 1 2 
-5 2 1 5 3 2 1 3 0 4 3 3 5 2 
-40 2 1 5 3 2 1 3 0 2 2 
-40 2 1 5 3 2 1 3 0 4 4 3 
65 2 1 5 3 2 1 3 0 2 5 5 0 4 
110 2 1 5 3 2 1 3 0 2 5 5 5 2 
10 2 1 5 3 2 1 3 0 2 5 2 
175 2 1 5 3 2 1 3 0 2 5 5 5 0 5 0 0 0 
245 2 1 5 3 2 1 3 0 2 5 5 5 0 5 0 2 1 
275 2 1 5 3 2 1 3 0 2 5 5 5 0 5 0 2 0 1 1 2 
220 2 1 5 3 2 1 3 0 2 5 5 5 0 5 2 
295 2 1 5 3 2 1 3 0 2 5 5 5 0 5 0 2 1 5 2 
300 2 1 5 3 2 1 3 0 2 5 5 5 0 5 0 2 0 4 2 5 
320 2 1 5 3 2 1 3 0 2 5 5 5 0 5 0 2 2 5 2 
350 2 1 5 3 2 1 3 0 2 5 5 5 0 5 0 2 2 5 5 1 
320 2 1 5 3 2 1 3 0 2 5 5 5 0 5 0 2 2 4 1 3 
300 2 1 5 3 2 1 3 0 2 5 5 5 0 5 0 2 0 4 4 4 5 
320 2 1 5 3 2 1 3 0 2 5 5 5 0 5 0 2 2 2 3 
65 2 1 5 3 2 1 3 0 2 5 5 5 0 5 0 2 2 5 5 5 
320 2 1 5 3 2 1 3 0 2 5 5 5 0 5 0 2 2 2 2 
285 2 1 5 3 2 1 3 0 2 5 5 5 0 5 0 2 2 0 0 3 5 
305 2 1 5 3 2 1 3 0 2 5 5 5 0 5 0 2 0 4 5 3 4 
280 2 1 5 3 2 1 3 0 2 5 5 5 0 5 0 2 2 0 0 5 
300 2 1 5 3 2 1 3 0 2 5 5 5 0 5 0 2 2 1 3 5 
330 2 1 5 3 2 1 3 0 2 5 5 5 0 5 0 2 2 5 5 3 
350 2 1 5 3 2 1 3 0 2 5 5 5 0 5 0 2 2 5 5 1 
375 2 1 5 3 2 1 3 0 2 5 5 5 0 5 0 2 2 5 5 3 
320 2 1 5 3 2 1 3 0 2 5 5 5 0 5 0 2 2 1 1 1 
280 2 1 5 3 2 1 3 0 2 5 5 5 0 5 0 2 4 0 3 4 2 
320 2 1 5 3 2 1 3 0 2 5 5 5 0 5 0 2 2 5 1 
320 2 1 5 3 2 1 3 0 2 5 5 5 0 5 0 2 2 5 3 
320 2 1 5 3 2 1 3 0 2 5 5 5 0 5 0 2 2 5 0 
320 2 1 5 3 2 1 3 0 2 5 5 5 0 5 0 2 2 5 0 
320 2 1 5 3 2 1 3 0 2 5 5 5 0 5 0 2 2 5 0 
320 2 1 5 3 2 1 3 0 2 5 5 5 0 5 0 2 2 5 1 
350 2 1 5 3 2 1 3 0 2 5 5 5 0 5 0 2 2 5 5 4 
350 2 1 5 3 2 1 3 0 2 5 5 5 0 5 0 2 2 5 5 1 
300 2 1 5 3 2 1 3 0 2 5 5 5 0 5 0 2 2 4 0 5 
295 2 1 5 3 2 1 3 0 2 5 5 5 0 5 0 2 5 1 2 
320 2 1 5 3 2 1 3 0 2 5 5 5 0 5 0 2 2 5 0 
275 2 1 5 3 2 1 3 0 2 5 5 5 0 5 0 2 2 3 2 
320 2 1 5 3 2 1 3 0 2 5 5 5 0 5 0 2 2 5 2 
350 2 1 5 3 2 1 3 0 2 5 5 5 0 5 0 2 2 5 5 1 
295 2 1 5 3 2 1 3 0 2 5 5 5 0 5 0 2 4 5 5 
1000669 2 1 5 3 2 1 3 0 2 5 5 5 0 5 0 2 2 2 5 1 
305 2 1 5 3 2 1 3 0 2 5 5 5 0 5 0 2 2 0 4 3 0 
375 2 1 5 3 2 1 3 0 2 5 5 5 0 5 0 2 2 5 5 5 
295 2 1 5 3 2 1 3 0 2 5 5 5 0 5 0 2 2 4 2 
320 2 1 5 3 2 1 3 0 2 5 5 5 0 5 0 2 2 5 4 
260 2 1 5 3 2 1 3 0 2 5 5 5 0 5 0 2 4 3 0 3 5 
320 2 1 5 3 2 1 3 0 2 5 5 5 0 5 0 2 2 5 1 
320 2 1 5 3 2 1 3 0 2 5 5 5 0 5 0 2 2 5 0 
320 2 1 5 3 2 1 3 0 2 5 5 5 0 5 0 2 2 5 0 
1000669 2 1 5 3 2 1 3 0 2 5 5 5 0 5 0 2 2 2 5 4 
280 2 1 5 3 2 1 3 0 2 5 5 5 0 5 0 2 0 1 1 0 2 
330 2 1 5 3 2 1 3 0 2 5 5 5 0 5 0 2 2 5 5 0 
1000669 2 1 5 3 2 1 3 0 2 5 5 5 0 5 0 2 2 5 5 4 
320 2 1 5 3 2 1 3 0 2 5 5 5 0 5 0 2 2 5 0 
330 2 1 5 3 2 1 3 0 2 5 5 5 0 5 0 2 2 5 5 3 
375 2 1 5 3 2 1 3 0 2 5 5 5 0 5 0 2 2 5 5 5 
305 2 1 5 3 2 1 3 0 2 5 5 5 0 5 0 2 2 0 0 4 1 
305 2 1 5 3 2 1 3 0 2 5 5 5 0 5 0 2 2 1 0 3 4 
320 2 1 5 3 2 1 3 0 2 5 5 5 0 5 0 2 2 5 4 
320 2 1 5 3 2 1 3 0 2 5 5 5 0 5 0 2 2 5 3 
320 2 1 5 3 2 1 3 0 2 5 5 5 0 5 0 2 2 5 4 
1000654 2 1 5 3 2 1 3 0 2 5 5 5 0 5 0 2 3 5 3 4 5 5 
285 2 1 5 3 2 1 3 0 2 5 5 5 0 5 0 2 3 1 1 3 0 2 
320 2 1 5 3 2 1 3 0 2 5 5 5 0 5 0 2 2 5 1 
290 2 1 5 3 2 1 3 0 2 5 5 5 0 5 0 2 0 2 3 0 0 1 
320 2 1 5 3 2 1 3 0 2 5 5 5 0 5 0 2 2 5 3 
320 2 1 5 3 2 1 3 0 2 5 5 5 0 5 0 2 2 4 1 4 
320 2 1 5 3 2 1 3 0 2 5 5 5 0 5 0 2 2 5 1 
320 2 1 5 3 2 1 3 0 2 5 5 5 0 5 0 2 2 5 3 
265 2 1 5 3 2 1 3 0 2 5 5 5 0 5 0 2 1 3 0 0 0 5 
350 2 1 5 3 2 1 3 0 2 5 5 5 0 5 0 2 2 5 5 4 
295 2 1 5 3 2 1 3 0 2 5 5 5 0 5 0 2 1 5 2 
1000669 2 1 5 3 2 1 3 0 2 5 5 5 0 5 0 2 2 5 5 4 
300 2 1 5 3 2 1 3 0 2 5 5 5 0 5 0 2 4 4 1 0 2 
295 2 1 5 3 2 1 3 0 2 5 5 5 0 5 0 2 2 4 5 
320 2 1 5 3 2 1 3 0 2 5 5 5 0 5 0 2 2 1 1 3 
320 2 1 5 3 2 1 3 0 2 5 5 5 0 5 0 2 2 2 3 
295 2 1 5 3 2 1 3 0 2 5 5 5 0 5 0 2 2 1 2 
295 2 1 5 3 2 1 3 0 2 5 5 5 0 5 0 2 2 1 5 
1000669 2 1 5 3 2 1 3 0 2 5 5 5 0 5 0 2 2 5 5 4 
300 2 1 5 3 2 1 3 0 2 5 5 5 0 5 0 2 2 1 3 2 
1000669 2 1 5 3 2 1 3 0 2 5 5 5 0 5 0 2 2 5 5 1 
275 2 1 5 3 2 1 3 0 2 5 5 5 0 5 0 2 2 0 5 
350 2 1 5 3 2 1 3 0 2 5 5 5 0 5 0 2 2 5 5 4 
285 2 1 5 3 2 1 3 0 2 5 5 5 0 5 0 2 2 0 3 3 4 
320 2 1 5 3 2 1 3 0 2 5 5 5 0 5 0 2 2 2 3 
320 2 1 5 3 2 1 3 0 2 5 5 5 0 5 0 2 2 5 1 
305 2 1 5 3 2 1 3 0 2 5 5 5 0 5 0 2 0 0 4 5 0 
320 2 1 5 3 2 1 3 0 2 5 5 5 0 5 0 2 2 5 1 
320 2 1 5 3 2 1 3 0 2 5 5 5 0 5 0 2 2 4 4 1 
320 2 1 5 3 2 1 3 0 2 5 5 5 0 5 0 2 2 5 3 
320 2 1 5 3 2 1 3 0 2 5 5 5 0 5 0 2 2 1 1 0 
320 2 1 5 3 2 1 3 0 2 5 5 5 0 5 0 2 2 5 4 
1000649 2 1 5 3 2 1 3 0 2 5 5 5 0 5 0 2 0 0 0 0 5 0 5 5 
280 2 1 5 3 2 1 3 0 2 5 5 5 0 5 0 2 2 0 0 5 
320 2 1 5 3 2 1 3 0 2 5 5 5 0 5 0 2 2 5 0 
325 2 1 5 3 2 1 3 0 2 5 5 5 0 5 0 2 2 5 3 
320 2 1 5 3 2 1 3 0 2 5 5 5 0 5 0 2 2 2 
375 2 1 5 3 2 1 3 0 2 5 5 5 0 5 0 2 2 5 5 0 
350 2 1 5 3 2 1 3 0 2 5 5 5 0 5 0 2 2 5 5 1 
1000669 2 1 5 3 2 1 3 0 2 5 5 5 0 5 0 2 2 5 5 4 
305 2 1 5 3 2 1 3 0 2 5 5 5 0 5 0 2 2 3 1 0 4 
320 2 1 5 3 2 1 3 0 2 5 5 5 0 5 0 2 2 5 2 
320 2 1 5 3 2 1 3 0 2 5 5 5 0 5 0 2 1 2 1 1 
330 2 1 5 3 2 1 3 0 2 5 5 5 0 5 0 2 2 5 5 3 
320 2 1 5 3 2 1 3 0 2 5 5 5 0 5 0 2 2 5 4 
375 2 1 5 3 2 1 3 0 2 5 5 5 0 5 0 2 2 5 5 5 
320 2 1 5 3 2 1 3 0 2 5 5 5 0 5 0 2 1 1 1 1 1 
320 2 1 5 3 2 1 3 0 2 5 5 5 0 5 0 2 2 5 0 
1000669 2 1 5 3 2 1 3 0 2 5 5 5 0 5 0 2 2 5 5 1 
320 2 1 5 3 2 1 3 0 2 5 5 5 0 5 0 2 2 5 0 
370 2 1 5 3 2 1 3 0 2 5 5 5 0 5 0 2 2 5 5 
295 2 1 5 3 2 1 3 0 2 5 5 5 0 5 0 2 2 4 2 
320 2 1 5 3 2 1 3 0 2 5 5 5 0 5 0 2 2 5 1 
275 2 1 5 3 2 1 3 0 2 5 5 5 0 5 0 2 2 0 
320 2 1 5 3 2 1 3 0 2 5 5 5 0 5 0 2 2 5 0 
375 2 1 5 3 2 1 3 0 2 5 5 5 0 5 0 2 2 5 5 2 
320 2 1 5 3 2 1 3 0 2 5 5 5 0 5 0 2 2 5 1 
375 2 1 5 3 2 1 3 0 2 5 5 5 0 5 0 2 2 5 5 5 
320 2 1 5 3 2 1 3 0 2 5 5 5 0 5 0 2 2 1 1 0 
320 2 1 5 3 2 1 3 0 2 5 5 5 0 5 0 2 2 2 1 
330 2 1 5 3 2 1 3 0 2 5 5 5 0 5 0 2 2 5 5 0 
305 2 1 5 3 2 1 3 0 2 5 5 5 0 5 0 2 2 0 3 4 4 
1000669 2 1 5 3 2 1 3 0 2 5 5 5 0 5 0 2 2 5 5 1 
275 2 1 5 3 2 1 3 0 2 5 5 5 0 5 0 2 2 3 5 
1000669 2 1 5 3 2 1 3 0 2 5 5 5 0 5 0 2 2 5 5 4 
320 2 1 5 3 2 1 3 0 2 5 5 5 0 5 0 2 2 5 0 
300 2 1 5 3 2 1 3 0 2 5 5 5 0 5 0 2 2 4 0 5 
375 2 1 5 3 2 1 3 0 2 5 5 5 0 5 0 2 2 5 5 5 
330 2 1 5 3 2 1 3 0 2 5 5 5 0 5 0 2 2 5 5 3 
320 2 1 5 3 2 1 3 0 2 5 5 5 0 5 0 2 2 1 4 2 
320 2 1 5 3 2 1 3 0 2 5 5 5 0 5 0 2 2 5 0 
1000669 2 1 5 3 2 1 3 0 2 5 5 5 0 5 0 2 2 5 5 2 
320 2 1 5 3 2 1 3 0 2 5 5 5 0 5 0 2 2 5 4 
330 2 1 5 3 2 1 3 0 2 5 5 5 0 5 0 2 2 5 5 3 
350 2 1 5 3 2 1 3 0 2 5 5 5 0 5 0 2 2 5 5 4 
275 2 1 5 3 2 1 3 0 2 5 5 5 0 5 0 2 2 0 2 
