35 2 1 4 5 5 2 3 3 6 4 5 3 5 
40 2 1 4 5 5 2 3 3 6 4 5 3 3 2 
-45 2 1 4 5 5 2 3 3 6 1 
-20 2 1 4 5 5 2 3 3 6 4 6 
-20 2 1 4 5 5 2 3 3 6 4 4 
-20 2 1 4 5 5 2 3 3 6 4 4 
-20 2 1 4 5 5 2 3 3 6 4 6 
-45 2 1 4 5 5 2 3 3 6 1 
-10 2 1 4 5 5 2 3 3 6 4 3 3 1 
145 2 1 4 5 5 2 3 3 6 4 5 3 6 2 3 2 5 
-15 2 1 4 5 5 2 3 3 6 4 3 6 
-45 2 1 4 5 5 2 3 3 6 3 
35 2 1 4 5 5 2 3 3 6 4 5 3 5 
-45 2 1 4 5 5 2 3 3 6 3 
-45 2 1 4 5 5 2 3 3 6 6 
-15 2 1 4 5 5 2 3 3 6 4 3 6 
35 2 1 4 5 5 2 3 3 6 4 5 3 2 
40 2 1 4 5 5 2 3 3 6 4 5 3 3 5 
-45 2 1 4 5 5 2 3 3 6 2 
-20 2 1 4 5 5 2 3 3 6 4 1 
35 2 1 4 5 5 2 3 3 6 4 5 6 3 1 
-15 2 1 4 5 5 2 3 3 6 4 3 4 
-15 2 1 4 5 5 2 3 3 6 4 3 2 
-20 2 1 4 5 5 2 3 3 6 4 1 
30 2 1 4 5 5 2 3 3 6 4 5 1 
35 2 1 4 5 5 2 3 3 6 4 5 3 4 
-20 2 1 4 5 5 2 3 3 6 4 6 
40 2 1 4 5 5 2 3 3 6 4 5 3 3 2 
35 2 1 4 5 5 2 3 3 6 4 5 3 4 
35 2 1 4 5 5 2 3 3 6 4 5 3 5 
-20 2 1 4 5 5 2 3 3 6 4 2 
30 2 1 4 5 5 2 3 3 6 4 5 4 
-95 2 1 4 5 5 3 6 2 
-100 2 1 4 5 5 6 4 
-115 3 5 5 6 1 3 2 1 
-115 3 5 1 6 6 5 5 3 1 
-120 2 1 3 4 4 5 6 2 
-120 2 5 5 4 6 3 5 
-95 2 4 2 3 6 2 1 1 
-125 5 2 3 1 1 6 3 3 3 3 4 
-125 5 1 4 6 1 5 2 
-125 6 2 5 5 1 2 
-125 1 2 5 6 5 2 
-140 3 2 3 6 1 1 1 1 2 
-140 3 5 6 1 3 1 2 5 
-140 5 1 6 3 4 2 3 2 
-140 1 3 6 4 5 3 5 2 
-140 5 6 5 3 3 5 5 
-145 1 3 4 6 5 5 6 
-165 3 5 2 6 1 3 6 
-165 6 3 4 4 4 3 5 6 
-170 6 6 5 1 1 4 3 3 
-175 5 6 4 1 6 4 4 
-175 4 6 6 4 4 2 1 
-190 6 2 6 3 4 3 1 6 6 
-190 5 4 6 6 3 4 3 4 
-195 6 2 3 6 2 5 
-200 4 2 1 6 6 5 
-210 6 3 6 3 1 5 3 5 
-170 3 6 6 5 1 2 2 
-220 3 6 5 6 4 6 
-225 2 1 6 6 6 
-245 6 5 3 6 6 6 
-250 5 6 6 6 4 
