999999 5 6 6 2 6 5 5 6 5 1 1 4 6 3 
999999 5 6 6 2 6 5 5 6 5 1 1 4 6 4 
999999 5 6 6 2 6 5 5 6 5 1 1 4 6 2 
999999 5 6 6 2 6 5 5 6 5 1 1 4 6 1 
999999 5 6 6 2 6 5 5 6 5 1 1 4 6 1 
999999 5 6 6 2 6 5 5 6 5 1 1 3 6 2 
999999 5 6 6 2 6 5 5 6 5 1 1 4 6 1 
999999 5 6 6 2 6 5 5 6 5 1 1 4 6 5 
999999 5 6 6 2 6 5 5 6 5 1 1 3 4 6 
999999 5 6 6 2 6 5 5 6 5 1 1 4 6 2 
999999 5 6 6 2 6 5 5 6 5 1 1 4 6 3 
999999 5 6 6 2 6 5 5 6 5 1 1 4 6 5 
999999 5 6 6 2 6 5 5 6 5 1 1 4 6 6 
999999 5 6 6 2 6 5 5 6 5 1 1 4 6 6 
999999 5 6 6 2 6 5 5 6 5 1 1 4 6 3 
999999 5 6 6 2 6 5 5 6 5 1 1 4 6 4 
280 5 6 6 2 6 5 5 6 5 1 1 1 4 
280 5 6 6 2 6 5 5 6 5 1 1 4 5 
280 5 6 6 2 6 5 5 6 5 1 1 4 1 
280 5 6 6 2 6 5 5 6 5 1 1 4 4 
280 5 6 6 2 6 5 5 6 5 1 1 4 5 
280 5 6 6 2 6 5 5 6 5 1 1 1 5 
280 5 6 6 2 6 5 5 6 5 1 1 1 4 
280 5 6 6 2 6 5 5 6 5 1 1 4 5 
280 5 6 6 2 6 5 5 6 5 1 1 4 4 
280 5 6 6 2 6 5 5 6 5 1 1 4 5 
280 5 6 6 2 6 5 5 6 5 1 1 4 1 
270 5 6 6 2 6 5 5 6 2 6 1 
255 5 6 6 2 6 5 5 6 5 1 1 5 
255 5 6 6 2 6 5 5 6 5 1 1 6 
255 5 6 6 2 6 5 5 6 5 1 1 6 
255 5 6 6 2 6 5 5 6 5 1 1 2 
255 5 6 6 2 6 5 5 6 5 1 1 2 
255 5 6 6 2 6 5 5 6 5 1 1 6 
-10 6 1 5 2 4 1 2 5 3 4 5 3 6 2 6 6 
-10 6 1 5 2 4 1 2 5 3 4 5 3 6 2 6 3 
-10 6 1 5 2 4 1 2 5 3 4 5 3 6 2 6 6 
-10 6 1 5 2 4 1 2 5 3 4 5 3 6 2 4 2 
-10 6 1 5 2 4 1 2 5 3 4 5 3 6 2 2 1 
-10 6 1 5 2 4 1 2 5 3 4 5 3 6 2 6 3 
-10 6 1 5 2 4 1 2 5 3 4 5 3 6 5 3 2 3 3 
-10 6 1 5 2 4 1 2 5 3 4 5 3 6 2 4 2 
-10 6 1 5 2 4 1 2 5 3 4 5 3 6 2 1 3 
-10 6 1 5 2 4 1 2 5 3 4 5 3 6 2 1 2 
-10 6 1 5 2 4 1 2 5 3 4 5 3 6 2 
-10 6 1 5 2 4 1 2 5 3 4 5 3 6 2 
-10 6 1 5 2 4 1 2 5 3 4 5 3 6 2 
-10 6 1 5 2 4 1 2 5 3 4 5 3 6 2 
-10 6 1 5 2 4 1 2 5 3 4 5 3 6 2 
-10 6 1 5 2 4 1 2 5 3 4 5 3 6 4 
-10 6 1 5 2 4 1 2 5 3 4 5 3 6 2 1 1 
-10 6 1 5 2 4 1 2 5 3 4 5 3 6 6 
-10 6 1 5 2 4 1 2 5 3 4 5 3 6 6 
-10 6 1 5 2 4 1 2 5 3 4 5 3 6 3 
-10 6 1 5 2 4 1 2 5 3 4 5 3 6 4 
-10 6 1 5 2 4 1 2 5 3 4 5 3 6 1 
-10 6 1 5 2 4 1 2 5 3 4 5 3 6 3 
-10 6 1 5 2 4 1 2 5 3 4 5 3 6 5 
-10 6 1 5 2 4 1 2 5 3 4 5 3 6 2 6 3 
-10 6 1 5 2 4 1 2 5 3 4 5 3 6 2 
-10 6 1 5 2 4 1 2 5 3 4 5 3 6 2 6 
-15 6 1 5 2 4 1 2 5 3 4 5 4 
-15 6 1 5 2 4 1 2 5 3 4 5 3 6 
-15 6 1 5 2 4 1 2 5 3 4 5 4 
-15 6 1 5 2 4 1 2 5 3 4 5 3 
-15 6 1 5 2 4 1 2 5 3 4 5 3 2 
-15 6 1 5 2 4 1 2 5 3 4 5 3 3 
-95 5 6 6 2 6 5 5 6 5 1 1 
-95 5 6 6 2 6 5 5 6 5 1 1 
-120 5 6 6 2 6 5 5 6 5 1 
