255 6 6 5 3 3 1 5 1 4 5 6 5 4 5 4 
215 6 6 5 3 3 1 5 1 4 5 6 6 4 6 
210 6 6 5 3 3 1 5 1 4 5 6 2 3 4 6 
125 6 6 5 3 3 1 5 1 4 5 6 1 
125 6 6 5 3 3 1 5 1 4 5 6 4 
65 6 6 5 3 3 1 5 1 4 5 3 1 
65 6 6 5 3 3 1 5 1 4 3 5 1 
65 6 6 5 3 3 1 5 1 4 5 3 1 
65 6 6 5 3 3 1 5 1 4 3 5 2 
60 6 6 5 3 3 1 5 1 4 5 1 
60 6 6 5 3 3 1 5 1 4 5 5 
15 6 6 5 3 3 1 5 1 4 3 3 
15 6 6 5 3 3 1 5 1 4 3 6 
10 6 6 5 3 3 1 5 1 4 4 
10 6 6 5 3 3 1 5 1 4 1 
-15 6 6 5 3 3 1 5 4 3 
-15 6 6 5 3 3 1 5 1 3 
-15 6 6 5 3 3 1 5 1 6 
-15 6 6 5 3 3 1 5 1 3 
-15 6 6 5 3 3 1 5 1 6 
-40 6 6 5 3 3 1 5 2 
-250 6 6 5 3 3 1 5 1 4 5 
-250 6 6 5 3 3 1 5 1 4 5 
-250 6 6 5 3 3 1 5 1 4 5 
-250 6 6 5 3 3 1 5 1 4 5 
-360 6 6 5 3 3 1 5 1 4 
-365 6 6 5 3 3 1 5 1 
-365 6 6 5 3 3 1 5 1 
-390 6 6 5 3 3 1 5 
-400 6 6 5 3 3 1 
