155 2 4 3 5 3 2 4 5 5 5 5 6 6 2 1 
-45 2 4 3 5 3 2 4 5 5 5 5 6 6 2 5 
105 2 4 3 5 3 2 4 5 5 5 5 6 6 6 
110 2 4 3 5 3 2 4 5 5 5 5 3 4 
-95 2 4 3 5 3 2 4 5 5 5 5 6 6 6 
155 2 4 3 5 3 2 4 5 5 5 5 6 6 2 4 
1000454 2 4 3 5 3 2 4 5 5 5 5 6 6 2 6 5 
215 2 4 3 5 3 2 4 5 5 5 5 6 5 5 3 3 1 
110 2 4 3 5 3 2 4 5 5 5 5 6 3 3 
130 2 4 3 5 3 2 4 5 5 5 5 6 4 4 
105 2 4 3 5 3 2 4 5 5 5 5 6 1 
105 2 4 3 5 3 2 4 5 5 5 5 6 1 
130 2 4 3 5 3 2 4 5 5 5 5 6 6 4 2 
155 2 4 3 5 3 2 4 5 5 5 5 6 6 5 1 
155 2 4 3 5 3 2 4 5 5 5 5 6 6 2 5 
1000434 2 4 3 5 3 2 4 5 5 5 5 6 6 3 1 6 4 
155 2 4 3 5 3 2 4 5 5 5 5 6 6 5 2 
110 2 4 3 5 3 2 4 5 5 5 5 6 3 5 
1000519 2 4 3 5 3 2 4 5 5 5 5 6 6 2 3 5 3 4 
155 2 4 3 5 3 2 4 5 5 5 5 6 6 2 5 
155 2 4 3 5 3 2 4 5 5 5 5 6 6 5 1 
230 2 4 3 5 3 2 4 5 5 5 5 6 5 5 4 1 
130 2 4 3 5 3 2 4 5 5 5 5 4 6 
205 2 4 3 5 3 2 4 5 5 5 5 6 5 2 6 
155 2 4 3 5 3 2 4 5 5 5 5 6 2 6 5 
240 2 4 3 5 3 2 4 5 5 5 5 6 5 3 4 2 3 
130 2 4 3 5 3 2 4 5 5 5 5 4 1 
155 2 4 3 5 3 2 4 5 5 5 5 6 6 2 4 
130 2 4 3 5 3 2 4 5 5 5 5 6 4 4 
155 2 4 3 5 3 2 4 5 5 5 5 5 1 
155 2 4 3 5 3 2 4 5 5 5 5 5 1 
105 2 4 3 5 3 2 4 5 5 5 5 6 1 
-125 6 2 2 1 4 1 5 
-125 4 6 2 2 5 6 
-125 6 2 4 5 2 5 
-125 6 5 5 6 1 5 6 6 
-125 4 2 2 2 6 2 
-135 3 5 2 6 3 4 4 3 5 
-140 4 4 4 1 3 3 6 2 6 
-140 2 5 6 2 3 3 6 
-140 6 3 5 6 3 2 5 6 4 
-140 5 3 5 6 2 3 6 
-140 3 2 1 3 6 1 1 4 6 
-140 1 1 3 4 4 3 6 6 5 6 3 
-140 3 6 2 2 5 3 2 
-145 4 1 2 1 6 1 3 6 
-145 3 6 2 5 5 2 
-145 2 5 3 6 5 2 
-155 3 6 3 4 3 5 3 4 4 5 
-160 3 5 3 6 5 3 4 6 
-170 1 3 6 2 5 6 
-175 2 6 4 4 6 4 2 
-175 6 5 5 6 1 6 6 
-175 1 4 5 6 1 6 2 
-175 4 4 6 1 1 4 6 4 
-190 6 6 3 2 1 4 3 2 
-190 1 5 3 3 6 1 6 4 
-190 4 4 6 5 6 3 3 3 
-200 5 6 6 6 5 1 
-210 6 3 2 3 4 6 3 5 
-215 4 6 2 6 3 3 5 
-220 1 3 6 6 4 1 5 
-240 4 3 1 3 6 6 6 
-250 6 1 6 6 4 3 
