999999 5 5 3 2 6 4 6 5 5 6 6 3 3 3 3 3 3 5 5 
999999 5 5 3 2 6 4 6 5 5 6 6 3 3 3 3 3 3 5 4 
999994 5 5 3 2 6 4 6 5 5 6 6 3 3 3 3 3 6 6 
999994 5 5 3 2 6 4 6 5 5 6 6 3 3 3 3 6 3 6 
999994 5 5 3 2 6 4 6 5 5 6 6 3 3 3 3 6 5 
999994 5 5 3 2 6 4 6 5 5 6 6 3 3 3 3 3 3 6 
999619 5 5 3 2 6 4 6 5 5 6 6 3 3 3 3 3 
280 5 5 3 2 6 4 6 5 5 6 6 3 3 3 3 4 3 
280 5 5 3 2 6 4 6 5 5 6 6 3 3 3 3 1 4 
265 5 5 3 2 6 4 6 5 5 6 6 3 3 3 3 3 3 4 
265 5 5 3 2 6 4 6 5 5 6 6 3 3 3 3 3 3 2 
265 5 5 3 2 6 4 6 5 5 6 6 3 3 3 3 3 3 3 
265 5 5 3 2 6 4 6 5 5 6 6 3 3 3 3 3 3 2 
265 5 5 3 2 6 4 6 5 5 6 6 3 3 3 3 3 3 4 
260 5 5 3 2 6 4 6 5 5 6 6 3 3 3 3 3 5 
260 5 5 3 2 6 4 6 5 5 6 6 3 3 3 3 3 5 
260 5 5 3 2 6 4 6 5 5 6 6 3 3 3 3 3 2 
260 5 5 3 2 6 4 6 5 5 6 6 3 3 3 3 3 1 
255 5 5 3 2 6 4 6 5 5 6 6 3 3 3 3 5 
-55 5 5 3 2 6 4 6 5 5 6 6 3 3 3 
-55 5 5 3 2 6 4 6 5 5 6 6 3 3 3 3 3 3 
-55 5 5 3 2 6 4 6 5 5 6 6 3 3 3 3 3 3 
-55 5 5 3 2 6 4 6 5 5 6 6 3 3 3 3 
-55 5 5 3 2 6 4 6 5 5 6 6 3 3 3 3 3 
-55 5 5 3 2 6 4 6 5 5 6 6 3 3 3 3 
-55 5 5 3 2 6 4 6 5 5 6 6 3 3 3 3 3 3 
-55 5 5 3 2 6 4 6 5 5 6 6 3 3 3 3 
-55 5 5 3 2 6 4 6 5 5 6 6 3 3 3 3 
-55 5 5 3 2 6 4 6 5 5 6 6 3 3 3 3 3 3 
-55 5 5 3 2 6 4 6 5 5 6 6 3 3 3 3 
-55 5 5 3 2 6 4 6 5 5 6 6 3 3 3 3 3 3 
-55 5 5 3 2 6 4 6 5 5 6 6 3 3 3 3 3 3 
-55 5 5 3 2 6 4 6 5 5 6 6 3 3 
-55 5 5 3 2 6 4 6 5 5 6 6 3 3 3 
-55 5 5 3 2 6 4 6 5 5 6 6 3 3 
-55 5 5 3 2 6 4 6 5 5 6 6 3 3 
-55 5 5 3 2 6 4 6 5 5 6 6 3 3 3 6 
-55 5 5 3 2 6 4 6 5 5 6 6 3 3 3 6 
-55 5 5 3 2 6 4 6 5 5 6 6 3 3 3 6 
-55 5 5 3 2 6 4 6 5 5 6 6 3 
-55 5 5 3 2 6 4 6 5 5 6 6 3 2 5 
-55 5 5 3 2 6 4 6 5 5 6 6 3 4 1 
-55 5 5 3 2 6 4 6 5 5 6 6 3 1 
-55 5 5 3 2 6 4 6 5 5 6 6 
-55 5 5 3 2 6 4 6 5 5 6 6 5 
-55 5 5 3 2 6 4 6 5 5 6 6 3 4 
-55 5 5 3 2 6 4 6 5 5 6 6 3 3 3 6 3 
-55 5 5 3 2 6 4 6 5 5 6 6 3 3 3 
-55 5 5 3 2 6 4 6 5 5 6 6 3 3 3 6 3 
-55 5 5 3 2 6 4 6 5 5 6 6 3 3 3 6 
-55 5 5 3 2 6 4 6 5 5 6 6 3 3 3 6 3 
-55 5 5 3 2 6 4 6 5 5 6 6 3 3 3 
-55 5 5 3 2 6 4 6 5 5 6 6 3 3 3 6 3 
-55 5 5 3 2 6 4 6 5 5 6 6 3 3 3 
-55 5 5 3 2 6 4 6 5 5 6 6 3 3 3 6 3 
-55 5 5 3 2 6 4 6 5 5 6 6 3 3 3 6 
-55 5 5 3 2 6 4 6 5 5 6 6 3 3 
-55 5 5 3 2 6 4 6 5 5 6 6 3 3 3 6 
-55 5 5 3 2 6 4 6 5 5 6 6 3 1 6 
-55 5 5 3 2 6 4 6 5 5 6 6 3 2 5 
-55 5 5 3 2 6 4 6 5 5 6 6 1 3 6 
-55 5 5 3 2 6 4 6 5 5 6 6 4 
-110 5 5 3 2 6 4 6 5 5 6 6 3 3 3 3 3 
-115 5 5 3 2 6 4 6 5 5 6 6 3 3 3 3 
