145 2 1 4 5 5 2 3 3 6 4 5 3 6 2 3 1 3 1 2 
160 2 1 4 5 5 2 3 3 6 4 5 3 6 2 4 4 4 1 
35 2 1 4 5 5 2 3 3 6 4 5 3 6 3 
35 2 1 4 5 5 2 3 3 6 4 5 3 6 1 
165 2 1 4 5 5 2 3 3 6 4 5 3 6 2 3 2 4 1 
140 2 1 4 5 5 2 3 3 6 4 5 3 6 2 4 1 3 5 
60 2 1 4 5 5 2 3 3 6 4 5 3 6 6 4 2 
170 2 1 4 5 5 2 3 3 6 4 5 3 6 2 3 2 4 3 1 
35 2 1 4 5 5 2 3 3 6 4 5 3 6 4 
35 2 1 4 5 5 2 3 3 6 4 5 3 6 4 
135 2 1 4 5 5 2 3 3 6 4 5 3 6 2 1 1 2 
150 2 1 4 5 5 2 3 3 6 4 5 3 6 2 3 3 2 3 4 
35 2 1 4 5 5 2 3 3 6 4 5 3 6 1 
1000444 2 1 4 5 5 2 3 3 6 4 5 3 6 2 3 2 3 6 5 
115 2 1 4 5 5 2 3 3 6 4 5 3 6 2 3 1 6 
140 2 1 4 5 5 2 3 3 6 4 5 3 6 2 3 5 5 
110 2 1 4 5 5 2 3 3 6 4 5 3 6 2 4 6 
170 2 1 4 5 5 2 3 3 6 4 5 3 6 2 3 3 4 5 1 
135 2 1 4 5 5 2 3 3 6 4 5 3 6 2 2 2 
140 2 1 4 5 5 2 3 3 6 4 5 3 6 2 3 5 5 
1000514 2 1 4 5 5 2 3 3 6 4 5 3 6 2 3 1 5 5 2 
165 2 1 4 5 5 2 3 3 6 4 5 3 6 2 3 2 4 1 
160 2 1 4 5 5 2 3 3 6 4 5 3 6 2 5 1 4 
165 2 1 4 5 5 2 3 3 6 4 5 3 6 2 3 2 1 1 
110 2 1 4 5 5 2 3 3 6 4 5 3 6 2 1 6 
165 2 1 4 5 5 2 3 3 6 4 5 3 6 2 3 5 1 2 
1000464 2 1 4 5 5 2 3 3 6 4 5 3 6 2 3 1 2 6 
1000529 2 1 4 5 5 2 3 3 6 4 5 3 6 2 4 1 1 3 5 3 3 3 
1000519 2 1 4 5 5 2 3 3 6 4 5 3 6 2 3 1 5 3 5 5 
165 2 1 4 5 5 2 3 3 6 4 5 3 6 2 3 1 2 2 
170 2 1 4 5 5 2 3 3 6 4 5 3 6 5 3 3 1 1 4 4 
1000469 2 1 4 5 5 2 3 3 6 4 5 3 6 2 3 2 1 3 6 
-95 2 4 2 3 6 2 1 1 
-95 2 1 4 5 5 3 6 2 
-100 2 1 4 5 5 6 4 
-115 3 5 5 6 1 3 2 1 
-115 3 5 1 6 6 5 5 3 1 
-120 2 1 3 4 4 5 6 2 
-120 2 5 5 4 6 3 5 
-125 5 2 3 1 1 6 3 3 3 3 4 
-125 5 1 4 6 1 5 2 
-125 6 2 5 5 1 2 
-125 1 2 5 6 5 2 
-140 3 2 3 6 1 1 1 1 2 
-140 3 5 6 1 3 1 2 5 
-140 5 1 6 3 4 2 3 2 
-140 1 3 6 4 5 3 5 2 
-140 5 6 5 3 3 5 5 
-145 1 3 4 6 5 5 6 
-165 3 5 2 6 1 3 6 
-165 6 3 4 4 4 3 5 6 
-175 6 6 5 1 1 4 3 3 
-170 3 6 6 5 1 2 2 
-175 5 6 4 1 6 4 4 
-175 4 6 6 4 4 2 1 
-190 6 2 6 3 4 3 1 6 6 
-190 5 4 6 6 3 4 3 4 
-195 6 2 3 6 2 5 
-200 4 2 1 6 6 5 
-210 6 3 6 3 1 5 3 5 
-220 3 6 5 6 4 6 
-225 2 1 6 6 6 
-245 6 5 3 6 6 6 
-250 5 6 6 6 4 
