999999 5 6 6 2 6 5 5 6 5 1 1 4 3 5 3 4 
999999 5 6 6 2 6 5 5 6 5 1 1 4 3 5 3 6 
999994 5 6 6 2 6 5 5 6 5 1 1 4 3 6 
999994 5 6 6 2 6 5 5 6 5 1 1 4 6 4 
999994 5 6 6 2 6 5 5 6 5 1 1 3 3 6 5 
999994 5 6 6 2 6 5 5 6 5 1 1 4 6 6 
999994 5 6 6 2 6 5 5 6 5 1 5 6 5 
999994 5 6 6 2 6 5 5 6 5 1 1 4 6 5 
999994 5 6 6 2 6 5 5 6 5 1 1 4 6 5 
999994 5 6 6 2 6 5 5 6 5 1 1 3 1 5 4 
999994 5 6 6 2 6 5 5 6 5 1 1 3 4 6 
999994 5 6 6 2 6 5 5 6 5 1 1 4 6 4 
999994 5 6 6 2 6 5 5 6 5 1 1 4 6 3 
999994 5 6 6 2 6 5 5 6 5 1 1 4 6 5 
999994 5 6 6 2 6 5 5 6 5 1 1 4 3 5 1 
999994 5 6 6 2 6 5 5 6 5 1 1 4 6 4 
999994 5 6 6 2 6 5 5 6 5 1 1 4 6 6 
999994 5 6 6 2 6 5 5 6 5 1 1 4 6 4 
999994 5 6 6 2 6 5 5 6 5 1 1 4 6 3 
999994 5 6 6 2 6 5 5 6 5 1 1 1 6 6 
999619 5 6 6 2 6 5 5 6 5 1 1 4 
285 5 6 6 2 6 5 5 6 5 1 1 4 3 2 
285 5 6 6 2 6 5 5 6 5 1 1 3 1 1 
285 5 6 6 2 6 5 5 6 5 1 1 3 1 1 
285 5 6 6 2 6 5 5 6 5 1 1 4 3 1 
280 5 6 6 2 6 5 5 6 5 1 1 4 4 
280 5 6 6 2 6 5 5 6 5 1 1 4 4 
280 5 6 6 2 6 5 5 6 5 1 1 4 4 
280 5 6 6 2 6 5 5 6 5 1 1 4 2 
280 5 6 6 2 6 5 5 6 5 1 1 1 4 
280 5 6 6 2 6 5 5 6 5 1 1 1 1 
280 5 6 6 2 6 5 5 6 5 1 1 4 2 
280 5 6 6 2 6 5 5 6 5 1 1 4 5 
280 5 6 6 2 6 5 5 6 5 5 4 1 
280 5 6 6 2 6 5 5 6 5 1 1 1 1 
280 5 6 6 2 6 5 5 6 5 1 1 4 4 
280 5 6 6 2 6 5 5 6 5 1 1 4 4 
280 5 6 6 2 6 5 5 6 5 1 1 4 2 
280 5 6 6 2 6 5 5 6 5 1 5 5 
280 5 6 6 2 6 5 5 6 5 1 1 1 4 
280 5 6 6 2 6 5 5 6 5 1 1 4 1 
280 5 6 6 2 6 5 5 6 5 1 2 4 
280 5 6 6 2 6 5 5 6 5 1 1 4 5 
280 5 6 6 2 6 5 5 6 5 1 1 4 4 
270 5 6 6 2 6 5 5 6 5 6 1 
270 5 6 6 2 6 5 5 6 5 3 3 5 3 2 
260 5 6 6 2 6 5 5 6 5 1 1 3 2 
255 5 6 6 2 6 5 5 6 5 1 1 5 
255 5 6 6 2 6 5 5 6 5 1 1 6 
255 5 6 6 2 6 5 5 6 5 1 1 2 
255 5 6 6 2 6 5 5 6 5 1 1 2 
255 5 6 6 2 6 5 5 6 5 1 1 6 
255 5 6 6 2 6 5 5 6 5 1 1 2 
255 5 6 6 2 6 5 5 6 5 1 1 5 
255 5 6 6 2 6 5 5 6 5 1 1 5 
255 5 6 6 2 6 5 5 6 5 1 1 5 
255 5 6 6 2 6 5 5 6 5 1 1 2 
255 5 6 6 2 6 5 5 6 5 1 1 6 
255 5 6 6 2 6 5 5 6 5 1 1 2 
255 5 6 6 2 6 5 5 6 5 1 1 6 
255 5 6 6 2 6 5 5 6 5 1 1 2 
240 5 6 6 2 6 5 5 6 5 1 3 3 5 
-15 6 1 5 2 4 1 2 5 3 4 5 3 2 5 
-95 5 6 6 2 6 5 5 6 5 1 1 
-105 5 6 6 2 6 5 5 6 2 
-115 5 6 6 2 6 5 5 6 5 1 1 
-120 5 6 6 2 6 5 5 6 5 1 
-145 5 6 6 2 6 5 5 6 5 
-145 5 6 6 2 6 5 5 6 5 
-385 5 6 6 2 6 5 5 6 5 1 1 4 5 
