-85 2 0 1 5 0 3 5 4 3 2 
-70 2 0 1 5 5 5 0 2 
-60 2 0 1 3 1 2 4 3 5 4 
-50 2 0 1 5 1 4 1 5 2 
-100 2 0 1 5 0 3 0 3 3 5 2 
-80 2 0 1 5 0 3 4 5 3 3 5 
-65 2 0 1 5 0 3 5 5 2 
-65 2 0 1 5 3 4 5 1 3 4 
90 2 0 1 5 0 3 5 2 0 5 5 5 4 
-10 2 0 1 5 0 3 5 2 0 5 4 
-10 2 0 1 5 0 3 5 2 0 5 1 
40 2 0 1 5 0 3 5 2 0 5 5 4 
-10 2 0 1 5 0 3 5 2 0 5 2 
20 2 0 1 5 0 3 5 2 0 5 3 4 1 
-10 2 0 1 5 0 3 5 2 0 5 4 
95 2 0 1 5 0 3 5 2 0 5 5 5 0 3 
