-45 4 1 2 0 4 1 2 3 1 1 4 
-80 0 4 5 0 0 5 2 0 0 1 5 
-60 0 5 0 2 0 2 1 0 4 4 4 
-65 2 3 4 3 2 0 5 4 1 5 
-65 4 2 3 3 5 1 3 1 2 5 
20 4 2 2 1 1 5 5 5 4 
-55 2 0 4 1 5 3 4 5 0 0 3 1 
-85 0 0 5 0 5 0 2 1 1 5 
-55 2 3 5 0 1 4 0 2 1 0 0 4 
-75 5 1 4 1 2 5 0 2 
-60 5 0 0 1 1 0 5 1 2 3 1 
-25 4 1 0 5 5 1 2 2 1 
-65 0 2 5 2 3 4 3 0 2 5 
-40 5 2 3 5 4 0 3 4 5 0 
-50 5 4 2 1 5 2 0 1 
-70 2 3 3 2 1 0 0 1 0 3 2 3 4 
-100 3 5 0 0 0 0 5 3 2 1 5 
45 0 1 1 1 3 3 3 5 3 4 4 2 5 1 4 4 
-55 2 3 4 2 4 5 0 3 3 4 3 1 
-50 4 4 3 5 3 3 5 3 5 3 1 3 0 
-55 3 0 5 3 0 2 1 0 2 2 4 
-45 0 5 1 2 5 4 4 0 1 1 
-60 3 1 4 0 5 2 0 3 5 4 1 
-80 0 3 2 2 3 5 3 0 5 2 
15 2 1 3 1 5 1 0 4 4 0 4 5 0 2 
-75 0 3 3 5 4 4 3 0 4 4 0 4 4 2 
50 4 2 0 1 0 5 0 2 3 4 3 5 5 0 4 
-60 1 0 5 4 3 2 4 1 0 1 0 4 
-85 0 1 1 1 0 1 2 1 3 0 1 5 
-80 0 3 3 3 3 0 3 1 0 4 2 0 3 4 5 4 
-55 5 2 4 4 2 5 5 
-60 0 1 1 2 1 0 1 3 2 0 4 1 
-50 5 3 1 1 1 2 4 5 2 
-55 0 2 0 5 2 3 1 3 2 3 2 
-25 4 1 5 1 5 3 2 5 2 
-55 1 1 4 5 5 4 2 2 
-45 0 5 5 5 5 3 5 2 
15 2 0 2 3 5 4 5 0 4 5 0 2 
-80 0 1 1 5 4 2 0 3 0 1 0 2 
-30 4 1 5 1 2 2 5 1 
-70 0 1 0 0 1 4 0 0 2 5 4 3 3 1 
-30 2 1 5 4 5 2 4 4 
75 4 1 5 2 4 5 0 5 5 5 3 
-55 4 5 4 1 2 2 4 2 
-45 4 4 1 5 4 3 4 3 1 5 1 
-70 4 3 2 3 5 2 1 1 5 
-70 2 1 4 1 3 0 0 3 3 4 3 4 3 4 3 
-40 2 2 0 2 4 1 3 1 0 4 1 
-60 4 2 3 5 1 4 0 3 3 4 1 1 
-85 4 1 3 4 0 4 3 2 5 0 5 
-75 4 4 2 3 4 4 5 4 2 
-85 2 5 3 3 3 4 1 3 5 5 
-55 3 5 2 0 0 3 0 2 4 2 1 
-80 3 0 2 3 5 1 0 3 2 1 5 
-70 2 5 0 4 1 1 3 5 5 
-55 0 3 2 3 4 4 1 3 5 2 0 2 
-65 4 3 3 5 4 3 0 0 3 5 1 0 0 1 3 
-55 0 1 4 5 5 0 0 5 0 3 1 1 
-30 2 2 2 2 5 4 1 
-25 2 0 1 4 4 1 4 1 1 4 1 3 
-55 2 2 0 2 3 0 0 2 0 1 0 
-70 4 3 5 3 5 4 4 2 5 
-70 4 4 5 0 4 4 0 4 2 2 
-40 5 4 4 0 5 4 1 0 3 5 4 
-45 2 4 3 2 5 1 3 5 1 
-85 4 0 1 3 0 0 2 4 1 2 5 
-70 0 3 3 3 2 4 0 5 0 4 0 5 2 
-40 2 5 2 5 3 0 3 5 4 
-80 3 5 4 4 3 3 3 4 2 3 1 2 
-30 1 5 1 5 5 1 2 0 
-45 5 0 4 3 5 2 5 4 2 
-25 2 4 0 5 5 1 4 4 1 4 
-65 1 3 2 2 2 3 5 3 2 
-55 0 5 3 5 3 4 5 3 2 0 4 
-40 3 1 3 2 4 4 1 2 5 3 4 
-40 2 5 4 3 4 1 3 4 3 5 2 
-100 0 2 3 0 3 3 4 5 0 2 2 
-40 5 3 4 2 3 1 5 2 3 0 
-40 5 0 2 2 3 1 4 5 0 2 
-65 2 4 2 3 2 1 1 3 0 2 
-75 3 3 4 1 2 3 0 2 3 3 2 5 
-65 4 5 4 4 4 4 3 2 3 3 2 
-85 2 4 0 4 4 3 1 3 0 2 2 
-45 5 3 4 5 1 0 4 1 4 1 4 
-70 2 0 3 0 1 0 4 4 3 0 4 0 2 4 
-55 5 0 1 3 3 2 1 3 1 3 2 3 
-65 4 1 1 0 2 1 3 1 5 3 2 
-75 0 1 5 3 3 3 4 0 4 1 2 3 2 
-60 2 3 5 4 0 4 3 3 4 5 4 
-70 1 1 3 2 2 0 1 2 5 
-40 5 2 4 0 4 5 5 3 3 4 
-45 3 2 5 3 2 2 2 4 
-45 4 4 2 5 3 1 3 1 4 4 0 
65 4 1 5 1 4 4 4 3 2 3 5 0 5 3 2 
-40 3 2 1 5 0 1 2 1 4 0 4 
-30 2 2 2 4 2 5 2 
-50 5 2 2 2 2 0 2 
60 3 1 2 5 1 3 2 2 3 5 5 0 
55 4 1 4 3 5 1 1 1 2 3 5 5 2 
-60 0 0 1 5 4 3 4 3 2 4 4 4 
-25 5 5 2 0 5 2 4 3 
-25 1 1 2 1 4 4 5 4 0 4 3 
-65 3 2 1 1 1 3 3 5 2 5 
-55 4 5 2 2 1 2 5 
-45 3 1 2 2 1 0 1 5 4 5 
10 3 1 4 5 3 5 3 2 2 5 1 
-30 2 5 2 1 5 2 2 
-60 2 3 3 4 3 1 1 5 5 0 2 
-60 2 0 2 0 3 5 3 4 2 1 
-25 4 5 2 2 5 2 0 2 
-75 2 3 5 1 5 5 2 
-60 2 1 3 4 4 3 5 3 3 4 1 4 
-30 2 1 5 1 2 1 4 1 2 
-65 2 1 5 3 4 4 2 0 0 5 
0 2 1 5 3 2 1 3 0 3 0 4 5 3 4 
-65 2 1 5 3 2 1 3 0 1 5 
10 2 1 5 3 2 1 3 0 2 5 4 
10 2 1 5 3 2 1 3 0 2 5 4 
60 2 1 5 3 2 1 3 0 2 5 5 1 
60 2 1 5 3 2 1 3 0 2 5 5 2 
115 2 1 5 3 2 1 3 0 2 5 5 5 0 4 
175 2 1 5 3 2 1 3 0 2 5 5 5 0 5 0 
115 2 1 5 3 2 1 3 0 2 5 5 5 0 3 
220 2 1 5 3 2 1 3 0 2 5 5 5 0 5 2 
220 2 1 5 3 2 1 3 0 2 5 5 5 0 5 5 
305 2 1 5 3 2 1 3 0 2 5 5 5 0 5 0 2 3 1 5 3 1 
320 2 1 5 3 2 1 3 0 2 5 5 5 0 5 0 2 2 4 1 2 
280 2 1 5 3 2 1 3 0 2 5 5 5 0 5 0 2 0 1 1 3 
1000669 2 1 5 3 2 1 3 0 2 5 5 5 0 5 0 2 2 2 5 4 
1000669 2 1 5 3 2 1 3 0 2 5 5 5 0 5 0 2 2 2 5 1 
1000669 2 1 5 3 2 1 3 0 2 5 5 5 0 5 0 2 2 2 5 1 
245 2 1 5 3 2 1 3 0 2 5 5 5 0 5 0 2 1 
285 2 1 5 3 2 1 3 0 2 5 5 5 0 5 0 2 2 3 0 3 2 
1000669 2 1 5 3 2 1 3 0 2 5 5 5 0 5 0 2 2 2 5 4 
1000669 2 1 5 3 2 1 3 0 2 5 5 5 0 5 0 2 2 2 5 1 
275 2 1 5 3 2 1 3 0 2 5 5 5 0 5 0 2 2 0 5 
1000669 2 1 5 3 2 1 3 0 2 5 5 5 0 5 0 2 2 2 5 1 
320 2 1 5 3 2 1 3 0 2 5 5 5 0 5 0 2 2 2 0 
320 2 1 5 3 2 1 3 0 2 5 5 5 0 5 0 2 2 4 4 2 
1000669 2 1 5 3 2 1 3 0 2 5 5 5 0 5 0 2 2 2 5 5 
320 2 1 5 3 2 1 3 0 2 5 5 5 0 5 0 2 2 4 1 1 
1000669 2 1 5 3 2 1 3 0 2 5 5 5 0 5 0 2 2 2 5 2 
320 2 1 5 3 2 1 3 0 2 5 5 5 0 5 0 2 2 5 3 
320 2 1 5 3 2 1 3 0 2 5 5 5 0 5 0 2 2 2 1 
305 2 1 5 3 2 1 3 0 2 5 5 5 0 5 0 2 2 4 3 0 1 
1000669 2 1 5 3 2 1 3 0 2 5 5 5 0 5 0 2 2 2 5 2 
1000669 2 1 5 3 2 1 3 0 2 5 5 5 0 5 0 2 2 2 5 5 
1000669 2 1 5 3 2 1 3 0 2 5 5 5 0 5 0 2 2 2 5 2 
320 2 1 5 3 2 1 3 0 2 5 5 5 0 5 0 2 2 2 4 
1000669 2 1 5 3 2 1 3 0 2 5 5 5 0 5 0 2 2 2 5 5 
320 2 1 5 3 2 1 3 0 2 5 5 5 0 5 0 2 2 2 3 
295 2 1 5 3 2 1 3 0 2 5 5 5 0 5 0 2 1 2 5 
320 2 1 5 3 2 1 3 0 2 5 5 5 0 5 0 2 2 2 2 
1000669 2 1 5 3 2 1 3 0 2 5 5 5 0 5 0 2 2 2 5 5 
270 2 1 5 3 2 1 3 0 2 5 5 5 0 5 0 2 5 
300 2 1 5 3 2 1 3 0 2 5 5 5 0 5 0 2 3 2 1 2 
320 2 1 5 3 2 1 3 0 2 5 5 5 0 5 0 2 2 2 4 
320 2 1 5 3 2 1 3 0 2 5 5 5 0 5 0 2 2 2 2 
320 2 1 5 3 2 1 3 0 2 5 5 5 0 5 0 2 2 2 1 
280 2 1 5 3 2 1 3 0 2 5 5 5 0 5 0 2 4 3 3 1 5 
-70 2 1 5 3 2 1 3 0 2 5 5 5 0 5 0 2 2 2 0 
320 2 1 5 3 2 1 3 0 2 5 5 5 0 5 0 2 2 2 4 
1000669 2 1 5 3 2 1 3 0 2 5 5 5 0 5 0 2 2 2 5 5 
1000669 2 1 5 3 2 1 3 0 2 5 5 5 0 5 0 2 2 2 5 1 
320 2 1 5 3 2 1 3 0 2 5 5 5 0 5 0 2 2 2 4 
1000639 2 1 5 3 2 1 3 0 2 5 5 5 0 5 0 2 0 2 0 3 3 5 2 
320 2 1 5 3 2 1 3 0 2 5 5 5 0 5 0 2 2 5 4 
1000674 2 1 5 3 2 1 3 0 2 5 5 5 0 5 0 2 2 2 5 0 0 
280 2 1 5 3 2 1 3 0 2 5 5 5 0 5 0 2 0 0 2 5 
300 2 1 5 3 2 1 3 0 2 5 5 5 0 5 0 2 2 4 0 1 
320 2 1 5 3 2 1 3 0 2 5 5 5 0 5 0 2 2 2 4 
320 2 1 5 3 2 1 3 0 2 5 5 5 0 5 0 2 2 2 0 
305 2 1 5 3 2 1 3 0 2 5 5 5 0 5 0 2 0 0 4 5 2 
275 2 1 5 3 2 1 3 0 2 5 5 5 0 5 0 2 4 1 3 2 
320 2 1 5 3 2 1 3 0 2 5 5 5 0 5 0 2 2 2 
285 2 1 5 3 2 1 3 0 2 5 5 5 0 5 0 2 5 3 3 3 2 
275 2 1 5 3 2 1 3 0 2 5 5 5 0 5 0 2 2 0 5 
1000669 2 1 5 3 2 1 3 0 2 5 5 5 0 5 0 2 2 2 5 1 
1000669 2 1 5 3 2 1 3 0 2 5 5 5 0 5 0 2 2 2 5 2 
300 2 1 5 3 2 1 3 0 2 5 5 5 0 5 0 2 3 4 2 4 
280 2 1 5 3 2 1 3 0 2 5 5 5 0 5 0 2 2 3 3 2 
300 2 1 5 3 2 1 3 0 2 5 5 5 0 5 0 2 2 0 1 4 
320 2 1 5 3 2 1 3 0 2 5 5 5 0 5 0 2 5 2 0 
280 2 1 5 3 2 1 3 0 2 5 5 5 0 5 0 2 2 3 0 2 
320 2 1 5 3 2 1 3 0 2 5 5 5 0 5 0 2 2 2 4 
1000674 2 1 5 3 2 1 3 0 2 5 5 5 0 5 0 2 2 2 5 0 4 
1000669 2 1 5 3 2 1 3 0 2 5 5 5 0 5 0 2 2 2 5 1 
300 2 1 5 3 2 1 3 0 2 5 5 5 0 5 0 2 2 1 0 4 
320 2 1 5 3 2 1 3 0 2 5 5 5 0 5 0 2 2 2 1 
305 2 1 5 3 2 1 3 0 2 5 5 5 0 5 0 2 2 0 3 4 0 
300 2 1 5 3 2 1 3 0 2 5 5 5 0 5 0 2 3 2 4 1 
320 2 1 5 3 2 1 3 0 2 5 5 5 0 5 0 2 2 2 0 
320 2 1 5 3 2 1 3 0 2 5 5 5 0 5 0 2 2 2 3 
1000674 2 1 5 3 2 1 3 0 2 5 5 5 0 5 0 2 2 2 5 3 0 
300 2 1 5 3 2 1 3 0 2 5 5 5 0 5 0 2 2 0 4 1 
275 2 1 5 3 2 1 3 0 2 5 5 5 0 5 0 2 5 3 5 
295 2 1 5 3 2 1 3 0 2 5 5 5 0 5 0 2 2 1 5 
1000669 2 1 5 3 2 1 3 0 2 5 5 5 0 5 0 2 2 2 5 2 
320 2 1 5 3 2 1 3 0 2 5 5 5 0 5 0 2 4 5 1 1 
1000669 2 1 5 3 2 1 3 0 2 5 5 5 0 5 0 2 2 2 5 2 
320 2 1 5 3 2 1 3 0 2 5 5 5 0 5 0 2 2 2 0 
320 2 1 5 3 2 1 3 0 2 5 5 5 0 5 0 2 2 2 0 
320 2 1 5 3 2 1 3 0 2 5 5 5 0 5 0 2 2 2 0 
295 2 1 5 3 2 1 3 0 2 5 5 5 0 5 0 2 2 1 5 
1000669 2 1 5 3 2 1 3 0 2 5 5 5 0 5 0 2 2 2 5 1 
320 2 1 5 3 2 1 3 0 2 5 5 5 0 5 0 2 2 2 3 
320 2 1 5 3 2 1 3 0 2 5 5 5 0 5 0 2 4 4 5 1 
1000669 2 1 5 3 2 1 3 0 2 5 5 5 0 5 0 2 2 2 5 2 
275 2 1 5 3 2 1 3 0 2 5 5 5 0 5 0 2 2 3 5 
320 2 1 5 3 2 1 3 0 2 5 5 5 0 5 0 2 4 2 1 0 
1000674 2 1 5 3 2 1 3 0 2 5 5 5 0 5 0 2 2 2 5 0 1 
1000669 2 1 5 3 2 1 3 0 2 5 5 5 0 5 0 2 2 2 5 5 
395 2 1 5 3 2 1 3 0 2 5 5 5 0 5 0 2 2 2 5 4 
1000669 2 1 5 3 2 1 3 0 2 5 5 5 0 5 0 2 2 2 5 2 
320 2 1 5 3 2 1 3 0 2 5 5 5 0 5 0 2 2 2 2 
285 2 1 5 3 2 1 3 0 2 5 5 5 0 5 0 2 3 0 4 4 0 1 
320 2 1 5 3 2 1 3 0 2 5 5 5 0 5 0 2 2 2 4 
300 2 1 5 3 2 1 3 0 2 5 5 5 0 5 0 2 2 0 4 2 
300 2 1 5 3 2 1 3 0 2 5 5 5 0 5 0 2 5 3 4 2 
275 2 1 5 3 2 1 3 0 2 5 5 5 0 5 0 2 2 3 5 
1000669 2 1 5 3 2 1 3 0 2 5 5 5 0 5 0 2 2 2 5 1 
305 2 1 5 3 2 1 3 0 2 5 5 5 0 5 0 2 2 0 3 4 0 
285 2 1 5 3 2 1 3 0 2 5 5 5 0 5 0 2 0 0 0 5 1 
305 2 1 5 3 2 1 3 0 2 5 5 5 0 5 0 2 4 1 0 0 1 3 
320 2 1 5 3 2 1 3 0 2 5 5 5 0 5 0 2 2 2 1 
225 2 1 5 3 2 1 3 0 2 5 5 5 0 5 0 2 0 
320 2 1 5 3 2 1 3 0 2 5 5 5 0 5 0 2 2 2 3 
320 2 1 5 3 2 1 3 0 2 5 5 5 0 5 0 2 2 2 1 
370 2 1 5 3 2 1 3 0 2 5 5 5 0 5 0 2 2 2 2 
300 2 1 5 3 2 1 3 0 2 5 5 5 0 5 0 2 2 2 4 
320 2 1 5 3 2 1 3 0 2 5 5 5 0 5 0 2 2 2 0 
1000659 2 1 5 3 2 1 3 0 2 5 5 5 0 5 0 2 3 0 4 1 4 5 4 
320 2 1 5 3 2 1 3 0 2 5 5 5 0 5 0 2 2 2 2 
300 2 1 5 3 2 1 3 0 2 5 5 5 0 5 0 2 2 3 1 1 
320 2 1 5 3 2 1 3 0 2 5 5 5 0 5 0 2 2 5 4 
1000669 2 1 5 3 2 1 3 0 2 5 5 5 0 5 0 2 2 2 5 4 
280 2 1 5 3 2 1 3 0 2 5 5 5 0 5 0 2 0 0 5 5 
1000669 2 1 5 3 2 1 3 0 2 5 5 5 0 5 0 2 2 2 5 4 
320 2 1 5 3 2 1 3 0 2 5 5 5 0 5 0 2 2 2 4 
1000674 2 1 5 3 2 1 3 0 2 5 5 5 0 5 0 2 2 2 5 3 5 
320 2 1 5 3 2 1 3 0 2 5 5 5 0 5 0 2 2 5 0 
275 2 1 5 3 2 1 3 0 2 5 5 5 0 5 0 2 2 3 2 
1000674 2 1 5 3 2 1 3 0 2 5 5 5 0 5 0 2 2 2 5 3 2 
320 2 1 5 3 2 1 3 0 2 5 5 5 0 5 0 2 2 5 3 
320 2 1 5 3 2 1 3 0 2 5 5 5 0 5 0 2 4 2 1 0 
320 2 1 5 3 2 1 3 0 2 5 5 5 0 5 0 2 2 2 3 
1000674 2 1 5 3 2 1 3 0 2 5 5 5 0 5 0 2 2 2 5 0 5 
1000669 2 1 5 3 2 1 3 0 2 5 5 5 0 5 0 2 2 2 5 4 
265 2 1 5 3 2 1 3 0 2 5 5 5 0 5 0 2 3 3 3 3 4 2 
1000669 2 1 5 3 2 1 3 0 2 5 5 5 0 5 0 2 2 2 5 4 
320 2 1 5 3 2 1 3 0 2 5 5 5 0 5 0 2 2 4 1 4 
305 2 1 5 3 2 1 3 0 2 5 5 5 0 5 0 2 0 2 0 1 1 
280 2 1 5 3 2 1 3 0 2 5 5 5 0 5 0 2 4 4 3 0 2 
1000664 2 1 5 3 2 1 3 0 2 5 5 5 0 5 0 2 4 2 3 3 5 3 5 
320 2 1 5 3 2 1 3 0 2 5 5 5 0 5 0 2 2 2 1 
1000674 2 1 5 3 2 1 3 0 2 5 5 5 0 5 0 2 2 2 5 0 3 
