999999 5 5 3 2 6 4 6 5 5 6 6 3 3 3 3 3 3 5 3 2 
999999 5 5 3 2 6 4 6 5 5 6 6 3 3 3 3 3 3 5 3 4 
999994 5 5 3 2 6 4 6 5 5 6 6 3 3 3 4 6 
999994 5 5 3 2 6 4 6 5 5 6 6 3 3 3 3 6 1 
999994 5 5 3 2 6 4 6 5 5 6 6 3 3 3 3 3 3 6 
999994 5 5 3 2 6 4 6 5 5 6 6 3 3 3 3 3 3 5 2 
999994 5 5 3 2 6 4 6 5 5 6 6 3 3 3 3 3 3 5 6 
999994 5 5 3 2 6 4 6 5 5 6 6 3 3 3 3 3 3 5 6 
999994 5 5 3 2 6 4 6 5 5 6 6 3 3 3 3 3 3 6 
999994 5 5 3 2 6 4 6 5 5 6 6 3 3 3 3 3 3 5 5 
999994 5 5 3 2 6 4 6 5 5 6 6 3 3 3 3 3 3 5 1 
999994 5 5 3 2 6 4 6 5 5 6 6 3 3 3 3 3 3 5 1 
999994 5 5 3 2 6 4 6 5 5 6 6 3 3 3 3 6 6 
999994 5 5 3 2 6 4 6 5 5 6 6 3 3 3 3 3 6 4 
999994 5 5 3 2 6 4 6 5 5 6 6 3 3 3 3 3 3 5 1 
999994 5 5 3 2 6 4 6 5 5 6 6 3 3 3 3 3 3 5 2 
999994 5 5 3 2 6 4 6 5 5 6 6 3 3 3 3 6 3 5 
999994 5 5 3 2 6 4 6 5 5 6 6 3 3 3 3 3 3 6 
999994 5 5 3 2 6 4 6 5 5 6 6 3 3 3 3 3 3 5 6 
999994 5 5 3 2 6 4 6 5 5 6 6 3 3 3 3 3 6 6 
999619 5 5 3 2 6 4 6 5 5 6 6 3 3 3 3 3 3 
999619 5 5 3 2 6 4 6 5 5 6 6 3 3 3 
999619 5 5 3 2 6 4 6 5 5 6 6 3 3 3 
290 5 5 3 2 6 4 6 5 5 6 6 2 3 4 
285 5 5 3 2 6 4 6 5 5 6 6 2 1 
285 5 5 3 2 6 4 6 5 5 6 6 1 4 5 
280 5 5 3 2 6 4 6 5 5 6 6 3 3 3 3 1 4 
280 5 5 3 2 6 4 6 5 5 6 6 3 3 3 3 4 2 
275 5 5 3 2 6 4 6 5 5 6 2 3 2 5 
275 5 5 3 2 6 4 6 5 5 6 6 3 3 3 4 4 
270 5 5 3 2 6 4 6 5 5 6 6 3 3 1 2 
265 5 5 3 2 6 4 6 5 5 6 6 3 3 3 3 3 3 1 
265 5 5 3 2 6 4 6 5 5 6 6 3 3 3 3 3 3 2 
265 5 5 3 2 6 4 6 5 5 6 6 3 3 3 3 3 3 1 
265 5 5 3 2 6 4 6 5 5 6 6 3 3 3 3 3 3 2 
265 5 5 3 2 6 4 6 5 5 6 6 3 3 3 3 3 3 1 
265 5 5 3 2 6 4 6 5 5 6 6 3 3 3 3 3 3 3 
265 5 5 3 2 6 4 6 5 5 6 6 3 3 3 3 3 3 4 
265 5 5 3 2 6 4 6 5 5 6 6 3 3 3 3 3 3 1 
265 5 5 3 2 6 4 6 5 5 6 6 3 4 5 
265 5 5 3 2 6 4 6 5 5 6 6 3 3 3 3 3 3 1 
260 5 5 3 2 6 4 6 5 5 6 6 4 5 
260 5 5 3 2 6 4 6 5 5 6 6 3 3 3 3 3 5 
260 5 5 3 2 6 4 6 5 5 6 6 3 3 3 3 3 4 
260 5 5 3 2 6 4 6 5 5 6 6 3 3 3 3 3 2 
260 5 5 3 2 6 4 6 5 5 6 6 3 3 3 3 3 4 
260 5 5 3 2 6 4 6 5 5 6 6 3 3 3 3 3 1 
260 5 5 3 2 6 4 6 5 5 6 6 3 3 3 3 3 5 
260 5 5 3 2 6 4 6 5 5 6 6 3 3 3 3 3 1 
260 5 5 3 2 6 4 6 5 5 6 6 3 3 3 3 3 1 
260 5 5 3 2 6 4 6 5 5 6 6 3 3 3 3 3 5 
255 5 5 3 2 6 4 6 5 5 6 6 3 3 3 3 5 
255 5 5 3 2 6 4 6 5 5 6 6 3 3 3 3 5 
255 5 5 3 2 6 4 6 5 5 6 6 3 3 3 3 5 
250 5 5 3 2 6 4 6 5 5 6 6 3 3 3 5 
245 5 5 3 2 6 4 6 5 5 6 6 3 3 6 
-110 5 5 3 2 6 4 6 5 5 6 6 3 3 3 3 3 
-115 5 5 3 2 6 4 6 5 5 6 6 3 3 3 3 
-115 5 5 3 2 6 4 6 5 5 6 6 3 3 3 3 
-120 5 5 3 2 6 4 6 5 5 6 6 3 3 3 
-120 5 5 3 2 6 4 6 5 5 6 6 3 3 3 
-120 5 5 3 2 6 4 6 5 5 6 6 3 3 3 
-120 5 5 3 2 6 4 6 5 5 6 6 3 3 3 
-125 5 5 3 2 6 4 6 5 5 6 6 3 3 
