-10 2 0 1 5 0 3 5 4 1 3 5 1 
-85 2 0 1 5 0 3 4 5 3 2 
-20 2 0 1 5 0 3 3 3 3 4 4 4 5 1 
-60 2 0 1 5 0 3 5 2 3 1 
-10 2 0 1 5 0 3 5 0 2 5 4 
-65 2 0 1 5 0 3 5 2 2 
-60 2 0 1 5 0 3 5 2 0 4 
-10 2 0 1 5 0 3 5 2 0 5 1 
-5 2 0 1 5 0 3 5 2 0 5 0 3 
40 2 0 1 5 0 3 5 2 0 5 5 0 
95 2 0 1 5 0 3 5 2 0 5 5 5 3 1 
145 2 0 1 5 0 3 5 2 0 5 5 5 0 5 4 
90 2 0 1 5 0 3 5 2 0 5 5 5 5 
90 2 0 1 5 0 3 5 2 0 5 5 5 5 
-10 2 0 1 5 0 3 5 2 0 5 2 
90 2 0 1 5 0 3 5 2 0 5 5 5 2 
