-40 3 5 4 0 2 0 4 2 5 4 
65 0 2 0 5 1 3 5 4 2 5 5 3 0 
-70 5 3 5 1 3 2 4 4 5 
-85 3 2 2 4 3 5 4 3 0 2 
-85 4 1 4 3 2 4 3 3 2 0 5 
-50 4 1 2 2 3 1 1 4 4 1 
-60 4 0 3 4 4 3 1 5 2 3 1 4 
-60 3 5 1 4 0 3 0 5 4 5 5 
-50 2 5 2 5 5 3 2 
-75 2 0 4 4 2 1 5 5 
-75 0 5 5 1 2 2 5 
-55 1 5 3 3 4 5 5 3 3 1 0 4 
60 1 0 5 2 2 4 4 4 0 5 3 5 2 
25 4 0 1 2 5 4 5 5 5 4 
-25 2 1 0 5 2 2 5 1 
-60 3 5 4 5 0 1 5 4 0 3 1 
-15 3 3 1 1 1 0 1 0 3 5 5 0 3 0 5 1 
-75 3 1 3 4 5 0 3 3 3 2 5 4 
-65 0 4 0 5 2 1 4 2 3 5 
-80 3 3 2 3 3 4 1 3 2 0 0 0 0 0 4 2 
-60 2 4 3 2 5 4 3 3 1 0 1 
-40 1 4 3 5 0 2 4 2 3 1 3 
30 4 4 5 4 1 4 5 4 1 3 5 3 2 
-55 1 5 4 4 2 4 5 2 
-80 3 2 1 3 0 0 4 2 3 4 4 2 
-45 3 2 2 5 2 1 4 0 2 
-40 4 1 0 2 2 5 3 0 5 0 
-55 3 3 0 4 3 5 5 4 5 1 3 0 
-30 1 5 1 4 5 2 5 1 
-70 5 1 5 4 1 3 0 2 2 
-85 0 4 5 1 1 2 3 4 3 3 5 
65 5 3 4 1 3 4 2 1 4 1 0 5 5 3 2 
-60 2 4 2 3 0 3 0 4 5 4 2 
-60 5 3 4 0 0 1 3 4 5 2 2 
-45 3 5 5 1 0 5 1 2 1 
-80 2 4 0 0 3 5 0 4 3 1 4 5 
-60 0 5 5 3 2 3 4 0 4 1 1 
-75 1 3 3 3 3 3 2 3 2 4 5 4 
20 4 5 1 5 2 4 5 5 2 
-40 0 3 1 4 5 0 2 2 4 4 4 
10 2 3 5 3 0 5 2 1 4 5 4 
-50 3 1 4 1 4 2 5 5 4 
-60 1 1 1 3 0 1 2 4 3 2 3 4 
-60 5 5 5 0 4 3 1 4 0 3 5 
-55 2 4 2 4 3 4 0 0 2 3 3 4 
-65 1 5 0 5 5 0 2 3 2 
-85 2 5 2 3 0 0 0 4 1 2 
-65 3 0 0 2 4 1 3 1 3 4 0 5 3 3 2 
-80 4 1 4 4 0 3 3 5 0 0 2 2 
-60 2 1 0 5 2 3 3 0 5 1 
-85 4 3 3 2 3 1 5 0 2 5 
-70 2 4 5 3 4 5 0 4 2 
-40 0 3 5 1 1 2 4 4 5 0 1 
30 2 1 5 1 2 5 3 0 5 1 5 
-40 1 0 4 1 4 3 3 5 2 2 2 
-25 1 2 2 2 3 4 4 1 1 4 
-70 0 3 3 1 3 0 3 5 4 4 1 2 0 4 
5 3 4 3 3 4 0 0 0 5 1 4 0 5 5 4 3 
-60 4 5 3 3 3 2 2 0 2 4 
-60 3 4 4 3 4 5 2 1 3 0 4 4 
-50 0 4 2 2 2 2 4 1 
-55 0 1 4 0 2 3 0 1 2 5 3 4 
-50 2 1 4 2 4 0 5 1 2 
-45 5 2 1 2 4 3 3 2 4 
-45 4 2 3 4 1 1 4 4 3 2 2 
-75 1 5 5 2 2 3 2 
-85 0 5 3 3 2 0 5 2 2 
-60 3 2 0 3 5 5 0 1 4 4 5 
-60 4 2 5 0 5 2 3 3 3 1 
-40 0 0 2 1 2 4 5 0 2 1 
-50 2 4 1 0 2 2 5 2 
-55 0 0 2 3 3 4 5 2 3 2 4 
-50 1 2 2 4 4 2 1 3 5 
-75 5 2 0 5 5 4 2 
-55 4 5 5 0 0 0 4 3 5 1 3 0 
30 4 1 3 2 4 2 5 4 3 5 4 3 
-55 2 1 2 2 4 4 1 2 
55 3 1 5 0 0 1 3 4 5 1 1 3 5 3 5 0 
-65 4 2 1 0 3 1 3 1 2 1 2 
-40 2 3 1 2 2 0 2 4 0 2 
-65 0 0 4 4 3 1 4 2 1 5 2 
-30 2 2 4 4 5 1 5 4 
-65 4 4 5 2 1 0 2 0 3 5 
40 1 0 3 5 4 1 4 2 2 5 3 3 4 2 
-70 2 1 1 3 1 4 5 0 1 5 
-80 4 0 1 4 5 0 0 0 1 4 1 0 2 
-60 0 0 5 0 5 1 1 2 3 4 1 
-60 5 3 1 3 3 0 5 2 2 4 
-60 4 4 4 4 2 0 3 0 3 5 1 4 
-55 2 2 3 2 3 3 3 1 1 1 3 3 
-45 5 4 0 3 1 4 1 1 2 4 2 
-50 3 4 5 1 1 5 5 4 2 
-40 5 3 1 0 2 2 0 5 4 3 
-60 3 5 1 5 5 4 0 0 1 0 2 
-85 0 0 2 2 5 3 0 5 5 
-55 1 3 0 1 1 0 4 0 0 2 4 5 2 
-65 1 5 3 0 1 0 5 2 4 5 
-70 5 5 5 0 2 0 1 2 
-100 4 1 2 1 0 4 0 0 3 4 0 0 5 
-50 4 1 1 3 2 5 2 4 1 
-85 4 5 3 4 0 0 3 5 5 5 
-65 3 0 4 2 0 1 1 5 2 5 
-70 1 3 4 3 3 0 0 4 2 1 0 0 1 4 5 
-85 0 0 2 3 1 5 3 4 5 2 
-65 0 4 5 0 4 4 1 1 1 1 0 5 
10 5 4 1 1 4 1 4 3 3 3 4 1 5 1 
-80 2 3 0 4 0 0 3 2 2 4 2 
-75 3 2 1 3 1 3 4 4 3 0 2 0 2 
-65 2 1 1 2 0 2 0 0 1 5 
-40 2 1 0 2 2 3 0 5 1 0 
-40 2 1 5 0 1 4 4 3 1 0 4 4 
-60 2 1 5 3 2 3 3 5 0 5 
-25 2 1 5 3 4 5 2 1 2 
-70 2 1 5 3 2 5 3 5 
-80 2 1 5 3 2 1 3 0 0 0 5 
45 2 1 5 3 2 1 3 3 3 3 1 5 5 2 
15 2 1 5 3 2 1 3 0 2 5 3 2 
40 2 1 5 3 2 1 3 0 2 5 0 4 1 
110 2 1 5 3 2 1 3 0 2 5 5 5 1 
60 2 1 5 3 2 1 3 0 2 5 5 4 
65 2 1 5 3 2 1 3 0 2 5 5 0 2 
110 2 1 5 3 2 1 3 0 2 5 5 5 1 
115 2 1 5 3 2 1 3 0 2 5 5 5 0 1 
195 2 1 5 3 2 1 3 0 2 5 5 5 0 5 4 
195 2 1 5 3 2 1 3 0 2 5 5 5 0 5 0 1 
1000659 2 1 5 3 2 1 3 0 2 5 5 5 0 5 0 2 5 3 3 4 5 3 0 
295 2 1 5 3 2 1 3 0 2 5 5 5 0 5 0 2 4 2 2 
270 2 1 5 3 2 1 3 0 2 5 5 5 0 5 0 2 3 3 3 3 4 0 5 
320 2 1 5 3 2 1 3 0 2 5 5 5 0 5 0 2 2 2 3 
320 2 1 5 3 2 1 3 0 2 5 5 5 0 5 0 2 2 2 2 
275 2 1 5 3 2 1 3 0 2 5 5 5 0 5 0 2 2 0 5 
320 2 1 5 3 2 1 3 0 2 5 5 5 0 5 0 2 2 2 0 
1000674 2 1 5 3 2 1 3 0 2 5 5 5 0 5 0 2 2 2 5 0 0 
1000674 2 1 5 3 2 1 3 0 2 5 5 5 0 5 0 2 2 2 5 0 1 
1000674 2 1 5 3 2 1 3 0 2 5 5 5 0 5 0 2 2 2 5 0 4 
-25 2 1 5 3 2 1 3 0 2 5 5 5 0 5 0 2 2 2 5 
1000674 2 1 5 3 2 1 3 0 2 5 5 5 0 5 0 2 2 2 5 0 3 
1000669 2 1 5 3 2 1 3 0 2 5 5 5 0 5 0 2 2 2 5 4 
1000669 2 1 5 3 2 1 3 0 2 5 5 5 0 5 0 2 2 2 5 5 
1000669 2 1 5 3 2 1 3 0 2 5 5 5 0 5 0 2 2 2 5 2 
320 2 1 5 3 2 1 3 0 2 5 5 5 0 5 0 2 2 2 2 
1000674 2 1 5 3 2 1 3 0 2 5 5 5 0 5 0 2 2 2 5 0 4 
295 2 1 5 3 2 1 3 0 2 5 5 5 0 5 0 2 2 1 2 
325 2 1 5 3 2 1 3 0 2 5 5 5 0 5 0 2 2 2 0 
1000669 2 1 5 3 2 1 3 0 2 5 5 5 0 5 0 2 2 2 5 4 
1000674 2 1 5 3 2 1 3 0 2 5 5 5 0 5 0 2 2 2 5 0 3 
1000674 2 1 5 3 2 1 3 0 2 5 5 5 0 5 0 2 2 2 5 0 2 
320 2 1 5 3 2 1 3 0 2 5 5 5 0 5 0 2 2 2 3 
320 2 1 5 3 2 1 3 0 2 5 5 5 0 5 0 2 2 2 1 
275 2 1 5 3 2 1 3 0 2 5 5 5 0 5 0 2 2 0 
320 2 1 5 3 2 1 3 0 2 5 5 5 0 5 0 2 2 2 4 
1000669 2 1 5 3 2 1 3 0 2 5 5 5 0 5 0 2 2 2 5 1 
1000674 2 1 5 3 2 1 3 0 2 5 5 5 0 5 0 2 2 2 5 0 2 
295 2 1 5 3 2 1 3 0 2 5 5 5 0 5 0 2 2 1 5 
1000674 2 1 5 3 2 1 3 0 2 5 5 5 0 5 0 2 2 2 5 0 4 
320 2 1 5 3 2 1 3 0 2 5 5 5 0 5 0 2 2 2 3 
1000674 2 1 5 3 2 1 3 0 2 5 5 5 0 5 0 2 2 2 5 0 3 
1000669 2 1 5 3 2 1 3 0 2 5 5 5 0 5 0 2 2 2 5 1 
1000669 2 1 5 3 2 1 3 0 2 5 5 5 0 5 0 2 2 2 5 5 
295 2 1 5 3 2 1 3 0 2 5 5 5 0 5 0 2 2 4 5 
295 2 1 5 3 2 1 3 0 2 5 5 5 0 5 0 2 2 4 2 
1000659 2 1 5 3 2 1 3 0 2 5 5 5 0 5 0 2 2 0 4 0 5 0 4 
1000674 2 1 5 3 2 1 3 0 2 5 5 5 0 5 0 2 2 2 5 0 4 
1000669 2 1 5 3 2 1 3 0 2 5 5 5 0 5 0 2 2 2 5 2 
1000674 2 1 5 3 2 1 3 0 2 5 5 5 0 5 0 2 2 2 5 0 5 
1000674 2 1 5 3 2 1 3 0 2 5 5 5 0 5 0 2 2 2 5 0 4 
1000669 2 1 5 3 2 1 3 0 2 5 5 5 0 5 0 2 2 2 5 1 
320 2 1 5 3 2 1 3 0 2 5 5 5 0 5 0 2 2 2 4 
1000674 2 1 5 3 2 1 3 0 2 5 5 5 0 5 0 2 2 2 5 0 1 
1000674 2 1 5 3 2 1 3 0 2 5 5 5 0 5 0 2 2 2 5 3 4 
300 2 1 5 3 2 1 3 0 2 5 5 5 0 5 0 2 2 1 3 1 
1000669 2 1 5 3 2 1 3 0 2 5 5 5 0 5 0 2 2 2 5 4 
1000674 2 1 5 3 2 1 3 0 2 5 5 5 0 5 0 2 2 2 5 3 5 
320 2 1 5 3 2 1 3 0 2 5 5 5 0 5 0 2 2 2 2 
1000674 2 1 5 3 2 1 3 0 2 5 5 5 0 5 0 2 2 2 5 0 4 
320 2 1 5 3 2 1 3 0 2 5 5 5 0 5 0 2 2 2 0 
305 2 1 5 3 2 1 3 0 2 5 5 5 0 5 0 2 2 4 0 3 3 
295 2 1 5 3 2 1 3 0 2 5 5 5 0 5 0 2 2 4 2 
300 2 1 5 3 2 1 3 0 2 5 5 5 0 5 0 2 2 4 3 5 
320 2 1 5 3 2 1 3 0 2 5 5 5 0 5 0 2 2 5 4 
320 2 1 5 3 2 1 3 0 2 5 5 5 0 5 0 2 2 2 0 
1000669 2 1 5 3 2 1 3 0 2 5 5 5 0 5 0 2 2 2 5 1 
320 2 1 5 3 2 1 3 0 2 5 5 5 0 5 0 2 2 2 1 
320 2 1 5 3 2 1 3 0 2 5 5 5 0 5 0 2 2 2 4 
320 2 1 5 3 2 1 3 0 2 5 5 5 0 5 0 2 2 2 1 
375 2 1 5 3 2 1 3 0 2 5 5 5 0 5 0 2 2 2 5 0 
1000674 2 1 5 3 2 1 3 0 2 5 5 5 0 5 0 2 2 2 5 0 5 
1000674 2 1 5 3 2 1 3 0 2 5 5 5 0 5 0 2 2 2 5 0 5 
1000669 2 1 5 3 2 1 3 0 2 5 5 5 0 5 0 2 2 2 5 5 
1000669 2 1 5 3 2 1 3 0 2 5 5 5 0 5 0 2 2 2 5 1 
1000674 2 1 5 3 2 1 3 0 2 5 5 5 0 5 0 2 2 2 5 3 1 
310 2 1 5 3 2 1 3 0 2 5 5 5 0 5 0 2 2 4 3 0 3 1 
1000674 2 1 5 3 2 1 3 0 2 5 5 5 0 5 0 2 2 2 5 3 1 
1000674 2 1 5 3 2 1 3 0 2 5 5 5 0 5 0 2 2 2 5 0 2 
1000674 2 1 5 3 2 1 3 0 2 5 5 5 0 5 0 2 2 2 5 0 5 
1000674 2 1 5 3 2 1 3 0 2 5 5 5 0 5 0 2 2 2 5 0 4 
1000669 2 1 5 3 2 1 3 0 2 5 5 5 0 5 0 2 2 2 5 5 
300 2 1 5 3 2 1 3 0 2 5 5 5 0 5 0 2 2 3 4 2 
1000674 2 1 5 3 2 1 3 0 2 5 5 5 0 5 0 2 2 2 5 0 3 
320 2 1 5 3 2 1 3 0 2 5 5 5 0 5 0 2 2 2 3 
320 2 1 5 3 2 1 3 0 2 5 5 5 0 5 0 2 2 2 2 
320 2 1 5 3 2 1 3 0 2 5 5 5 0 5 0 2 2 5 4 
320 2 1 5 3 2 1 3 0 2 5 5 5 0 5 0 2 2 2 0 
1000674 2 1 5 3 2 1 3 0 2 5 5 5 0 5 0 2 2 2 5 3 0 
320 2 1 5 3 2 1 3 0 2 5 5 5 0 5 0 2 2 2 3 
1000669 2 1 5 3 2 1 3 0 2 5 5 5 0 5 0 2 2 2 5 4 
320 2 1 5 3 2 1 3 0 2 5 5 5 0 5 0 2 2 2 3 
1000674 2 1 5 3 2 1 3 0 2 5 5 5 0 5 0 2 2 2 5 0 5 
320 2 1 5 3 2 1 3 0 2 5 5 5 0 5 0 2 2 5 0 
1000674 2 1 5 3 2 1 3 0 2 5 5 5 0 5 0 2 2 2 5 0 4 
1000674 2 1 5 3 2 1 3 0 2 5 5 5 0 5 0 2 2 2 5 0 3 
320 2 1 5 3 2 1 3 0 2 5 5 5 0 5 0 2 2 2 0 
275 2 1 5 3 2 1 3 0 2 5 5 5 0 5 0 2 2 0 2 
380 2 1 5 3 2 1 3 0 2 5 5 5 0 5 0 2 2 2 5 0 0 
1000669 2 1 5 3 2 1 3 0 2 5 5 5 0 5 0 2 2 2 5 4 
1000674 2 1 5 3 2 1 3 0 2 5 5 5 0 5 0 2 2 2 5 0 3 
1000674 2 1 5 3 2 1 3 0 2 5 5 5 0 5 0 2 2 2 5 3 2 
1000674 2 1 5 3 2 1 3 0 2 5 5 5 0 5 0 2 2 2 5 0 3 
320 2 1 5 3 2 1 3 0 2 5 5 5 0 5 0 2 2 2 4 
1000674 2 1 5 3 2 1 3 0 2 5 5 5 0 5 0 2 2 2 5 0 3 
320 2 1 5 3 2 1 3 0 2 5 5 5 0 5 0 2 2 2 0 
1000674 2 1 5 3 2 1 3 0 2 5 5 5 0 5 0 2 2 2 5 3 0 
300 2 1 5 3 2 1 3 0 2 5 5 5 0 5 0 2 2 1 0 1 
320 2 1 5 3 2 1 3 0 2 5 5 5 0 5 0 2 2 5 0 
1000674 2 1 5 3 2 1 3 0 2 5 5 5 0 5 0 2 2 2 5 0 2 
1000669 2 1 5 3 2 1 3 0 2 5 5 5 0 5 0 2 2 2 5 4 
320 2 1 5 3 2 1 3 0 2 5 5 5 0 5 0 2 2 2 0 
320 2 1 5 3 2 1 3 0 2 5 5 5 0 5 0 2 2 2 1 
275 2 1 5 3 2 1 3 0 2 5 5 5 0 5 0 2 2 3 
1000669 2 1 5 3 2 1 3 0 2 5 5 5 0 5 0 2 2 2 5 4 
1000669 2 1 5 3 2 1 3 0 2 5 5 5 0 5 0 2 2 2 5 2 
320 2 1 5 3 2 1 3 0 2 5 5 5 0 5 0 2 2 5 
1000674 2 1 5 3 2 1 3 0 2 5 5 5 0 5 0 2 2 2 5 0 5 
320 2 1 5 3 2 1 3 0 2 5 5 5 0 5 0 2 2 2 3 
320 2 1 5 3 2 1 3 0 2 5 5 5 0 5 0 2 2 2 4 
320 2 1 5 3 2 1 3 0 2 5 5 5 0 5 0 2 2 1 4 3 
320 2 1 5 3 2 1 3 0 2 5 5 5 0 5 0 2 2 2 0 
1000664 2 1 5 3 2 1 3 0 2 5 5 5 0 5 0 2 2 3 3 1 5 0 4 
1000674 2 1 5 3 2 1 3 0 2 5 5 5 0 5 0 2 2 2 5 0 4 
380 2 1 5 3 2 1 3 0 2 5 5 5 0 5 0 2 2 2 5 0 3 
1000669 2 1 5 3 2 1 3 0 2 5 5 5 0 5 0 2 2 2 5 1 
320 2 1 5 3 2 1 3 0 2 5 5 5 0 5 0 2 2 2 3 
1000674 2 1 5 3 2 1 3 0 2 5 5 5 0 5 0 2 2 2 5 3 4 
300 2 1 5 3 2 1 3 0 2 5 5 5 0 5 0 2 2 3 4 1 
320 2 1 5 3 2 1 3 0 2 5 5 5 0 5 0 2 2 2 1 
320 2 1 5 3 2 1 3 0 2 5 5 5 0 5 0 2 2 2 2 
320 2 1 5 3 2 1 3 0 2 5 5 5 0 5 0 2 2 5 0 
300 2 1 5 3 2 1 3 0 2 5 5 5 0 5 0 2 2 1 0 5 
1000669 2 1 5 3 2 1 3 0 2 5 5 5 0 5 0 2 2 2 5 2 
1000674 2 1 5 3 2 1 3 0 2 5 5 5 0 5 0 2 2 2 5 0 2 
320 2 1 5 3 2 1 3 0 2 5 5 5 0 5 0 2 2 2 3 
70 2 1 5 3 2 1 3 0 2 5 5 5 0 5 0 2 2 2 5 0 2 
1000674 2 1 5 3 2 1 3 0 2 5 5 5 0 5 0 2 2 2 5 3 5 
1000674 2 1 5 3 2 1 3 0 2 5 5 5 0 5 0 2 2 2 5 0 0 
1000669 2 1 5 3 2 1 3 0 2 5 5 5 0 5 0 2 2 2 5 4 
1000674 2 1 5 3 2 1 3 0 2 5 5 5 0 5 0 2 2 2 5 0 0 
