5 2 4 0 3 0 5 0 3 5 1 1 5 0 0 0 
-70 2 2 2 5 0 4 0 2 
-75 4 0 1 3 0 4 2 0 0 1 0 5 1 
-55 0 3 2 5 1 3 4 4 3 4 1 0 3 
-40 1 0 1 1 0 1 4 2 0 1 2 0 
-80 3 4 2 5 3 0 1 1 3 1 0 2 
-60 2 2 5 3 3 0 3 4 4 1 5 
-60 3 5 4 3 1 5 4 0 0 5 5 
15 3 2 5 5 1 4 2 3 3 5 3 2 
-25 5 5 1 5 2 5 3 1 
-85 3 4 0 0 1 0 1 1 5 2 5 
-60 1 1 4 1 2 3 3 0 0 5 1 1 
-40 3 3 1 4 1 1 2 2 0 4 1 0 
-60 5 2 0 3 4 0 2 0 5 4 
-15 0 0 0 2 3 3 0 5 3 4 3 1 4 4 5 2 
-80 3 5 3 3 1 1 0 1 1 5 3 2 
-65 2 1 0 0 1 3 0 0 3 2 1 3 0 1 2 
10 5 2 5 1 0 4 3 0 1 4 5 2 
-65 0 2 4 2 1 1 3 0 4 4 2 
-60 0 3 5 5 0 1 4 2 3 1 4 
-55 0 3 5 3 2 4 2 4 4 0 3 4 
15 4 0 5 0 3 4 2 2 2 5 3 5 
-55 2 2 3 3 3 5 0 0 4 2 0 
10 1 4 2 4 5 1 2 3 3 3 5 2 
-50 4 2 5 4 3 2 2 4 
-60 5 0 3 3 4 2 4 3 5 1 2 
10 5 2 0 0 4 5 3 5 4 5 4 
-75 0 1 5 5 0 2 3 0 0 1 0 5 
-70 5 2 3 2 0 2 1 2 
-55 3 4 4 0 3 1 0 2 2 4 0 1 3 
-60 3 1 5 3 2 5 1 3 3 1 1 
-80 0 2 0 0 0 0 2 2 5 2 
-75 4 0 5 2 3 3 0 1 3 3 5 1 
-40 0 1 4 2 0 0 2 2 2 0 
-45 3 2 4 1 5 2 2 0 4 
-50 2 2 4 3 5 5 4 1 
-65 1 3 2 4 0 1 5 1 4 3 5 
-70 2 2 3 4 1 4 3 4 1 5 
-25 2 5 5 0 5 4 2 4 
-60 3 5 3 3 2 1 5 0 5 1 
-55 4 4 3 2 3 5 3 3 1 4 4 0 1 
-75 0 4 3 2 5 3 2 1 3 3 3 4 
-85 3 0 5 4 3 5 5 1 0 2 
-25 2 5 1 2 3 5 5 3 
-55 3 5 1 4 4 1 3 4 3 0 2 0 0 
-105 1 2 3 3 2 0 3 3 0 0 3 3 1 3 5 
95 0 2 0 0 1 4 1 2 0 3 2 5 5 5 4 
-40 1 1 0 1 1 4 2 1 5 0 0 4 
-65 1 1 4 4 0 3 4 2 3 1 4 2 
-40 2 2 0 1 4 1 4 4 0 1 3 1 
-40 1 4 3 2 5 3 5 3 2 0 
-40 5 1 2 3 0 4 1 4 3 2 4 
-60 2 0 4 4 3 2 5 1 3 0 5 
-60 3 0 0 2 5 1 4 1 4 1 0 4 
-55 5 5 3 3 0 4 1 0 4 5 3 0 
-65 1 4 3 3 2 3 5 5 4 2 
-45 1 0 4 1 1 4 1 4 4 0 2 2 
-110 3 0 1 3 3 3 3 3 0 5 0 4 2 5 
-60 0 5 0 4 4 0 2 5 0 4 2 
-50 2 5 0 4 5 1 1 1 1 
-60 4 3 1 3 4 4 1 5 3 3 5 1 
-85 0 2 3 3 2 5 5 0 5 
-60 3 4 5 0 4 3 0 5 2 4 5 
-70 1 5 1 3 0 2 1 1 4 5 
-60 4 5 0 2 3 2 3 0 5 3 1 
-55 1 0 3 2 1 3 1 3 5 2 3 2 
-40 5 5 5 0 4 3 3 4 2 0 
-45 5 4 0 2 1 3 5 2 5 
-70 5 2 5 5 0 1 3 5 
-40 0 4 0 1 2 1 4 5 2 0 2 
-95 3 5 0 5 0 3 2 4 0 3 3 2 
-50 1 4 3 2 5 5 2 1 
-40 5 2 0 2 0 5 0 5 0 
-80 1 4 1 1 1 3 2 0 0 1 0 3 2 
10 2 2 0 1 2 5 3 0 4 5 2 
-30 1 1 4 5 1 4 5 2 1 
-60 3 0 3 3 1 5 2 2 5 2 
-45 4 5 4 1 3 0 2 4 2 1 
-30 2 2 4 5 1 1 4 4 0 
-55 3 5 3 1 3 1 3 0 1 1 2 4 2 
-25 4 4 2 1 0 4 5 4 2 3 
-80 4 0 3 2 0 2 4 2 3 3 5 
-30 2 5 5 4 5 4 4 2 
-60 2 0 5 1 3 3 1 3 1 2 2 
-45 3 1 4 2 1 1 3 5 1 1 4 
-60 4 0 1 0 5 4 2 5 0 3 2 
-60 3 5 2 3 1 1 0 3 3 1 0 1 3 0 3 
-80 1 2 0 4 0 2 0 0 0 5 5 
-25 1 5 0 2 5 5 4 1 2 
-45 5 2 2 4 3 0 1 4 4 1 
-70 0 4 4 1 1 2 1 1 3 1 2 
-45 4 4 2 3 0 5 2 5 2 
-85 0 3 0 2 5 4 4 0 4 1 5 
-40 5 1 1 0 5 1 3 0 5 1 4 
-25 4 1 2 2 5 2 3 1 1 
-40 5 1 2 1 3 1 0 2 4 0 3 
-40 2 2 0 0 2 2 4 4 0 0 
-50 5 3 0 5 3 2 3 3 5 4 3 4 
-85 3 1 4 3 0 1 1 1 1 3 2 2 
-55 5 5 0 5 3 0 0 1 3 4 4 4 
-70 5 1 5 5 1 4 0 0 5 
-30 2 4 1 2 2 4 4 4 1 
-60 5 1 3 3 2 4 5 3 0 4 1 
-85 5 3 4 0 0 2 0 5 4 2 
-70 5 2 0 1 5 4 4 0 2 
-40 4 4 1 0 3 5 5 5 1 3 1 
-60 5 1 0 0 3 5 3 2 1 1 5 
-30 4 1 1 2 2 1 1 5 1 
-45 0 2 5 1 1 2 4 1 3 1 
-55 0 1 0 3 3 1 2 2 5 1 3 4 
-40 2 1 5 3 1 1 3 2 1 0 4 
0 2 1 5 3 3 2 0 3 0 2 5 0 1 
-70 2 1 5 3 1 0 5 4 2 
-25 2 1 5 3 2 5 5 2 
-50 2 1 5 3 2 1 2 5 
60 2 1 5 3 2 1 3 2 0 5 5 4 
-55 2 1 5 3 2 1 3 0 1 3 0 1 
-40 2 1 5 3 2 1 3 0 2 1 
-40 2 1 5 3 2 1 3 0 2 2 
15 2 1 5 3 2 1 3 0 2 5 0 0 
60 2 1 5 3 2 1 3 0 2 5 5 2 
115 2 1 5 3 2 1 3 0 2 5 5 5 3 0 
115 2 1 5 3 2 1 3 0 2 5 5 5 0 2 
195 2 1 5 3 2 1 3 0 2 5 5 5 0 5 1 
195 2 1 5 3 2 1 3 0 2 5 5 5 0 5 4 
275 2 1 5 3 2 1 3 0 2 5 5 5 0 5 0 2 2 3 2 
305 2 1 5 3 2 1 3 0 2 5 5 5 0 5 0 2 3 5 3 1 0 
280 2 1 5 3 2 1 3 0 2 5 5 5 0 5 0 2 2 0 3 
320 2 1 5 3 2 1 3 0 2 5 5 5 0 5 0 2 2 5 0 
1000669 2 1 5 3 2 1 3 0 2 5 5 5 0 5 0 2 2 2 5 4 
320 2 1 5 3 2 1 3 0 2 5 5 5 0 5 0 2 2 2 1 
320 2 1 5 3 2 1 3 0 2 5 5 5 0 5 0 2 2 2 0 
320 2 1 5 3 2 1 3 0 2 5 5 5 0 5 0 2 2 2 2 
320 2 1 5 3 2 1 3 0 2 5 5 5 0 5 0 2 2 2 2 
70 2 1 5 3 2 1 3 0 2 5 5 5 0 5 0 2 2 2 5 0 2 
1000674 2 1 5 3 2 1 3 0 2 5 5 5 0 5 0 2 2 2 5 0 2 
1000669 2 1 5 3 2 1 3 0 2 5 5 5 0 5 0 2 2 2 5 1 
1000669 2 1 5 3 2 1 3 0 2 5 5 5 0 5 0 2 2 2 5 4 
1000669 2 1 5 3 2 1 3 0 2 5 5 5 0 5 0 2 2 2 5 1 
1000669 2 1 5 3 2 1 3 0 2 5 5 5 0 5 0 2 2 2 5 4 
1000669 2 1 5 3 2 1 3 0 2 5 5 5 0 5 0 2 2 2 5 5 
1000674 2 1 5 3 2 1 3 0 2 5 5 5 0 5 0 2 2 2 5 3 2 
1000674 2 1 5 3 2 1 3 0 2 5 5 5 0 5 0 2 2 2 5 0 4 
1000674 2 1 5 3 2 1 3 0 2 5 5 5 0 5 0 2 2 2 5 0 4 
1000674 2 1 5 3 2 1 3 0 2 5 5 5 0 5 0 2 2 2 5 0 1 
320 2 1 5 3 2 1 3 0 2 5 5 5 0 5 0 2 2 2 1 
320 2 1 5 3 2 1 3 0 2 5 5 5 0 5 0 2 2 2 0 
320 2 1 5 3 2 1 3 0 2 5 5 5 0 5 0 2 2 2 3 
285 2 1 5 3 2 1 3 0 2 5 5 5 0 5 0 2 2 3 3 0 5 
300 2 1 5 3 2 1 3 0 2 5 5 5 0 5 0 2 2 3 1 4 
320 2 1 5 3 2 1 3 0 2 5 5 5 0 5 0 2 2 2 2 
1000674 2 1 5 3 2 1 3 0 2 5 5 5 0 5 0 2 2 2 5 0 5 
295 2 1 5 3 2 1 3 0 2 5 5 5 0 5 0 2 2 4 
1000669 2 1 5 3 2 1 3 0 2 5 5 5 0 5 0 2 2 2 5 4 
305 2 1 5 3 2 1 3 0 2 5 5 5 0 5 0 2 2 3 0 4 1 
320 2 1 5 3 2 1 3 0 2 5 5 5 0 5 0 2 2 2 4 
320 2 1 5 3 2 1 3 0 2 5 5 5 0 5 0 2 2 2 0 
1000674 2 1 5 3 2 1 3 0 2 5 5 5 0 5 0 2 2 2 5 0 4 
320 2 1 5 3 2 1 3 0 2 5 5 5 0 5 0 2 2 2 2 
1000669 2 1 5 3 2 1 3 0 2 5 5 5 0 5 0 2 2 2 5 2 
275 2 1 5 3 2 1 3 0 2 5 5 5 0 5 0 2 2 0 5 
1000674 2 1 5 3 2 1 3 0 2 5 5 5 0 5 0 2 2 2 5 0 3 
1000669 2 1 5 3 2 1 3 0 2 5 5 5 0 5 0 2 2 2 5 2 
70 2 1 5 3 2 1 3 0 2 5 5 5 0 5 0 2 2 2 5 0 5 
1000669 2 1 5 3 2 1 3 0 2 5 5 5 0 5 0 2 2 2 5 1 
1000674 2 1 5 3 2 1 3 0 2 5 5 5 0 5 0 2 2 2 5 3 4 
275 2 1 5 3 2 1 3 0 2 5 5 5 0 5 0 2 2 0 
1000669 2 1 5 3 2 1 3 0 2 5 5 5 0 5 0 2 2 2 5 4 
1000674 2 1 5 3 2 1 3 0 2 5 5 5 0 5 0 2 2 2 5 0 0 
320 2 1 5 3 2 1 3 0 2 5 5 5 0 5 0 2 2 2 2 
1000674 2 1 5 3 2 1 3 0 2 5 5 5 0 5 0 2 2 2 5 0 4 
370 2 1 5 3 2 1 3 0 2 5 5 5 0 5 0 2 2 2 2 
1000674 2 1 5 3 2 1 3 0 2 5 5 5 0 5 0 2 2 2 5 0 5 
320 2 1 5 3 2 1 3 0 2 5 5 5 0 5 0 2 2 2 1 
1000674 2 1 5 3 2 1 3 0 2 5 5 5 0 5 0 2 2 2 5 0 3 
1000669 2 1 5 3 2 1 3 0 2 5 5 5 0 5 0 2 2 2 5 4 
320 2 1 5 3 2 1 3 0 2 5 5 5 0 5 0 2 2 5 4 
1000674 2 1 5 3 2 1 3 0 2 5 5 5 0 5 0 2 2 2 5 0 3 
320 2 1 5 3 2 1 3 0 2 5 5 5 0 5 0 2 2 2 3 
320 2 1 5 3 2 1 3 0 2 5 5 5 0 5 0 2 2 2 2 
320 2 1 5 3 2 1 3 0 2 5 5 5 0 5 0 2 2 2 3 
1000669 2 1 5 3 2 1 3 0 2 5 5 5 0 5 0 2 2 2 5 2 
275 2 1 5 3 2 1 3 0 2 5 5 5 0 5 0 2 2 3 2 
320 2 1 5 3 2 1 3 0 2 5 5 5 0 5 0 2 2 1 4 2 
300 2 1 5 3 2 1 3 0 2 5 5 5 0 5 0 2 2 3 1 4 
1000674 2 1 5 3 2 1 3 0 2 5 5 5 0 5 0 2 2 2 5 0 0 
320 2 1 5 3 2 1 3 0 2 5 5 5 0 5 0 2 2 5 
1000669 2 1 5 3 2 1 3 0 2 5 5 5 0 5 0 2 2 2 5 4 
1000669 2 1 5 3 2 1 3 0 2 5 5 5 0 5 0 2 2 2 5 4 
1000669 2 1 5 3 2 1 3 0 2 5 5 5 0 5 0 2 2 2 5 2 
320 2 1 5 3 2 1 3 0 2 5 5 5 0 5 0 2 2 4 4 3 
65 2 1 5 3 2 1 3 0 2 5 5 5 0 5 0 2 2 2 5 1 
1000669 2 1 5 3 2 1 3 0 2 5 5 5 0 5 0 2 2 2 5 2 
320 2 1 5 3 2 1 3 0 2 5 5 5 0 5 0 2 2 2 1 
1000669 2 1 5 3 2 1 3 0 2 5 5 5 0 5 0 2 2 2 5 5 
320 2 1 5 3 2 1 3 0 2 5 5 5 0 5 0 2 2 2 4 
1000674 2 1 5 3 2 1 3 0 2 5 5 5 0 5 0 2 2 2 5 0 0 
320 2 1 5 3 2 1 3 0 2 5 5 5 0 5 0 2 2 2 1 
320 2 1 5 3 2 1 3 0 2 5 5 5 0 5 0 2 2 2 3 
1000674 2 1 5 3 2 1 3 0 2 5 5 5 0 5 0 2 2 2 5 0 1 
1000674 2 1 5 3 2 1 3 0 2 5 5 5 0 5 0 2 2 2 5 3 0 
320 2 1 5 3 2 1 3 0 2 5 5 5 0 5 0 2 2 2 4 
1000674 2 1 5 3 2 1 3 0 2 5 5 5 0 5 0 2 2 2 5 0 2 
320 2 1 5 3 2 1 3 0 2 5 5 5 0 5 0 2 2 2 1 
1000669 2 1 5 3 2 1 3 0 2 5 5 5 0 5 0 2 2 2 5 4 
1000669 2 1 5 3 2 1 3 0 2 5 5 5 0 5 0 2 2 2 5 5 
320 2 1 5 3 2 1 3 0 2 5 5 5 0 5 0 2 2 2 4 
320 2 1 5 3 2 1 3 0 2 5 5 5 0 5 0 2 2 5 0 
1000674 2 1 5 3 2 1 3 0 2 5 5 5 0 5 0 2 2 2 5 0 4 
320 2 1 5 3 2 1 3 0 2 5 5 5 0 5 0 2 2 2 1 
275 2 1 5 3 2 1 3 0 2 5 5 5 0 5 0 2 2 0 2 
275 2 1 5 3 2 1 3 0 2 5 5 5 0 5 0 2 2 3 
1000669 2 1 5 3 2 1 3 0 2 5 5 5 0 5 0 2 2 2 5 1 
1000674 2 1 5 3 2 1 3 0 2 5 5 5 0 5 0 2 2 2 5 0 1 
320 2 1 5 3 2 1 3 0 2 5 5 5 0 5 0 2 2 2 0 
1000669 2 1 5 3 2 1 3 0 2 5 5 5 0 5 0 2 2 2 5 1 
275 2 1 5 3 2 1 3 0 2 5 5 5 0 5 0 2 2 3 
320 2 1 5 3 2 1 3 0 2 5 5 5 0 5 0 2 2 2 3 
1000674 2 1 5 3 2 1 3 0 2 5 5 5 0 5 0 2 2 2 5 0 1 
1000674 2 1 5 3 2 1 3 0 2 5 5 5 0 5 0 2 2 2 5 3 2 
1000669 2 1 5 3 2 1 3 0 2 5 5 5 0 5 0 2 2 2 5 5 
1000674 2 1 5 3 2 1 3 0 2 5 5 5 0 5 0 2 2 2 5 0 3 
320 2 1 5 3 2 1 3 0 2 5 5 5 0 5 0 2 2 2 4 
280 2 1 5 3 2 1 3 0 2 5 5 5 0 5 0 2 2 0 0 5 
320 2 1 5 3 2 1 3 0 2 5 5 5 0 5 0 2 2 1 1 3 
320 2 1 5 3 2 1 3 0 2 5 5 5 0 5 0 2 2 5 3 
1000674 2 1 5 3 2 1 3 0 2 5 5 5 0 5 0 2 2 2 5 0 5 
1000674 2 1 5 3 2 1 3 0 2 5 5 5 0 5 0 2 2 2 5 0 2 
320 2 1 5 3 2 1 3 0 2 5 5 5 0 5 0 2 2 4 4 2 
1000674 2 1 5 3 2 1 3 0 2 5 5 5 0 5 0 2 2 2 5 0 0 
1000674 2 1 5 3 2 1 3 0 2 5 5 5 0 5 0 2 2 2 5 0 2 
320 2 1 5 3 2 1 3 0 2 5 5 5 0 5 0 2 2 2 3 
320 2 1 5 3 2 1 3 0 2 5 5 5 0 5 0 2 2 4 1 4 
1000674 2 1 5 3 2 1 3 0 2 5 5 5 0 5 0 2 2 2 5 0 4 
320 2 1 5 3 2 1 3 0 2 5 5 5 0 5 0 2 2 5 1 
1000674 2 1 5 3 2 1 3 0 2 5 5 5 0 5 0 2 2 2 5 0 0 
1000674 2 1 5 3 2 1 3 0 2 5 5 5 0 5 0 2 2 2 5 0 5 
1000669 2 1 5 3 2 1 3 0 2 5 5 5 0 5 0 2 2 2 5 4 
320 2 1 5 3 2 1 3 0 2 5 5 5 0 5 0 2 2 2 2 
320 2 1 5 3 2 1 3 0 2 5 5 5 0 5 0 2 2 5 0 
1000674 2 1 5 3 2 1 3 0 2 5 5 5 0 5 0 2 2 2 5 0 3 
295 2 1 5 3 2 1 3 0 2 5 5 5 0 5 0 2 2 3 3 0 0 2 
320 2 1 5 3 2 1 3 0 2 5 5 5 0 5 0 2 2 2 3 
1000669 2 1 5 3 2 1 3 0 2 5 5 5 0 5 0 2 2 2 5 4 
320 2 1 5 3 2 1 3 0 2 5 5 5 0 5 0 2 2 4 4 3 
1000669 2 1 5 3 2 1 3 0 2 5 5 5 0 5 0 2 2 2 5 4 
320 2 1 5 3 2 1 3 0 2 5 5 5 0 5 0 2 2 2 4 
1000674 2 1 5 3 2 1 3 0 2 5 5 5 0 5 0 2 2 2 5 3 5 
1000669 2 1 5 3 2 1 3 0 2 5 5 5 0 5 0 2 2 2 5 4 
320 2 1 5 3 2 1 3 0 2 5 5 5 0 5 0 2 2 2 3 
275 2 1 5 3 2 1 3 0 2 5 5 5 0 5 0 2 2 0 2 
320 2 1 5 3 2 1 3 0 2 5 5 5 0 5 0 2 2 2 1 
1000674 2 1 5 3 2 1 3 0 2 5 5 5 0 5 0 2 2 2 5 0 5 
1000674 2 1 5 3 2 1 3 0 2 5 5 5 0 5 0 2 2 2 5 0 5 
320 2 1 5 3 2 1 3 0 2 5 5 5 0 5 0 2 2 2 3 
375 2 1 5 3 2 1 3 0 2 5 5 5 0 5 0 2 2 2 5 0 
