-105 2 0 1 5 0 3 5 3 3 2 
-90 2 0 1 5 0 3 5 3 3 3 0 2 
-60 2 0 1 5 0 3 5 3 2 2 
-65 2 0 1 5 0 3 5 2 4 
-5 2 0 1 5 0 3 5 2 0 5 3 5 
-60 2 0 1 5 0 3 5 2 0 1 
20 2 0 1 5 0 3 5 2 0 5 0 4 4 
-5 2 0 1 5 0 3 5 4 1 3 5 2 
145 2 0 1 5 0 3 5 2 0 5 5 5 0 5 1 
40 2 0 1 5 0 3 5 2 0 5 5 2 
95 2 0 1 5 0 3 5 2 0 5 5 5 0 3 
90 2 0 1 5 0 3 5 2 0 5 5 5 3 1 
40 2 0 1 5 0 3 5 2 0 5 5 1 
155 2 0 1 5 0 3 5 2 0 5 5 5 0 5 0 4 
90 2 0 1 5 0 3 5 2 0 5 5 5 1 
90 2 0 1 5 0 3 5 2 0 5 5 5 5 
