999999 2 6 4 3 4 6 4 3 4 3 5 5 4 6 5 6 3 6 2 4 5 4 5 4 6 4 1 5 
999999 2 6 4 3 4 6 4 3 4 3 5 5 4 6 5 6 3 6 2 4 5 4 4 4 4 6 5 6 
999999 2 6 4 3 4 6 4 3 4 3 5 5 4 6 5 6 3 6 2 4 5 5 5 1 5 6 
999999 2 6 4 3 4 6 4 3 4 3 5 5 4 6 5 6 3 6 2 4 5 4 6 6 5 1 
999999 2 6 4 3 4 6 4 3 4 3 5 5 4 6 5 6 3 6 2 4 5 6 4 6 5 2 
999994 2 6 4 3 4 6 4 3 4 3 5 5 4 6 5 6 3 6 2 4 5 4 4 5 6 4 5 
999994 2 6 4 3 4 6 4 3 4 3 5 5 4 6 5 6 3 6 2 4 5 4 4 1 3 6 5 3 3 
999994 2 6 4 3 4 6 4 3 4 3 5 5 4 6 5 6 3 6 2 4 5 4 5 4 6 4 2 
999994 2 6 4 3 4 6 4 3 4 3 5 5 4 6 5 6 3 6 2 4 5 4 6 3 3 5 5 2 
999994 2 6 4 3 4 6 4 3 4 3 5 5 4 6 5 6 3 6 2 4 5 4 4 5 6 6 
755 2 6 4 3 4 6 4 3 4 3 5 5 4 6 5 6 3 6 2 4 5 4 2 4 6 3 
750 2 6 4 3 4 6 4 3 4 3 5 5 4 6 5 6 3 6 2 4 5 6 4 6 4 
745 2 6 4 3 4 6 4 3 4 3 5 5 4 6 5 6 3 6 2 4 5 4 6 6 3 
740 2 6 4 3 4 6 4 3 4 3 5 5 4 6 5 6 3 6 2 4 5 1 3 5 3 6 3 
715 2 6 4 3 4 6 4 3 4 3 5 5 4 6 5 6 3 6 2 4 5 1 2 4 4 6 
705 2 6 4 3 4 6 4 3 4 3 5 5 4 6 5 6 3 6 2 4 5 4 4 6 6 
705 2 6 4 3 4 6 4 3 4 3 5 5 4 6 5 6 3 6 2 4 5 4 4 6 6 
700 2 6 4 3 4 6 4 3 4 3 5 5 4 6 5 6 3 6 2 4 5 3 5 4 3 1 6 
690 2 6 4 3 4 6 4 3 4 3 5 5 4 6 5 6 3 6 2 4 5 4 3 3 6 6 
690 2 6 4 3 4 6 4 3 4 3 5 5 4 6 5 6 3 6 2 4 5 4 3 6 3 6 
685 2 6 4 3 4 6 4 3 4 3 5 5 4 6 5 6 3 6 2 4 5 4 6 3 6 
620 2 6 4 3 4 6 4 3 4 3 5 5 4 6 5 6 3 6 2 4 5 4 5 4 4 4 
615 2 6 4 3 4 6 4 3 4 3 5 5 4 6 5 6 3 6 2 4 5 4 4 1 5 4 
615 2 6 4 3 4 6 4 3 4 3 5 5 4 6 5 6 3 6 2 4 5 4 5 4 1 4 
615 2 6 4 3 4 6 4 3 4 3 5 5 4 6 5 6 3 6 2 4 5 4 5 5 3 
605 2 6 4 3 4 6 4 3 4 3 5 5 4 6 5 6 3 6 2 4 5 4 4 6 4 
605 2 6 4 3 4 6 4 3 4 3 5 5 4 6 5 6 3 6 2 4 5 4 6 1 4 
600 2 6 4 3 4 6 4 3 4 3 5 5 4 6 5 6 3 6 2 4 5 4 4 3 5 3 1 
600 2 6 4 3 4 6 4 3 4 3 5 5 4 6 5 6 3 6 2 4 5 5 5 3 3 1 
595 2 6 4 3 4 6 4 3 4 3 5 5 4 6 5 6 3 6 2 4 5 4 5 4 3 1 
595 2 6 4 3 4 6 4 3 4 3 5 5 4 6 5 6 3 6 2 4 5 4 1 5 3 2 
590 2 6 4 3 4 6 4 3 4 3 5 5 4 6 5 6 3 6 2 4 5 4 4 5 4 
590 2 6 4 3 4 6 4 3 4 3 5 5 4 6 5 6 3 6 2 4 5 4 4 5 5 
590 2 6 4 3 4 6 4 3 4 3 5 5 4 6 5 6 3 6 2 4 5 4 1 5 1 
590 2 6 4 3 4 6 4 3 4 3 5 5 4 6 5 6 3 6 2 4 5 4 1 5 5 
590 2 6 4 3 4 6 4 3 4 3 5 5 4 6 5 6 3 6 2 4 5 1 2 4 2 
585 2 6 4 3 4 6 4 3 4 3 5 5 4 6 5 6 3 6 2 4 5 4 3 6 1 
580 2 6 4 3 4 6 4 3 4 3 5 5 4 6 5 6 3 6 2 4 5 6 4 2 
580 2 6 4 3 4 6 4 3 4 3 5 5 4 6 5 6 3 6 2 4 5 4 5 3 3 3 2 
565 2 6 4 3 4 6 4 3 4 3 5 5 4 6 5 6 3 6 2 4 5 4 5 1 
565 2 6 4 3 4 6 4 3 4 3 5 5 4 6 5 6 3 6 2 4 5 5 4 6 
565 2 6 4 3 4 6 4 3 4 3 5 5 4 6 5 6 3 6 2 4 5 4 5 2 
565 2 6 4 3 4 6 4 3 4 3 5 5 4 6 5 6 3 6 2 4 5 4 1 4 2 
565 2 6 4 3 4 6 4 3 4 3 5 5 4 6 5 6 3 6 2 4 5 4 4 4 1 
565 2 6 4 3 4 6 4 3 4 3 5 5 4 6 5 6 3 6 2 4 5 4 4 1 2 
565 2 6 4 3 4 6 4 3 4 3 5 5 4 6 5 6 3 6 2 4 5 4 2 3 
565 2 6 4 3 4 6 4 3 4 3 5 5 4 6 5 6 3 6 2 4 5 4 1 4 1 
565 2 6 4 3 4 6 4 3 4 3 5 5 4 6 5 6 3 6 2 4 5 4 1 1 2 
565 2 6 4 3 4 6 4 3 4 3 5 5 4 6 5 6 3 6 2 4 5 4 5 6 
565 2 6 4 3 4 6 4 3 4 3 5 5 4 6 5 6 3 6 2 4 5 1 5 6 
565 2 6 4 3 4 6 4 3 4 3 5 5 4 6 5 6 3 6 2 4 5 4 2 1 
555 2 6 4 3 4 6 4 3 4 3 5 5 4 6 5 6 3 6 2 4 5 6 1 
550 2 6 4 3 4 6 4 3 4 3 5 5 4 6 5 6 3 6 2 4 5 4 1 3 3 1 
545 2 6 4 3 4 6 4 3 4 3 5 5 4 6 5 6 3 6 2 4 5 2 3 1 
545 2 6 4 3 4 6 4 3 4 3 5 5 4 6 5 6 3 6 2 4 5 4 3 4 4 
545 2 6 4 3 4 6 4 3 4 3 5 5 4 6 5 6 3 6 2 4 5 4 3 1 1 
545 2 6 4 3 4 6 4 3 4 3 5 5 4 6 5 6 3 6 2 4 5 4 4 3 4 
540 2 6 4 3 4 6 4 3 4 3 5 5 4 6 5 6 3 6 2 4 5 1 1 6 5 4 
540 2 6 4 3 4 6 4 3 4 3 5 5 4 6 5 6 3 6 2 4 5 1 1 6 5 5 3 4 
540 2 6 4 3 4 6 4 3 4 3 5 5 4 6 5 6 3 6 2 4 5 1 1 6 5 5 2 
540 2 6 4 3 4 6 4 3 4 3 5 5 4 6 5 6 3 6 2 4 5 1 1 6 5 5 1 
540 2 6 4 3 4 6 4 3 4 3 5 5 4 6 5 6 3 6 2 4 5 1 1 6 5 1 
540 2 6 4 3 4 6 4 3 4 3 5 5 4 6 5 6 3 6 2 4 5 1 1 6 5 1 
540 2 6 4 3 4 6 4 3 4 3 5 5 4 6 5 6 3 6 2 4 5 1 1 6 5 5 3 1 
540 2 6 4 3 4 6 4 3 4 3 5 5 4 6 5 6 3 6 2 4 5 1 1 6 5 1 
540 2 6 4 3 4 6 4 3 4 3 5 5 4 6 5 6 3 6 2 4 5 1 1 6 5 5 5 
540 2 6 4 3 4 6 4 3 4 3 5 5 4 6 5 6 3 6 2 4 5 1 1 6 5 5 1 
540 2 6 4 3 4 6 4 3 4 3 5 5 4 6 5 6 3 6 2 4 5 1 1 6 5 5 3 3 
540 2 6 4 3 4 6 4 3 4 3 5 5 4 6 5 6 3 6 2 4 5 1 1 6 5 5 3 3 
540 2 6 4 3 4 6 4 3 4 3 5 5 4 6 5 6 3 6 2 4 5 1 1 6 5 5 3 5 
540 2 6 4 3 4 6 4 3 4 3 5 5 4 6 5 6 3 6 2 4 5 1 1 6 5 6 
540 2 6 4 3 4 6 4 3 4 3 5 5 4 6 5 6 3 6 2 4 5 1 1 6 5 6 
540 2 6 4 3 4 6 4 3 4 3 5 5 4 6 5 6 3 6 2 4 5 1 1 6 5 5 3 2 
540 2 6 4 3 4 6 4 3 4 3 5 5 4 6 5 6 3 6 2 4 5 1 1 6 5 5 4 
540 2 6 4 3 4 6 4 3 4 3 5 5 4 6 5 6 3 6 2 4 5 1 1 6 5 5 6 
540 2 6 4 3 4 6 4 3 4 3 5 5 4 6 5 6 3 6 2 4 5 1 1 6 5 5 3 5 
540 2 6 4 3 4 6 4 3 4 3 5 5 4 6 5 6 3 6 2 4 5 1 1 6 5 5 3 5 
540 2 6 4 3 4 6 4 3 4 3 5 5 4 6 5 6 3 6 2 4 5 1 1 6 5 5 2 
540 2 6 4 3 4 6 4 3 4 3 5 5 4 6 5 6 3 6 2 4 5 1 1 6 5 5 4 
540 2 6 4 3 4 6 4 3 4 3 5 5 4 6 5 6 3 6 2 4 5 1 1 6 5 1 
540 2 6 4 3 4 6 4 3 4 3 5 5 4 6 5 6 3 6 2 4 5 1 1 6 5 5 4 
540 2 6 4 3 4 6 4 3 4 3 5 5 4 6 5 6 3 6 2 4 5 1 1 6 5 5 3 2 
540 2 6 4 3 4 6 4 3 4 3 5 5 4 6 5 6 3 6 2 4 5 1 1 6 5 5 4 
540 2 6 4 3 4 6 4 3 4 3 5 5 4 6 5 6 3 6 2 4 5 1 1 6 5 5 3 6 
540 2 6 4 3 4 6 4 3 4 3 5 5 4 6 5 6 3 6 2 4 5 1 1 6 5 5 3 2 
540 2 6 4 3 4 6 4 3 4 3 5 5 4 6 5 6 3 6 2 4 5 1 1 6 5 2 
540 2 6 4 3 4 6 4 3 4 3 5 5 4 6 5 6 3 6 2 4 5 1 1 6 5 5 3 3 
540 2 6 4 3 4 6 4 3 4 3 5 5 4 6 5 6 3 6 2 4 5 1 1 6 5 5 
540 2 6 4 3 4 6 4 3 4 3 5 5 4 6 5 6 3 6 2 4 5 1 1 6 5 5 2 
540 2 6 4 3 4 6 4 3 4 3 5 5 4 6 5 6 3 6 2 4 5 1 1 6 5 5 3 
540 2 6 4 3 4 6 4 3 4 3 5 5 4 6 5 6 3 6 2 4 5 4 4 2 
540 2 6 4 3 4 6 4 3 4 3 5 5 4 6 5 6 3 6 2 4 5 4 4 2 
540 2 6 4 3 4 6 4 3 4 3 5 5 4 6 5 6 3 6 2 4 5 2 2 
540 2 6 4 3 4 6 4 3 4 3 5 5 4 6 5 6 3 6 2 4 5 4 4 2 
540 2 6 4 3 4 6 4 3 4 3 5 5 4 6 5 6 3 6 2 4 5 1 1 6 5 5 2 
540 2 6 4 3 4 6 4 3 4 3 5 5 4 6 5 6 3 6 2 4 5 1 1 6 5 1 
540 2 6 4 3 4 6 4 3 4 3 5 5 4 6 5 6 3 6 2 4 5 1 1 6 5 5 3 2 
540 2 6 4 3 4 6 4 3 4 3 5 5 4 6 5 6 3 6 2 4 5 1 1 6 5 5 3 
540 2 6 4 3 4 6 4 3 4 3 5 5 4 6 5 6 3 6 2 4 5 1 1 6 5 5 1 
540 2 6 4 3 4 6 4 3 4 3 5 5 4 6 5 6 3 6 2 4 5 1 1 6 5 3 
540 2 6 4 3 4 6 4 3 4 3 5 5 4 6 5 6 3 6 2 4 5 1 1 6 5 6 
540 2 6 4 3 4 6 4 3 4 3 5 5 4 6 5 6 3 6 2 4 5 1 1 6 5 5 
540 2 6 4 3 4 6 4 3 4 3 5 5 4 6 5 6 3 6 2 4 5 1 1 6 5 5 3 5 
540 2 6 4 3 4 6 4 3 4 3 5 5 4 6 5 6 3 6 2 4 5 1 1 6 5 2 
540 2 6 4 3 4 6 4 3 4 3 5 5 4 6 5 6 3 6 2 4 5 1 1 6 5 5 3 5 
540 2 6 4 3 4 6 4 3 4 3 5 5 4 6 5 6 3 6 2 4 5 1 1 6 5 5 2 
540 2 6 4 3 4 6 4 3 4 3 5 5 4 6 5 6 3 6 2 4 5 1 1 6 5 5 5 
540 2 6 4 3 4 6 4 3 4 3 5 5 4 6 5 6 3 6 2 4 5 1 1 6 5 2 
540 2 6 4 3 4 6 4 3 4 3 5 5 4 6 5 6 3 6 2 4 5 1 1 6 5 5 3 2 
540 2 6 4 3 4 6 4 3 4 3 5 5 4 6 5 6 3 6 2 4 5 1 1 6 5 5 3 2 
540 2 6 4 3 4 6 4 3 4 3 5 5 4 6 5 6 3 6 2 4 5 1 1 6 5 5 5 
540 2 6 4 3 4 6 4 3 4 3 5 5 4 6 5 6 3 6 2 4 5 1 1 6 5 5 1 
540 2 6 4 3 4 6 4 3 4 3 5 5 4 6 5 6 3 6 2 4 5 1 1 6 5 5 5 
540 2 6 4 3 4 6 4 3 4 3 5 5 4 6 5 6 3 6 2 4 5 1 1 6 5 6 
540 2 6 4 3 4 6 4 3 4 3 5 5 4 6 5 6 3 6 2 4 5 1 1 6 5 5 3 1 
540 2 6 4 3 4 6 4 3 4 3 5 5 4 6 5 6 3 6 2 4 5 1 1 6 5 4 
540 2 6 4 3 4 6 4 3 4 3 5 5 4 6 5 6 3 6 2 4 5 1 1 6 5 6 
540 2 6 4 3 4 6 4 3 4 3 5 5 4 6 5 6 3 6 2 4 5 1 1 6 5 2 
540 2 6 4 3 4 6 4 3 4 3 5 5 4 6 5 6 3 6 2 4 5 1 1 6 5 6 
540 2 6 4 3 4 6 4 3 4 3 5 5 4 6 5 6 3 6 2 4 5 1 1 6 5 5 2 
540 2 6 4 3 4 6 4 3 4 3 5 5 4 6 5 6 3 6 2 4 5 1 1 6 5 5 3 5 
530 2 6 4 3 4 6 4 3 4 3 5 5 4 6 5 6 3 6 2 4 5 3 4 3 2 
495 2 6 4 3 4 6 4 3 4 3 5 5 4 6 5 6 3 6 2 4 5 3 6 
165 2 6 4 3 4 6 4 3 4 3 5 5 4 6 5 6 3 6 2 4 5 1 1 6 5 5 
165 2 6 4 3 4 6 4 3 4 3 5 5 4 6 5 6 3 6 2 4 5 1 1 6 5 5 
165 2 6 4 3 4 6 4 3 4 3 5 5 4 6 5 6 3 6 2 4 5 1 1 6 5 5 
165 2 6 4 3 4 6 4 3 4 3 5 5 4 6 5 6 3 6 2 4 5 1 1 6 5 5 
-690 2 6 4 3 4 6 4 3 4 3 5 5 4 6 5 6 3 6 2 4 5 1 1 6 5 
