999999 5 5 1 4 3 4 6 4 3 4 5 3 6 5 3 5 2 3 6 1 5 4 6 5 4 3 5 6 
560 5 5 1 4 3 4 6 4 3 4 5 3 6 5 3 5 5 6 6 3 4 6 6 2 
555 5 5 1 4 3 4 6 4 3 4 5 3 6 5 3 5 2 3 6 1 5 4 6 1 4 5 
540 5 5 1 4 3 4 6 4 3 4 5 3 6 5 3 5 6 2 6 4 6 2 2 
535 5 5 1 4 3 4 6 4 3 4 5 3 6 5 3 5 2 3 6 3 3 3 6 5 6 2 
515 5 5 1 4 3 4 6 4 3 4 5 3 6 5 3 5 2 3 6 1 5 5 
515 5 5 1 4 3 4 6 4 3 4 5 3 6 5 3 5 2 3 6 1 1 4 6 
500 5 5 1 4 3 4 6 4 3 4 5 3 6 5 3 5 2 3 6 3 1 1 3 6 
460 5 5 1 4 3 4 6 4 3 4 5 3 6 5 3 5 2 3 6 1 1 3 6 3 
440 5 5 1 4 3 4 6 4 3 4 5 3 6 5 3 5 2 3 6 1 5 4 1 
440 5 5 1 4 3 4 6 4 3 4 5 3 6 5 3 5 2 3 6 1 2 1 1 
440 5 5 1 4 3 4 6 4 3 4 5 3 6 5 3 5 2 3 6 1 2 4 2 
435 5 5 1 4 3 4 6 4 3 4 5 3 6 5 3 5 3 5 3 3 5 4 4 1 4 2 
435 5 5 1 4 3 4 6 4 3 4 5 3 6 5 3 5 2 3 6 2 6 2 6 
430 5 5 1 4 3 4 6 4 3 4 5 3 6 5 3 5 2 3 5 2 2 3 1 
425 5 5 1 4 3 4 6 4 3 4 5 3 6 5 3 5 2 3 6 1 4 3 1 3 3 
415 5 5 1 4 3 4 6 4 3 4 5 3 6 5 3 5 2 3 6 1 5 2 
415 5 5 1 4 3 4 6 4 3 4 5 3 6 5 3 5 3 2 6 4 2 2 
415 5 5 1 4 3 4 6 4 3 4 5 3 6 5 3 5 2 3 6 1 2 2 
380 5 5 1 4 3 4 6 4 3 4 5 3 6 5 3 5 2 3 6 1 1 6 3 
220 5 5 1 4 3 4 6 4 3 4 5 3 6 5 3 5 4 
170 5 5 1 4 3 4 6 4 3 4 5 3 6 5 3 6 
170 5 5 1 4 3 4 6 4 3 4 5 3 6 5 3 2 
165 5 5 1 4 3 4 6 4 3 4 5 3 6 5 4 
140 5 5 1 4 3 4 6 4 3 4 5 3 6 5 3 5 2 3 6 1 
-200 5 5 1 4 3 4 6 4 3 4 5 3 6 5 3 
-255 5 5 1 4 3 4 6 4 3 4 5 1 
-255 5 5 1 4 3 4 6 4 3 4 5 1 
-255 5 5 1 4 3 4 6 4 3 4 5 1 
-380 5 5 1 4 3 4 6 4 3 
