-40 2 6 4 3 4 6 4 3 5 
-40 2 6 4 3 4 6 4 3 5 
-40 2 6 4 3 4 6 4 3 2 
-40 2 6 4 3 4 6 3 4 5 
-40 2 6 4 3 4 6 4 3 5 
-40 2 6 4 3 4 6 4 3 6 
-45 2 6 4 3 4 6 4 6 
-45 2 6 4 3 4 6 4 2 
-45 2 6 4 3 4 6 4 2 
-45 2 6 4 3 4 6 4 6 
-45 2 6 4 3 4 6 4 4 
-45 2 6 4 3 4 6 4 4 
-45 2 6 4 3 4 6 4 4 
-45 2 6 4 3 4 6 4 2 
-45 2 6 4 3 4 6 4 4 
-45 2 6 4 3 4 6 4 5 
-45 2 6 4 3 4 6 4 2 
-45 2 6 4 3 4 6 4 5 
-45 2 6 4 3 4 6 4 2 
-45 2 6 4 3 4 6 4 6 
-45 2 6 4 3 4 6 4 1 
-45 2 6 4 3 4 6 4 6 
-45 2 6 4 3 4 6 4 2 
-45 2 6 4 3 4 6 4 1 
-45 2 6 4 3 4 6 4 1 
-45 2 6 4 3 4 6 4 1 
-45 2 6 4 3 4 6 4 4 
-45 2 6 4 3 4 6 4 6 
-65 2 6 4 3 4 6 3 6 
-65 2 6 4 3 4 6 3 1 
-65 2 6 4 3 4 6 3 5 
-70 2 6 4 3 4 6 2 
-70 2 6 4 3 4 6 5 
-70 2 6 4 3 4 6 1 
-70 2 6 4 3 4 6 2 
-70 2 6 4 3 4 6 5 
-70 2 6 4 3 4 6 1 
-70 2 6 4 3 4 6 2 
-70 2 6 4 3 4 6 2 
-70 2 6 4 3 4 6 6 
-70 2 6 4 3 4 6 5 
-70 2 6 4 3 4 6 6 
-70 2 6 4 3 4 6 2 
-70 2 6 4 3 4 6 1 
-70 2 6 4 3 4 6 5 
-70 2 6 4 3 4 6 5 
-70 2 6 4 3 4 6 6 
-70 2 6 4 3 4 6 1 
-70 2 6 4 3 4 6 6 
-70 5 6 4 3 4 6 1 
-95 2 6 4 3 4 3 4 3 4 
-105 2 6 4 3 4 3 4 4 
-125 2 6 4 3 4 3 1 
-130 2 6 4 3 4 3 5 
-130 2 6 4 3 4 3 3 
-135 2 6 4 3 4 5 
-135 2 6 4 3 4 4 
-135 2 6 4 3 4 5 
-135 2 6 4 3 4 5 
-135 2 6 4 3 4 4 
-135 2 6 4 3 4 5 
-135 2 6 4 3 4 5 
-135 2 6 4 3 4 5 
-135 2 6 4 3 4 2 
-135 2 6 4 3 4 5 
-135 2 6 4 3 4 2 
-135 2 6 4 3 4 2 
-135 2 6 4 3 4 5 
-135 2 6 4 3 4 5 
-155 2 5 5 1 
-160 2 6 4 3 5 
-160 2 6 4 3 6 
-160 2 6 4 3 6 
-165 2 6 4 4 
-165 2 6 4 5 
-165 2 6 4 1 
-165 2 6 4 6 
-165 5 6 4 4 
-165 2 6 4 1 
-165 2 6 4 5 
-165 2 6 4 6 
-165 2 6 4 1 
-165 2 6 4 1 
-165 2 6 4 1 
-190 2 6 1 
-190 2 6 5 
-190 2 6 2 
-255 5 1 
-255 1 4 1 
-255 1 4 2 
-255 5 1 
-255 2 4 
-255 2 2 
-255 5 2 
-275 3 1 5 
-280 4 5 
-280 4 5 
-300 3 2 
-305 6 
-305 6 
-535 2 6 4 3 
-535 2 6 4 3 
-535 2 6 4 3 
-540 2 6 4 
-540 2 6 4 
-540 2 6 4 
-540 2 6 4 
-565 2 6 
-565 2 6 
-565 2 6 
-565 2 6 
-565 2 6 
-565 2 6 
-565 2 6 
-565 5 6 
-565 2 6 
-565 2 6 
-565 2 6 
-565 2 6 
-565 2 6 
-565 2 6 
-630 2 
-630 2 
-630 5 
-630 1 1 
-630 2 
-630 2 
-670 3 3 2 1 3 
