-25 5 5 1 4 3 4 6 4 3 2 
-35 5 5 1 4 3 4 6 4 2 
-35 5 5 1 4 3 4 6 4 1 
-35 5 5 1 4 3 4 6 4 5 
-35 5 5 1 4 3 4 6 4 2 
-35 5 5 1 4 3 4 6 4 1 
-60 5 5 1 4 3 4 6 6 
-60 5 5 1 4 3 4 6 1 
-60 5 5 1 4 3 4 6 2 
-65 5 5 5 4 6 6 
-120 5 5 1 4 3 4 3 5 
-120 5 5 1 4 3 4 3 5 
-125 5 5 1 4 3 4 5 
-125 5 5 1 4 3 4 4 
-125 5 5 1 4 3 4 4 
-125 5 5 1 4 3 4 4 
-150 5 5 1 4 3 6 
-155 5 5 5 5 
-155 5 5 1 4 1 
-155 5 5 1 4 6 
-155 5 5 1 4 4 
-180 5 5 4 2 
-180 5 5 1 3 
-180 5 5 1 2 
-205 5 5 6 
-500 5 5 1 4 3 
-500 5 5 1 4 3 
-530 5 5 
-555 5 5 
-630 
