120 2 6 4 3 4 6 4 3 4 3 5 5 4 5 
85 2 6 4 3 4 6 4 3 4 5 5 2 
-10 2 6 4 3 4 6 4 3 4 3 1 
-15 2 6 4 3 4 6 4 3 4 4 
-15 2 6 4 3 4 6 4 3 4 1 
-15 2 6 4 3 4 6 4 3 4 1 
-15 2 6 4 3 4 6 4 3 4 1 
-35 2 6 4 3 4 6 3 4 3 5 
-40 2 6 4 3 4 6 3 4 1 
-40 2 6 4 3 4 3 4 6 6 
-40 2 6 4 3 4 6 4 3 6 
-40 2 6 4 3 4 6 4 3 1 
-40 2 6 4 3 4 6 4 3 1 
-40 2 6 4 3 4 6 4 3 6 
-40 2 6 4 3 4 6 4 3 2 
-40 2 6 4 3 4 6 4 3 2 
-40 2 6 4 3 4 6 4 3 1 
-40 2 6 4 3 4 6 3 4 4 
-40 2 6 4 3 4 6 4 3 3 
-40 2 6 4 3 4 6 4 3 6 
-40 2 6 4 3 4 6 4 3 1 
-40 2 6 4 3 4 6 4 3 1 
-40 2 6 4 3 4 6 4 3 2 
-40 2 6 4 3 4 6 4 3 2 
-40 2 6 4 3 4 6 4 3 3 
-40 2 6 4 3 4 6 4 3 1 
-40 2 6 4 3 4 6 4 3 1 
-40 2 6 4 3 4 6 4 3 2 
-45 2 6 4 3 4 6 4 4 
-45 2 6 4 3 4 6 4 5 
-45 2 6 4 3 4 6 4 1 
-45 2 6 4 3 4 6 4 4 
-45 2 6 4 3 4 6 4 1 
-45 2 6 4 3 4 6 4 1 
-45 2 6 4 3 4 6 4 5 
-45 2 6 4 3 4 6 4 5 
-45 2 6 4 3 4 6 4 5 
-45 2 6 4 3 4 6 4 2 
-45 2 6 4 3 4 6 4 5 
-45 2 6 4 3 4 6 4 2 
-45 2 6 4 3 4 6 4 2 
-45 2 6 4 3 4 6 4 6 
-45 2 6 4 3 4 6 4 4 
-45 2 6 4 3 4 6 4 1 
-45 2 6 4 3 4 6 4 4 
-45 2 6 4 3 4 6 4 6 
-45 2 6 4 3 4 6 4 6 
-45 2 6 4 3 4 6 4 1 
-45 2 6 4 3 4 6 4 1 
-45 2 6 4 3 4 6 4 1 
-45 2 6 4 3 4 6 4 1 
-45 2 6 4 3 4 6 4 2 
-45 2 6 4 3 4 6 4 2 
-45 2 6 4 3 4 6 4 4 
-45 2 6 4 3 4 6 4 6 
-45 2 6 4 3 4 6 4 4 
-45 2 6 4 3 4 6 4 4 
-45 2 6 4 3 4 6 4 2 
-45 2 6 4 3 4 6 4 4 
-65 2 6 4 3 4 6 3 1 
-65 2 6 4 3 4 6 3 6 
-65 2 6 4 3 4 3 6 5 
-65 2 6 4 3 4 6 3 3 
-65 2 6 4 3 4 6 3 6 
-70 2 6 4 3 4 6 5 
-70 2 6 4 3 4 6 5 
-70 2 6 4 3 4 6 5 
-70 2 6 4 3 4 6 5 
-70 2 6 4 3 4 6 6 
-70 2 6 4 3 4 6 5 
-70 2 6 4 3 4 6 5 
-70 2 6 4 3 4 6 1 
-70 2 6 4 3 4 6 6 
-70 2 6 4 3 4 6 2 
-70 2 6 4 3 4 6 1 
-70 2 6 4 3 4 6 2 
-70 2 6 4 3 4 6 1 
-70 2 6 4 3 4 6 5 
-70 2 6 4 3 4 6 6 
-70 2 6 4 3 4 6 6 
-70 2 6 4 3 4 6 5 
-70 2 6 4 3 4 6 2 
-70 2 6 4 3 4 6 6 
-100 2 6 4 3 4 3 4 3 4 
-130 2 6 4 3 4 3 5 
-130 2 6 4 3 4 3 1 
-130 2 6 4 3 4 3 5 
-130 2 6 4 3 4 3 5 
-130 2 6 4 3 4 3 2 
-135 2 6 4 3 4 4 
-135 2 6 4 3 4 2 
-135 2 6 4 3 4 5 
-135 2 6 4 3 4 2 
-135 2 6 4 3 4 4 
-135 2 6 4 3 4 2 
-135 2 6 4 3 4 1 
-135 2 6 4 3 4 5 
-135 2 6 4 3 4 1 
-135 2 6 4 3 4 1 
-135 2 6 4 3 4 2 
-135 2 6 4 3 4 1 
-135 2 6 4 3 4 5 
-135 2 6 4 3 4 1 
-160 2 6 4 3 5 
-160 2 6 4 3 2 
-160 2 6 4 3 5 
-160 2 6 4 3 2 
-160 2 6 4 3 1 
-160 2 6 4 3 3 
-160 2 6 4 3 1 
-165 2 6 4 2 
-165 2 6 4 5 
-415 2 6 4 3 4 6 4 
-415 2 6 4 3 4 6 4 
-415 2 6 4 3 4 6 4 
-415 2 6 4 3 4 6 4 
-420 2 6 4 3 4 6 4 
-420 2 6 4 3 4 6 4 
-420 2 6 4 3 4 6 4 
-420 2 6 4 3 4 6 4 
-420 2 6 4 3 4 6 4 
-420 2 6 4 3 4 6 4 
-420 2 6 4 3 4 6 4 
-420 2 6 4 3 4 6 4 
-445 2 6 4 3 4 6 
-445 2 6 4 3 4 6 
-535 5 6 4 3 
-535 2 6 4 3 
