0 5 5 1 4 3 4 6 4 3 4 2 
-30 5 5 1 4 3 4 6 4 3 5 
-30 5 5 1 4 3 4 6 4 3 2 
-30 5 5 1 4 3 4 6 4 3 2 
-35 5 5 1 4 3 4 6 4 6 
-35 5 5 1 4 3 4 6 4 5 
-35 5 5 1 4 3 4 6 4 2 
-35 5 5 1 4 3 4 6 4 1 
-35 5 5 1 4 3 4 6 4 2 
-55 5 5 1 4 3 4 6 3 1 
-60 5 5 1 4 3 4 6 5 
-60 5 5 1 4 3 4 6 2 
-60 5 5 1 4 3 4 6 2 
-120 5 5 1 4 3 4 3 2 
-125 5 5 1 4 3 4 2 
-125 5 5 1 4 3 4 2 
-150 5 5 1 4 3 3 
-150 5 5 1 4 3 6 
-150 5 5 1 4 3 2 
-150 5 5 1 4 3 2 
-150 5 5 1 4 3 1 
-405 5 5 1 4 3 4 6 4 
-405 5 5 1 4 3 4 6 4 
-405 5 5 1 4 3 4 6 4 
-405 5 5 1 4 3 4 6 4 
-410 5 5 1 4 3 4 6 
-435 5 5 1 4 3 4 
-500 5 5 1 4 3 
-500 5 5 1 4 3 
-530 5 5 
