180 2 6 4 3 4 6 4 3 4 3 5 5 4 6 4 
180 2 6 4 3 4 6 4 3 4 3 5 5 4 6 6 
180 2 6 4 3 4 6 4 3 4 3 5 5 4 6 3 
180 2 6 4 3 4 6 4 3 4 3 5 5 4 6 6 
180 2 6 4 3 4 6 4 3 4 3 5 5 4 6 2 
170 2 6 4 3 4 6 4 3 4 3 5 5 4 2 3 4 
170 2 6 4 3 4 6 4 3 4 3 5 6 6 1 
120 2 6 4 3 4 3 4 6 4 5 3 1 2 4 
115 2 6 4 3 4 6 4 3 4 3 5 5 4 3 
115 2 6 4 3 4 6 4 3 4 3 5 5 4 2 
115 2 6 4 3 4 6 4 3 4 3 5 5 4 5 
115 2 6 4 3 4 6 4 3 4 3 5 5 1 1 
115 2 6 4 3 4 6 4 3 4 3 5 5 4 5 
115 2 6 4 3 4 6 4 3 4 3 5 5 1 5 
115 2 6 4 3 4 6 4 3 4 3 5 5 4 5 
115 2 6 4 3 4 6 4 3 4 3 5 5 1 5 
115 2 6 4 3 4 6 4 3 4 3 5 5 4 5 
115 2 6 4 3 4 6 4 3 4 3 5 5 4 2 
115 2 6 4 3 4 6 4 3 4 3 5 5 1 4 
115 2 6 4 3 4 6 4 3 4 3 5 2 4 4 
115 2 6 4 3 4 6 4 3 4 3 5 5 4 3 
115 2 6 4 3 4 6 4 3 4 3 5 5 4 3 
115 2 6 4 3 4 6 4 3 4 3 5 1 5 5 
115 2 6 4 3 4 6 4 3 4 3 5 4 5 4 
115 2 6 4 3 4 6 4 3 4 3 5 5 4 1 
115 2 6 4 3 4 6 4 3 4 3 5 2 4 3 
115 2 6 4 3 4 6 4 3 4 3 5 4 1 4 5 
115 2 6 4 3 4 6 4 3 4 3 5 5 1 3 
115 2 6 4 3 4 6 4 3 4 3 5 5 4 3 
115 2 6 4 3 4 6 4 3 4 3 5 5 1 4 
115 2 6 4 3 4 6 4 3 4 3 5 5 4 3 
115 2 6 4 3 4 6 4 3 4 3 5 5 1 2 
115 2 6 4 3 4 6 4 3 4 3 5 5 4 1 
105 2 6 4 3 4 6 4 3 4 3 5 6 2 
105 2 6 4 3 4 6 4 3 4 3 5 6 5 
100 2 6 4 3 4 6 4 3 4 3 5 3 4 3 1 6 
100 2 6 4 3 4 6 4 3 4 6 4 4 4 
100 2 6 4 3 4 6 4 3 4 3 5 5 3 3 5 
95 2 6 4 3 4 6 4 3 4 3 5 3 5 4 
95 2 6 4 3 4 6 4 3 4 3 5 3 2 2 
95 2 6 4 3 4 6 4 3 4 3 5 5 3 6 
95 2 6 4 3 4 6 4 3 4 3 5 3 5 1 
95 2 6 4 3 4 6 4 3 4 3 5 5 3 4 
95 2 6 4 3 4 6 4 3 4 3 5 5 3 2 
95 2 6 4 3 4 6 4 3 4 3 5 5 3 1 
90 2 6 4 3 4 6 4 3 4 3 5 5 2 
90 2 6 4 3 4 6 4 3 4 3 5 5 2 
90 2 6 4 3 4 6 4 3 4 3 5 5 5 
90 2 6 4 3 4 6 4 3 4 3 5 5 6 
90 2 6 4 3 4 6 4 3 4 3 5 5 6 
90 2 6 4 3 4 6 4 3 4 3 5 5 5 
90 2 6 4 3 4 6 4 3 4 3 5 4 1 2 
90 2 6 4 3 4 6 4 3 4 3 5 5 2 
90 2 6 4 3 4 6 4 3 4 3 5 5 6 
90 2 6 4 3 4 6 4 3 4 3 5 1 1 2 
85 2 6 4 3 4 6 4 3 4 5 4 4 6 
75 2 6 4 3 4 6 4 3 4 6 1 5 
75 2 6 4 3 4 6 4 3 4 3 5 3 1 3 2 
70 2 6 4 3 4 6 4 3 4 3 5 3 4 2 
65 2 6 4 3 4 6 4 3 4 3 5 4 6 
-15 2 6 4 3 4 6 4 3 4 1 
-15 2 6 4 3 4 6 4 3 4 4 
-35 2 6 4 3 4 6 3 4 3 2 
-40 2 6 4 3 4 6 4 3 6 
-40 2 6 4 3 4 6 4 3 2 
-40 2 6 4 3 4 6 4 3 5 
-40 2 6 4 3 4 6 4 3 6 
-40 2 6 4 3 4 6 4 3 1 
-40 2 6 4 3 4 6 4 3 5 
-40 2 6 4 3 4 6 4 3 1 
-40 2 6 4 3 4 6 4 3 1 
-40 2 6 4 3 4 6 4 3 5 
-40 2 6 4 3 4 6 4 3 3 
-40 2 6 4 3 4 6 4 3 3 
-40 2 6 4 3 4 6 4 3 1 
-40 2 6 4 3 4 6 3 4 5 
-40 2 6 4 3 4 3 6 4 5 
-40 2 6 4 3 4 6 4 3 5 
-45 2 6 4 3 4 6 4 4 
-45 2 6 4 3 4 6 4 2 
-45 2 6 4 3 4 6 4 2 
-45 2 6 4 3 4 6 4 2 
-45 2 6 4 3 4 6 4 1 
-45 2 6 4 3 4 6 4 5 
-45 2 6 4 3 4 6 4 2 
-45 2 6 4 3 4 6 4 6 
-45 2 6 4 3 4 6 4 2 
-65 2 6 4 3 4 6 3 3 
-65 2 6 4 3 4 6 3 5 
-70 2 6 4 3 4 6 5 
-70 2 6 4 3 4 6 2 
-70 2 6 4 3 4 6 5 
-70 2 6 4 3 4 6 5 
-70 2 6 4 3 4 6 1 
-70 2 6 4 3 4 6 2 
-70 2 6 4 3 4 6 2 
-70 2 6 4 3 4 6 6 
-70 2 6 4 3 4 6 5 
-70 2 6 4 3 4 6 1 
-70 2 6 4 3 4 6 1 
-130 2 6 4 3 4 3 5 
-135 2 6 4 3 4 2 
-135 2 6 4 3 4 4 
-135 2 6 4 3 4 5 
-135 2 6 4 3 4 1 
-135 2 6 4 3 4 1 
-135 2 6 4 3 4 2 
-135 2 6 4 3 4 5 
-135 2 6 4 3 4 1 
-260 2 6 4 3 4 6 4 3 4 3 5 5 
-260 2 6 4 3 4 6 4 3 4 3 5 5 
-260 2 6 4 3 4 6 4 3 4 3 5 5 
-260 2 6 4 3 4 6 4 3 4 3 5 5 
-285 2 6 4 3 4 6 4 3 4 3 5 5 
-285 2 6 4 3 4 6 4 3 4 3 5 5 
-285 2 6 4 3 4 6 4 3 4 3 5 5 
-285 2 6 4 3 4 6 4 3 4 3 5 5 
-285 2 6 4 3 4 6 4 3 4 3 5 5 
-415 2 6 4 3 4 6 4 3 
-420 2 6 4 3 4 6 4 
-420 2 6 4 3 4 6 4 
-420 2 6 4 3 4 6 4 
-445 2 6 4 3 4 6 
-445 2 6 4 3 4 6 
-510 2 6 4 3 4 
-510 2 6 4 3 4 
-510 2 6 4 3 4 
-510 2 6 4 3 4 
