570 2 6 4 3 4 6 4 3 4 3 5 5 4 6 5 6 3 6 2 4 5 4 4 4 1 
550 2 6 4 3 4 6 4 3 4 3 5 5 4 6 5 6 5 2 3 6 5 1 3 2 
230 2 6 4 3 4 6 4 3 4 3 5 5 4 2 6 4 
230 2 6 4 3 4 6 4 3 4 3 5 5 4 6 5 3 
230 2 6 4 3 4 6 4 3 4 3 5 5 4 2 6 4 
230 2 6 4 3 4 6 4 3 4 3 5 6 5 4 5 1 
230 2 6 4 3 4 6 4 3 4 3 5 5 4 6 5 1 
220 2 6 4 3 4 6 4 3 4 3 5 5 4 2 3 5 4 
180 2 6 4 3 4 6 4 3 4 3 5 5 4 6 6 
180 2 6 4 3 4 6 4 3 4 3 5 5 4 6 1 
180 2 6 4 3 4 6 4 3 4 3 5 5 4 6 1 
180 2 6 4 3 4 6 4 3 4 3 5 5 4 6 4 
180 2 6 4 3 4 6 4 3 4 3 5 5 4 6 6 
180 2 6 4 3 4 6 4 3 4 3 5 5 4 6 3 
180 2 6 4 3 4 6 4 3 4 3 5 5 4 6 6 
180 2 6 4 3 4 6 4 3 4 3 5 5 4 6 2 
180 2 6 4 3 4 6 4 3 4 3 5 5 4 6 6 
180 2 6 4 3 4 6 4 3 4 3 5 5 4 6 4 
180 2 6 4 3 4 6 4 3 4 3 5 5 4 6 6 
180 2 6 4 3 4 6 4 3 4 3 5 5 4 6 4 
180 2 6 4 3 4 6 4 3 4 3 5 5 4 6 6 
180 2 6 4 3 4 6 4 3 4 3 5 5 4 6 6 
180 2 6 4 3 4 6 4 3 4 3 5 5 4 6 1 
180 2 6 4 3 4 6 4 3 4 3 5 5 4 6 2 
180 2 6 4 3 4 6 4 3 4 3 5 5 4 6 3 
180 2 6 4 3 4 6 4 3 4 3 5 2 4 6 4 
180 2 6 4 3 4 6 4 3 4 3 5 5 4 6 4 
180 2 6 4 3 4 6 4 3 4 3 5 5 4 6 3 
180 2 6 4 3 4 6 4 3 4 3 5 5 4 6 3 
180 2 6 4 3 4 6 4 3 4 3 5 5 4 6 2 
180 2 6 4 3 4 6 4 3 4 3 5 5 4 6 3 
170 2 6 4 3 4 6 4 3 4 3 5 6 6 1 
170 2 6 4 3 4 6 4 3 4 3 5 5 4 2 3 2 
170 2 6 4 3 4 6 4 3 4 3 5 6 6 2 
165 2 6 4 3 4 6 4 3 4 3 5 5 4 5 2 
165 2 6 4 3 4 6 4 3 4 3 5 5 4 5 5 
165 2 6 4 3 4 6 4 3 4 3 5 5 4 2 2 
160 2 6 4 3 4 6 4 3 4 3 5 6 5 3 1 
115 2 6 4 3 4 6 4 3 4 3 5 5 4 1 
115 2 6 4 3 4 6 4 3 4 3 5 5 4 4 
115 2 6 4 3 4 6 4 3 4 3 5 5 4 1 
115 2 6 4 3 4 6 4 3 4 3 5 5 4 1 
115 2 6 4 3 4 6 4 3 4 3 5 5 1 2 
115 2 6 4 3 4 6 4 3 4 3 5 5 4 3 
115 2 6 4 3 4 6 4 3 4 3 5 5 1 5 
115 2 6 4 3 4 6 4 3 4 3 5 5 4 3 
115 2 6 4 3 4 6 4 3 4 3 5 5 1 6 
115 2 6 4 3 4 6 4 3 4 3 5 5 4 3 
115 2 6 4 3 4 6 4 3 4 3 5 5 4 3 
115 2 6 4 3 4 6 4 3 4 3 5 5 1 5 
115 2 6 4 3 4 6 4 3 4 3 5 5 1 2 
115 2 6 4 3 4 6 4 3 4 3 5 5 4 3 
115 2 6 4 3 4 6 4 3 4 3 5 5 4 4 
115 2 6 4 3 4 6 4 3 4 3 5 2 1 4 
115 2 6 4 3 4 6 4 3 4 3 5 5 1 1 
115 2 6 4 3 4 6 4 3 4 3 5 5 4 3 
115 2 6 4 3 4 6 4 3 4 3 5 5 1 4 
115 2 6 4 3 4 6 4 3 4 3 5 5 1 1 
115 2 6 4 3 4 6 4 3 4 3 5 5 4 4 
115 2 6 4 3 4 6 4 3 4 3 5 4 4 1 2 
115 2 6 4 3 4 6 4 3 4 3 5 5 1 5 
115 2 6 4 3 4 6 4 3 4 3 5 5 4 1 
115 2 6 4 3 4 6 4 3 4 3 5 5 1 6 
115 2 6 4 3 4 6 4 3 4 3 5 4 1 4 5 
115 2 6 4 3 4 6 4 3 4 3 5 5 4 1 
115 2 6 4 3 4 6 4 3 4 3 5 4 5 1 
115 2 6 4 3 4 6 4 3 4 3 5 1 5 4 
115 2 6 4 3 4 6 4 3 4 3 5 5 4 4 
115 2 6 4 3 4 3 4 6 4 5 3 1 2 6 
115 2 6 4 3 4 6 4 3 4 3 5 5 4 2 1 
115 2 6 4 3 4 6 4 3 4 3 5 5 4 3 
105 2 6 4 3 4 6 4 3 4 3 5 6 4 
105 2 6 4 3 4 6 4 3 4 3 5 6 4 
105 2 6 4 3 4 6 4 3 4 3 5 6 4 
105 2 6 4 3 4 6 4 3 4 3 5 6 3 
105 2 6 4 3 4 6 4 3 4 3 5 6 6 
105 2 6 4 3 4 6 4 3 4 3 6 2 4 
100 2 6 4 3 4 6 4 3 4 3 5 5 3 3 5 
100 2 6 4 3 4 6 4 3 4 3 5 1 3 1 3 5 
100 2 6 4 3 4 6 4 3 4 3 5 3 3 5 2 
100 2 6 4 3 4 6 4 3 4 3 5 3 4 3 1 5 
100 2 6 4 3 4 6 4 3 4 6 4 4 4 
95 2 6 4 3 4 6 4 3 4 3 5 5 3 6 
95 2 6 4 3 4 6 4 3 4 3 5 5 3 6 
95 2 6 4 3 4 6 4 3 4 3 5 5 3 4 
95 2 6 4 3 4 6 4 3 4 3 5 5 3 2 
95 2 6 4 3 4 6 4 3 4 3 5 3 1 4 4 
95 2 6 4 3 4 6 4 3 4 3 5 3 1 4 4 
95 2 6 4 3 4 6 4 3 4 3 5 5 3 1 
95 2 6 4 3 4 6 4 3 4 3 5 3 2 4 
90 2 6 4 3 4 6 4 3 4 3 5 5 6 
90 2 6 4 3 4 6 4 3 4 3 5 5 2 
90 2 6 4 3 4 6 4 3 4 3 5 5 6 
90 2 6 4 3 4 6 4 3 4 3 5 5 2 
90 2 6 4 3 4 6 4 3 4 3 5 5 5 
90 2 6 4 3 4 6 4 3 4 3 5 2 5 
90 2 6 4 3 4 6 4 3 4 3 5 5 5 
90 2 6 4 3 4 6 4 3 4 3 5 2 6 
90 2 6 4 3 4 6 4 3 4 3 5 1 1 5 
90 2 6 4 3 4 6 4 3 4 3 5 5 5 
90 2 6 4 3 4 6 4 3 4 3 5 5 6 
90 2 6 4 3 4 6 4 3 4 3 5 4 4 5 
90 2 6 4 3 4 6 4 3 4 3 5 5 5 
90 2 6 4 3 4 6 4 3 4 3 5 5 6 
85 2 6 4 3 4 6 4 3 4 5 4 4 6 
70 2 6 4 3 4 6 4 3 4 3 5 1 3 6 
65 2 6 4 3 4 6 4 3 4 3 5 1 6 
-10 2 6 4 3 4 6 4 3 4 3 1 
-10 2 6 4 3 4 6 4 3 4 3 4 
-10 2 6 4 3 4 6 4 3 4 3 4 
-10 2 6 4 3 4 6 4 3 4 3 2 
-10 2 6 4 3 4 6 4 3 4 3 4 
-15 2 6 4 3 4 6 4 3 4 2 
-40 2 6 4 3 4 6 3 4 4 
-45 2 6 4 3 4 6 4 2 
-195 2 6 4 3 4 6 4 3 4 3 5 5 4 6 
-195 2 6 4 3 4 6 4 3 4 3 5 5 4 6 
-195 2 6 4 3 4 6 4 3 4 3 5 5 4 6 
-195 2 6 4 3 4 6 4 3 4 3 5 5 4 6 
-260 2 6 4 3 4 6 4 3 4 3 5 5 4 
-260 2 6 4 3 4 6 4 3 4 3 5 5 4 
-260 2 6 4 3 4 6 4 3 4 3 5 5 4 
-260 2 6 4 3 4 6 4 3 4 3 5 5 4 
-285 2 6 4 3 4 6 4 3 4 3 5 5 
-285 2 6 4 3 4 6 4 3 4 3 5 5 
-285 2 6 4 3 4 6 4 3 4 3 5 5 
-285 2 6 4 3 4 6 4 3 4 3 5 5 
-420 2 6 4 3 4 6 4 
