125 5 5 1 4 3 4 6 4 3 4 5 1 5 1 
110 5 5 1 4 3 4 6 4 3 4 6 5 5 
0 5 5 1 4 3 4 6 4 3 4 3 2 
0 5 5 1 4 3 4 6 4 3 4 3 2 
0 5 5 1 4 3 4 6 4 3 4 3 3 
-5 5 5 1 4 3 4 6 4 3 4 4 
-5 5 5 1 4 3 4 6 4 3 4 2 
-5 5 5 1 4 3 4 6 4 3 4 4 
-5 5 5 1 4 3 4 6 4 3 4 1 
-5 5 5 1 4 3 4 6 4 3 4 1 
-5 5 5 1 4 3 4 6 4 3 4 4 
-5 5 5 1 4 3 4 6 4 3 4 2 
-30 5 5 1 4 3 4 6 4 3 3 
-30 5 5 1 4 3 4 6 4 3 5 
-35 5 5 1 4 3 4 6 4 5 
-35 5 5 1 4 3 4 6 4 5 
-35 5 5 1 4 3 4 6 4 2 
-35 5 5 1 4 3 4 6 4 4 
-35 5 5 1 4 3 4 6 4 2 
-55 5 5 1 4 3 4 6 3 5 
-55 5 5 1 4 3 4 6 3 5 
-55 5 5 1 4 3 4 6 3 6 
-60 5 5 1 4 3 4 6 1 
-125 5 5 1 4 3 4 1 
-125 5 5 1 4 3 4 2 
-125 5 5 1 4 3 4 5 
-150 5 5 1 4 3 3 
-410 5 5 1 4 3 4 6 
-435 5 5 1 4 3 4 
-495 5 5 1 4 3 4 
