230 5 5 1 4 3 4 6 4 3 4 5 3 6 5 3 5 3 4 
185 5 5 1 4 3 4 6 4 3 4 5 1 5 6 2 
185 5 5 1 4 3 4 6 4 3 4 5 1 5 6 6 
175 5 5 1 4 3 4 6 4 3 4 5 6 6 4 
125 5 5 1 4 3 4 6 4 3 4 5 1 5 3 6 
125 5 5 1 4 3 4 6 4 3 4 5 3 4 5 2 
125 5 5 1 4 3 4 6 4 3 4 5 1 2 3 4 
120 5 5 1 4 3 4 6 4 3 4 5 5 4 5 
120 5 5 1 4 3 4 6 4 3 4 5 1 1 4 3 
105 5 5 1 4 3 4 6 4 3 4 5 1 3 3 1 1 
100 5 5 1 4 3 4 6 4 3 4 5 5 3 5 
100 5 5 1 4 3 4 6 4 3 4 5 1 3 4 5 
100 5 5 1 4 3 4 6 4 3 4 5 1 3 4 2 
100 5 5 1 4 3 4 6 4 3 4 5 1 4 3 2 
95 5 5 1 4 3 4 6 4 3 4 5 2 2 
95 5 5 1 4 3 4 6 4 3 4 5 5 6 
60 5 5 1 4 3 4 6 4 3 4 6 6 
0 5 5 1 4 3 4 6 4 3 4 3 2 
-5 5 5 1 4 3 4 6 4 3 4 1 
-5 5 5 1 4 3 4 6 4 3 4 4 
-30 5 5 1 4 3 4 6 4 3 2 
-30 5 5 1 4 3 4 6 4 3 2 
-30 5 5 1 4 3 4 6 4 3 6 
-30 5 5 1 4 3 4 6 4 3 5 
-35 5 5 1 4 3 4 6 4 5 
-35 5 5 1 4 3 4 6 4 1 
-55 5 5 1 4 3 4 6 3 6 
-265 5 5 1 4 3 4 6 4 3 4 6 
-375 5 5 1 4 3 4 6 4 3 4 
-405 5 5 1 4 3 4 6 4 
