230 2 6 4 3 4 6 4 3 4 3 5 5 4 6 5 6 3 6 2 4 5 4 4 
230 2 6 4 3 4 6 4 3 4 3 5 5 4 6 5 6 3 6 2 4 5 4 4 4 
230 2 6 4 3 4 6 4 3 4 3 5 5 4 6 5 6 3 6 2 4 5 4 6 
230 2 6 4 3 4 6 4 3 4 3 5 5 4 6 5 6 3 6 2 4 5 4 4 4 3 
230 2 6 4 3 4 6 4 3 4 3 5 5 4 6 5 6 3 6 2 4 5 4 2 
230 2 6 4 3 4 6 4 3 4 3 5 5 4 6 5 6 3 6 2 4 5 4 4 4 
230 2 6 4 3 4 6 4 3 4 3 5 5 4 6 5 6 3 6 2 4 5 4 4 4 5 
230 2 6 4 3 4 6 4 3 4 3 5 5 4 6 5 6 3 6 2 4 5 4 2 
230 2 6 4 3 4 6 4 3 4 3 5 5 4 6 5 6 3 6 2 4 5 4 4 4 6 
230 2 6 4 3 4 6 4 3 4 3 5 5 4 6 5 6 3 6 2 4 5 4 4 5 
230 2 6 4 3 4 6 4 3 4 3 5 5 4 6 5 6 3 6 2 4 5 4 2 
230 2 6 4 3 4 6 4 3 4 3 5 5 4 6 5 6 3 6 2 4 5 4 4 4 5 
230 2 6 4 3 4 6 4 3 4 3 5 5 4 6 5 6 3 6 2 4 5 4 4 4 5 
230 2 6 4 3 4 6 4 3 4 3 5 5 4 6 5 6 3 6 2 4 5 4 4 4 4 
230 2 6 4 3 4 6 4 3 4 3 5 5 4 6 5 6 3 6 2 4 5 4 4 6 
230 2 6 4 3 4 6 4 3 4 3 5 5 4 6 5 6 3 6 2 4 5 4 4 2 
230 2 6 4 3 4 6 4 3 4 3 5 5 4 6 5 6 3 6 2 4 5 4 1 
230 2 6 4 3 4 6 4 3 4 3 5 5 4 6 5 6 3 6 2 4 5 4 2 
230 2 6 4 3 4 6 4 3 4 3 5 5 4 6 5 6 3 6 2 4 5 4 4 4 6 
230 2 6 4 3 4 6 4 3 4 3 5 5 4 6 5 6 3 6 2 4 5 4 4 4 4 
230 2 6 4 3 4 6 4 3 4 3 5 5 4 6 5 6 3 6 2 4 5 4 4 
230 2 6 4 3 4 6 4 3 4 3 5 5 4 6 5 6 3 6 2 4 5 4 4 4 6 
230 2 6 4 3 4 6 4 3 4 3 5 5 4 6 5 6 3 6 2 4 5 4 5 
230 2 6 4 3 4 6 4 3 4 3 5 5 4 6 5 6 3 6 2 4 5 4 4 4 6 
230 2 6 4 3 4 6 4 3 4 3 5 5 4 6 5 6 3 6 2 4 5 4 4 2 
230 2 6 4 3 4 6 4 3 4 3 5 5 4 6 5 6 3 6 2 4 5 4 3 
230 2 6 4 3 4 6 4 3 4 3 5 5 4 6 5 6 3 6 2 4 5 4 4 3 
230 2 6 4 3 4 6 4 3 4 3 5 5 4 6 5 6 3 6 2 4 5 4 6 
230 2 6 4 3 4 6 4 3 4 3 5 5 4 6 5 6 3 6 2 4 5 4 4 4 2 
230 2 6 4 3 4 6 4 3 4 3 5 5 4 6 5 6 3 6 2 4 5 4 4 2 
230 2 6 4 3 4 6 4 3 4 3 5 5 4 6 5 6 3 6 2 4 5 4 5 
230 2 6 4 3 4 6 4 3 4 3 5 5 4 6 5 6 3 6 2 4 5 4 2 
230 2 6 4 3 4 6 4 3 4 3 5 5 4 6 5 6 3 6 2 4 5 4 4 2 
230 2 6 4 3 4 6 4 3 4 3 5 5 4 6 5 6 3 6 2 4 5 4 4 4 6 
230 2 6 4 3 4 6 4 3 4 3 5 5 4 6 5 6 3 6 2 4 5 4 4 4 
230 2 6 4 3 4 6 4 3 4 3 5 5 4 6 5 6 3 6 2 4 5 4 4 1 
230 2 6 4 3 4 6 4 3 4 3 5 5 4 6 5 6 3 6 2 4 5 4 1 
230 2 6 4 3 4 6 4 3 4 3 5 5 4 6 5 6 3 6 2 4 5 4 4 4 5 
230 2 6 4 3 4 6 4 3 4 3 5 5 4 6 5 6 3 6 2 4 5 4 3 
230 2 6 4 3 4 6 4 3 4 3 5 5 4 6 5 6 3 6 2 4 5 4 6 
230 2 6 4 3 4 6 4 3 4 3 5 5 4 6 5 6 3 6 2 4 5 4 2 
230 2 6 4 3 4 6 4 3 4 3 5 5 4 6 5 6 3 6 2 4 5 4 4 5 
230 2 6 4 3 4 6 4 3 4 3 5 5 4 6 5 6 3 6 2 4 5 4 1 
230 2 6 4 3 4 6 4 3 4 3 5 5 4 6 5 6 3 6 2 4 5 4 1 
230 2 6 4 3 4 6 4 3 4 3 5 5 4 6 5 6 3 6 2 4 5 4 4 5 
230 2 6 4 3 4 6 4 3 4 3 5 5 4 6 5 6 3 6 2 4 5 4 4 1 
230 2 6 4 3 4 6 4 3 4 3 5 5 4 6 5 4 
230 2 6 4 3 4 6 4 3 4 3 5 5 4 6 5 6 
180 2 6 4 3 4 6 4 3 4 3 5 5 4 6 3 
180 2 6 4 3 4 6 4 3 4 3 5 5 4 6 1 
180 2 6 4 3 4 6 4 3 4 3 5 5 4 6 2 
180 2 6 4 3 4 6 4 3 4 3 5 4 1 4 6 3 
115 2 6 4 3 4 6 4 3 4 3 5 5 4 2 
115 2 6 4 3 4 6 4 3 4 3 5 5 4 5 
115 2 6 4 3 4 6 4 3 4 3 5 5 4 1 
115 2 6 4 3 4 6 4 3 4 3 5 1 5 1 
115 2 6 4 3 4 6 4 3 4 3 5 5 4 2 5 
115 2 6 4 3 4 6 4 3 4 3 5 5 1 2 
115 2 6 4 3 4 6 4 3 4 3 5 5 4 2 
115 2 6 4 3 4 6 4 3 4 3 5 5 4 3 
115 2 6 4 3 4 6 4 3 4 3 5 5 4 6 
115 2 6 4 3 4 6 4 3 4 3 5 5 4 1 
115 2 6 4 3 4 6 4 3 4 3 5 5 4 3 
115 2 6 4 3 4 6 4 3 4 3 5 5 4 2 
115 2 6 4 3 4 6 4 3 4 3 5 2 1 6 
115 2 6 4 3 4 6 4 3 4 3 5 5 4 1 
115 2 6 4 3 4 6 4 3 4 3 5 5 4 3 
115 2 6 4 3 4 6 4 3 4 3 5 5 4 5 
115 2 6 4 3 4 6 4 3 4 3 5 5 4 2 2 
115 2 6 4 3 4 6 4 3 4 3 5 4 2 3 
115 2 6 4 3 4 6 4 3 4 3 5 5 4 4 
115 2 6 4 3 4 6 4 3 4 3 5 4 5 3 
115 2 6 4 3 4 6 4 3 4 3 5 4 5 1 
115 2 6 4 3 4 6 4 3 4 3 5 5 4 6 
115 2 6 4 3 4 6 4 3 4 3 5 5 4 5 
115 2 6 4 3 4 6 4 3 4 3 5 4 4 1 4 
115 2 6 4 3 4 6 4 3 4 3 5 1 2 1 
115 2 6 4 3 4 6 4 3 4 3 5 5 4 3 
110 2 6 4 3 4 6 4 3 4 3 5 5 3 3 3 1 
110 2 6 4 3 4 6 4 3 4 3 5 5 3 3 3 2 
110 2 6 4 3 4 6 4 3 4 3 5 5 3 3 3 5 
105 2 6 4 3 4 6 4 3 4 3 5 6 5 4 4 
105 2 6 4 3 4 6 4 3 4 3 5 6 5 3 4 
105 2 6 4 3 4 6 4 3 4 3 5 6 5 
105 2 6 4 3 4 6 4 3 4 3 5 3 3 5 5 
100 2 6 4 3 4 6 4 3 4 3 5 3 1 4 6 
100 2 6 4 3 4 6 4 3 4 3 5 5 3 3 1 
95 2 6 4 3 4 6 4 3 4 3 5 2 3 1 
95 2 6 4 3 4 6 4 3 4 3 5 5 3 6 
95 2 6 4 3 4 6 4 3 4 3 5 5 3 6 
90 2 6 4 3 4 6 4 3 4 3 5 5 6 
90 2 6 4 3 4 6 4 3 4 3 5 5 2 
90 2 6 4 3 4 6 4 3 4 3 5 5 6 
90 2 6 4 3 4 6 4 3 4 3 5 5 2 
90 2 6 4 3 4 6 4 3 4 3 5 1 4 5 
90 2 6 4 3 4 6 4 3 4 3 5 1 4 6 
90 2 6 4 3 4 6 4 3 4 3 5 5 6 
90 2 6 4 3 4 6 4 3 4 3 5 2 2 
-145 2 6 4 3 4 6 4 3 4 3 5 5 4 6 5 6 3 6 2 4 5 4 4 
-145 2 6 4 3 4 6 4 3 4 3 5 5 4 6 5 6 3 6 2 4 5 4 4 
-145 2 6 4 3 4 6 4 3 4 3 5 5 4 6 5 6 3 6 2 4 5 4 
-145 2 6 4 3 4 6 4 3 4 3 5 5 4 6 5 6 3 6 2 4 5 4 4 
-145 2 6 4 3 4 6 4 3 4 3 5 5 4 6 5 6 3 6 2 4 5 4 4 
-145 2 6 4 3 4 6 4 3 4 3 5 5 4 6 5 6 3 6 2 4 5 4 4 
-145 2 6 4 3 4 6 4 3 4 3 5 5 4 6 5 6 3 6 2 4 5 4 4 4 4 4 6 
-145 2 6 4 3 4 6 4 3 4 3 5 5 4 6 5 6 3 6 2 4 5 4 
-145 2 6 4 3 4 6 4 3 4 3 5 5 4 6 5 6 3 6 2 4 5 4 4 
-145 2 6 4 3 4 6 4 3 4 3 5 5 4 6 5 6 3 6 2 4 5 4 4 
-145 2 6 4 3 4 6 4 3 4 3 5 5 4 6 5 6 3 6 2 4 5 4 4 
-145 2 6 4 3 4 6 4 3 4 3 5 5 4 6 5 6 3 6 2 4 5 4 4 
-145 2 6 4 3 4 6 4 3 4 3 5 5 4 6 5 6 3 6 2 4 5 4 4 
-145 2 6 4 3 4 6 4 3 4 3 5 5 4 6 5 6 3 6 2 4 5 4 
-145 2 6 4 3 4 6 4 3 4 3 5 5 4 6 5 6 3 6 2 4 5 4 
-145 2 6 4 3 4 6 4 3 4 3 5 5 4 6 5 6 3 6 2 4 5 4 
-145 2 6 4 3 4 6 4 3 4 3 5 5 4 6 5 6 3 6 2 4 5 4 4 
-145 2 6 4 3 4 6 4 3 4 3 5 5 4 6 5 6 3 6 2 4 5 4 4 
-145 2 6 4 3 4 6 4 3 4 3 5 5 4 6 5 6 3 6 2 4 5 4 4 
-195 2 6 4 3 4 6 4 3 4 3 5 5 4 6 
-195 2 6 4 3 4 6 4 3 4 3 5 5 4 6 
-195 2 6 4 3 4 6 4 3 4 3 5 5 4 6 
-215 2 6 4 3 4 6 4 3 4 3 5 5 4 6 5 6 5 2 3 6 5 2 5 4 
-260 2 6 4 3 4 6 4 3 4 3 5 5 4 
-260 2 6 4 3 4 6 4 3 4 3 5 5 4 
-260 2 6 4 3 4 6 4 3 4 3 5 5 4 
-260 2 6 4 3 4 6 4 3 4 3 5 5 4 
-260 2 6 4 3 4 6 4 3 4 3 5 5 1 
-285 2 6 4 3 4 6 4 3 4 3 5 5 
-390 2 6 4 3 4 3 4 6 4 5 3 
