999999 2 6 4 3 4 6 4 3 4 3 5 5 4 6 5 6 3 6 2 4 5 1 1 6 5 5 3 3 
999994 2 6 4 3 4 6 4 3 4 3 5 5 4 6 5 6 3 6 2 4 5 4 4 5 6 4 2 
999994 2 6 4 3 4 6 4 3 4 3 5 5 4 6 5 6 3 6 2 4 5 4 4 1 3 6 6 
999994 2 6 4 3 4 6 4 3 4 3 5 5 4 6 5 6 3 6 2 4 5 4 5 4 6 6 
999994 2 6 4 3 4 6 4 3 4 3 5 5 4 6 5 6 3 6 2 4 5 4 2 4 6 5 
999994 2 6 4 3 4 6 4 3 4 3 5 5 4 6 5 6 3 6 2 4 5 4 6 3 3 5 5 6 
999994 2 6 4 3 4 6 4 3 4 3 5 5 4 6 5 6 3 6 2 4 5 4 6 6 6 
999994 2 6 4 3 4 6 4 3 4 3 5 5 4 6 5 6 3 6 2 4 5 4 6 6 4 4 5 
755 2 6 4 3 4 6 4 3 4 3 5 5 4 6 5 6 3 6 2 4 5 4 4 5 6 2 
735 2 6 4 3 4 6 4 3 4 3 5 5 4 6 5 6 3 6 2 4 5 4 4 4 3 6 1 
735 2 6 4 3 4 6 4 3 4 3 5 5 4 6 5 6 3 6 2 4 5 4 3 6 5 4 
695 2 6 4 3 4 6 4 3 4 3 5 5 4 6 5 6 3 6 2 4 5 4 1 5 3 6 
695 2 6 4 3 4 6 4 3 4 3 5 5 4 6 5 6 3 6 2 4 5 4 4 5 3 6 
690 2 6 4 3 4 6 4 3 4 3 5 5 4 6 5 6 3 6 2 4 5 4 3 3 6 6 
685 2 6 4 3 4 6 4 3 4 3 5 5 4 6 5 6 3 6 2 4 5 4 6 3 6 
685 2 6 4 3 4 6 4 3 4 3 5 5 4 6 5 6 3 6 2 4 5 4 3 6 6 
600 2 6 4 3 4 6 4 3 4 3 5 5 4 6 5 6 3 6 2 4 5 5 5 3 3 1 
600 2 6 4 3 4 6 4 3 4 3 5 5 4 6 5 6 3 6 2 4 5 4 4 3 5 3 4 
595 2 6 4 3 4 6 4 3 4 3 5 5 4 6 5 6 3 6 2 4 5 1 3 5 1 2 
590 2 6 4 3 4 6 4 3 4 3 5 5 4 6 5 6 3 6 2 4 5 4 4 5 2 
590 2 6 4 3 4 6 4 3 4 3 5 5 4 6 5 6 3 6 2 4 5 4 4 5 1 
590 2 6 4 3 4 6 4 3 4 3 5 5 4 6 5 6 3 6 2 4 5 4 4 5 1 
590 2 6 4 3 4 6 4 3 4 3 5 5 4 6 5 6 3 6 2 4 5 5 5 2 
590 2 6 4 3 4 6 4 3 4 3 5 5 4 6 5 6 3 6 2 4 5 4 1 1 4 1 
590 2 6 4 3 4 6 4 3 4 3 5 5 4 6 5 6 3 6 2 4 5 4 4 5 5 
590 2 6 4 3 4 6 4 3 4 3 5 5 4 6 5 6 3 6 2 4 5 4 4 5 4 
590 2 6 4 3 4 6 4 3 4 3 5 5 4 6 5 6 3 6 2 4 5 4 5 4 4 
590 2 6 4 3 4 6 4 3 4 3 5 5 4 6 5 6 3 6 2 4 5 4 4 5 2 
590 2 6 4 3 4 6 4 3 4 3 5 5 4 6 5 6 3 6 2 4 5 4 4 5 4 
590 2 6 4 3 4 6 4 3 4 3 5 5 4 6 5 6 3 6 2 4 5 4 1 5 4 
590 2 6 4 3 4 6 4 3 4 3 5 5 4 6 5 6 3 6 2 4 5 4 3 6 3 2 
590 2 6 4 3 4 6 4 3 4 3 5 5 4 6 5 6 3 6 2 4 5 4 1 4 4 1 
590 2 6 4 3 4 6 4 3 4 3 5 5 4 6 5 6 3 6 2 4 5 4 4 5 5 
590 2 6 4 3 4 6 4 3 4 3 5 5 4 6 5 6 3 6 2 4 5 4 5 4 5 
590 2 6 4 3 4 6 4 3 4 3 5 5 4 6 5 6 3 6 2 4 5 4 5 4 1 
590 2 6 4 3 4 6 4 3 4 3 5 5 4 6 5 6 3 6 2 4 5 4 1 5 4 
585 2 6 4 3 4 6 4 3 4 3 5 5 4 6 5 6 3 6 2 4 5 6 4 3 2 
580 2 6 4 3 4 6 4 3 4 3 5 5 4 6 5 6 3 6 2 4 5 4 5 3 3 3 2 
580 2 6 4 3 4 6 4 3 4 3 5 5 4 6 5 6 3 6 2 4 5 4 6 2 
580 2 6 4 3 4 6 4 3 4 3 5 5 4 6 5 6 3 6 2 4 5 4 1 3 3 3 1 1 
580 2 6 4 3 4 6 4 3 4 3 5 5 4 6 5 6 3 6 2 4 5 4 6 4 
580 2 6 4 3 4 6 4 3 4 3 5 5 4 6 5 6 3 6 2 4 5 3 5 4 3 3 1 
580 2 6 4 3 4 6 4 3 4 3 5 5 4 6 5 6 3 6 2 4 5 1 6 1 
580 2 6 4 3 4 6 4 3 4 3 5 5 4 6 5 6 3 6 2 4 5 4 6 4 
570 2 6 4 3 4 6 4 3 4 3 5 5 4 6 5 6 3 6 2 4 5 2 4 3 2 
570 2 6 4 3 4 6 4 3 4 3 5 5 4 6 5 6 3 6 2 4 5 4 4 4 3 2 
570 2 6 4 3 4 6 4 3 4 3 5 5 4 6 5 6 3 6 2 4 5 4 3 5 5 
565 2 6 4 3 4 6 4 3 4 3 5 5 4 6 5 6 3 6 2 4 5 4 5 6 
565 2 6 4 3 4 6 4 3 4 3 5 5 4 6 5 6 3 6 2 4 5 5 1 6 
565 2 6 4 3 4 6 4 3 4 3 5 5 4 6 5 6 3 6 2 4 5 4 5 1 
565 2 6 4 3 4 6 4 3 4 3 5 5 4 6 5 6 3 6 2 4 5 4 5 6 
565 2 6 4 3 4 6 4 3 4 3 5 5 4 6 5 6 3 6 2 4 5 4 4 1 5 
565 2 6 4 3 4 6 4 3 4 3 5 5 4 6 5 6 3 6 2 4 5 1 5 5 
565 2 6 4 3 4 6 4 3 4 3 5 5 4 6 5 6 3 6 2 4 5 2 1 2 
565 2 6 4 3 4 6 4 3 4 3 5 5 4 6 5 6 3 6 2 4 5 4 2 2 
565 2 6 4 3 4 6 4 3 4 3 5 5 4 6 5 6 3 6 2 4 5 4 4 4 6 
565 2 6 4 3 4 6 4 3 4 3 5 5 4 6 5 6 3 6 2 4 5 4 2 2 
565 2 6 4 3 4 6 4 3 4 3 5 5 4 6 5 6 3 6 2 4 5 4 1 1 2 
565 2 6 4 3 4 6 4 3 4 3 5 5 4 6 5 6 3 6 2 4 5 2 1 6 
565 2 6 4 3 4 6 4 3 4 3 5 5 4 6 5 6 3 6 2 4 5 4 4 4 6 
565 2 6 4 3 4 6 4 3 4 3 5 5 4 6 5 6 3 6 2 4 5 1 2 2 
565 2 6 4 3 4 6 4 3 4 3 5 5 4 6 5 6 3 6 2 4 5 1 2 2 
565 2 6 4 3 4 6 4 3 4 3 5 5 4 6 5 6 3 6 2 4 5 4 5 1 
565 2 6 4 3 4 6 4 3 4 3 5 5 4 6 5 6 3 6 2 4 5 4 2 6 
565 2 6 4 3 4 6 4 3 4 3 5 5 4 6 5 6 3 6 2 4 5 4 4 1 5 
565 2 6 4 3 4 6 4 3 4 3 5 5 4 6 5 6 3 6 2 4 5 4 1 4 1 
565 2 6 4 3 4 6 4 3 4 3 5 5 4 6 5 6 3 6 2 4 5 4 5 1 
565 2 6 4 3 4 6 4 3 4 3 5 5 4 6 5 6 3 6 2 4 5 4 4 4 2 
565 2 6 4 3 4 6 4 3 4 3 5 5 4 6 5 6 3 6 2 4 5 1 2 5 
555 2 6 4 3 4 6 4 3 4 3 5 5 4 6 5 6 3 6 2 4 5 6 1 
555 2 6 4 3 4 6 4 3 4 3 5 5 4 6 5 6 3 6 2 4 6 2 1 
555 2 6 4 3 4 6 4 3 4 3 5 5 4 6 5 6 3 6 2 4 5 6 2 
555 2 6 4 3 4 6 4 3 4 3 5 5 4 6 5 6 3 6 2 4 5 6 5 
555 2 6 4 3 4 6 4 3 4 3 5 5 4 6 5 6 3 6 2 4 5 6 5 
555 2 6 4 3 4 6 4 3 4 3 5 5 4 6 5 6 3 6 2 4 5 6 6 
550 2 6 4 3 4 6 4 3 4 3 5 5 4 6 5 6 3 6 2 4 5 4 1 3 3 6 
550 2 6 4 3 4 6 4 3 4 3 5 5 4 6 5 6 3 6 2 4 5 5 3 3 6 
545 2 6 4 3 4 6 4 3 4 3 5 5 4 6 5 6 3 6 2 4 5 4 4 3 1 
545 2 6 4 3 4 6 4 3 4 3 5 5 4 6 5 6 3 6 2 4 5 4 4 3 6 
545 2 6 4 3 4 6 4 3 4 3 5 5 4 6 5 6 3 6 2 4 5 4 3 1 1 
545 2 6 4 3 4 6 4 3 4 3 5 5 4 6 5 6 3 6 2 4 5 4 4 3 1 
545 2 6 4 3 4 6 4 3 4 3 5 5 4 6 5 6 3 6 2 4 5 4 4 3 6 
545 2 6 4 3 4 6 4 3 4 3 5 5 4 6 5 6 3 6 2 4 5 4 3 1 6 
545 2 6 4 3 4 6 4 3 4 3 5 5 4 6 5 6 3 6 2 4 5 4 3 4 1 
545 2 6 4 3 4 6 4 3 4 3 5 5 4 6 5 6 3 6 2 4 5 4 4 3 6 
545 2 6 4 3 4 6 4 3 4 3 5 5 4 6 5 6 3 6 2 4 5 4 3 4 6 
540 2 6 4 3 4 6 4 3 4 3 5 5 4 6 5 6 3 6 2 4 5 4 4 6 
540 2 6 4 3 4 6 4 3 4 3 5 5 4 6 5 6 3 6 2 4 5 4 4 6 
540 2 6 4 3 4 6 4 3 4 3 5 5 4 6 5 6 3 6 2 4 5 4 4 6 
540 2 6 4 3 4 6 4 3 4 3 5 5 4 6 5 6 3 6 2 4 5 4 4 2 
540 2 6 4 3 4 6 4 3 4 3 5 5 4 6 5 6 3 6 2 4 5 2 2 
540 2 6 4 3 4 6 4 3 4 3 5 5 4 6 5 6 3 6 2 4 5 4 1 2 
540 2 6 4 3 4 6 4 3 4 3 5 5 4 6 5 6 3 6 2 4 5 4 4 2 
540 2 6 4 3 4 6 4 3 4 3 5 5 4 6 5 6 3 6 2 4 5 4 4 2 
540 2 6 4 3 4 6 4 3 4 3 5 5 4 6 5 6 3 6 2 4 5 5 2 
540 2 6 4 3 4 6 4 3 4 3 5 5 4 6 5 6 3 6 2 4 5 4 4 2 
540 2 6 4 3 4 6 4 3 4 3 5 5 4 6 5 6 3 6 2 4 5 4 4 2 
540 2 6 4 3 4 6 4 3 4 3 5 5 4 6 5 6 3 6 2 4 5 2 2 
540 2 6 4 3 4 6 4 3 4 3 5 5 4 6 5 6 3 6 2 4 5 4 4 2 
540 2 6 4 3 4 6 4 3 4 3 5 5 4 6 5 6 3 6 2 4 5 4 4 6 
540 2 6 4 3 4 6 4 3 4 3 5 5 4 6 5 6 3 6 2 4 5 4 4 2 
540 2 6 4 3 4 6 4 3 4 3 5 5 4 6 5 6 3 6 2 4 5 5 2 
525 2 6 4 3 4 6 4 3 4 3 5 5 4 6 5 6 3 6 2 4 5 3 3 1 2 
520 2 6 4 3 4 6 4 3 4 3 5 5 4 6 5 6 3 6 2 4 5 4 3 2 
520 2 6 4 3 4 6 4 3 4 3 5 5 4 6 5 6 3 6 2 4 5 3 4 2 
520 2 6 4 3 4 6 4 3 4 3 5 5 4 6 5 5 4 2 6 6 
440 2 6 4 3 4 6 4 3 4 3 5 5 4 6 5 6 3 6 2 4 3 
410 2 6 4 3 4 6 4 3 4 3 5 5 4 6 5 6 6 4 1 5 
230 2 6 4 3 4 6 4 3 4 3 5 5 4 6 5 1 
190 2 6 4 3 4 6 4 3 4 3 5 5 4 6 5 6 3 6 2 4 5 4 4 
180 2 6 4 3 4 6 4 3 4 3 5 5 4 6 3 
170 2 6 4 3 4 6 4 3 4 3 5 5 4 2 3 2 
165 2 6 4 3 4 6 4 3 4 3 5 5 4 6 5 6 3 6 2 4 5 4 4 
115 2 6 4 3 4 6 4 3 4 3 5 1 2 2 
115 2 6 4 3 4 6 4 3 4 3 5 5 4 1 
115 2 6 4 3 4 6 4 3 4 3 5 5 4 5 
115 2 6 4 3 4 6 4 3 4 3 5 4 5 4 
95 2 6 4 3 4 6 4 3 4 3 5 3 5 4 
90 2 6 4 3 4 6 4 3 4 3 5 5 5 
90 2 6 4 3 4 6 4 3 4 3 5 4 1 5 
90 2 6 4 3 4 6 4 3 4 3 5 5 6 
70 2 6 4 3 4 6 4 3 4 3 5 4 3 6 
65 2 6 4 3 4 6 4 3 4 3 5 5 4 6 5 6 3 6 2 4 
65 2 6 4 3 4 6 4 3 4 3 5 5 4 6 5 6 3 6 2 4 
65 2 6 4 3 4 6 4 3 4 3 5 4 6 
45 2 6 4 3 4 6 4 3 4 3 5 3 6 
-260 2 6 4 3 4 6 4 3 4 3 5 5 4 
-260 2 6 4 3 4 6 4 3 4 3 5 4 4 1 
