515 5 5 1 4 3 4 6 4 3 4 5 3 6 5 3 5 2 3 6 1 5 5 
435 5 5 1 4 3 4 6 4 3 4 5 3 6 5 3 5 6 2 5 5 2 
400 5 5 1 4 3 4 6 4 3 4 5 3 6 5 3 5 3 2 6 2 6 4 
225 5 5 1 4 3 4 6 4 3 4 5 3 6 5 3 5 3 4 
220 5 5 1 4 3 4 6 4 3 4 5 3 6 5 3 5 4 
220 5 5 1 4 3 4 6 4 3 4 5 3 6 5 3 5 1 
220 5 5 1 4 3 4 6 4 3 4 5 3 6 5 3 5 4 
175 5 5 1 4 3 4 6 4 3 4 5 3 6 5 3 3 6 
175 5 5 1 4 3 4 6 4 3 4 5 3 6 5 3 3 2 
170 5 5 1 4 3 4 6 4 3 4 5 3 6 5 3 6 
170 5 5 1 4 3 4 6 4 3 4 5 3 6 5 3 6 
125 5 5 1 4 3 4 6 4 3 4 5 1 5 3 5 
120 5 5 1 4 3 4 6 4 3 4 5 1 5 2 
120 5 5 1 4 3 4 6 4 3 4 5 1 2 2 
110 5 5 1 4 3 4 6 4 3 4 5 6 4 
105 5 5 1 4 3 4 6 4 3 4 5 1 4 3 3 4 
100 5 5 1 4 3 4 6 4 3 4 5 3 4 4 2 
95 5 5 1 4 3 4 6 4 3 4 5 1 4 6 
75 5 5 1 4 3 4 6 4 3 4 5 1 3 6 
-150 5 5 1 4 3 4 6 4 3 4 5 3 6 5 3 5 
-150 5 5 1 4 3 4 6 4 3 4 5 3 6 5 3 5 
-155 5 5 1 4 3 4 6 4 3 4 5 3 6 5 3 
-200 5 5 1 4 3 4 6 4 3 4 5 6 
-205 5 5 1 4 3 4 6 4 3 4 5 3 6 5 
-205 5 5 1 4 3 4 6 4 3 4 5 3 6 5 
-255 5 5 1 4 3 4 6 4 3 4 5 1 
-255 5 5 1 4 3 4 6 4 3 4 5 1 
-270 5 5 1 4 3 4 6 4 3 4 5 1 3 3 
-280 5 5 1 4 3 4 6 4 3 4 5 1 
-280 5 5 1 4 3 4 6 4 3 4 5 
