1035 4 4 6 5 5 6 4 5 5 1 2 1 3 5 3 6 4 5 6 4 6 1 2 1 2 1 1 4 2 6 3 6 6 
1035 4 4 6 5 5 6 4 5 5 1 2 1 3 5 3 6 4 5 6 4 6 1 2 1 2 1 1 4 2 6 3 6 6 
1020 4 4 6 5 5 6 4 5 5 1 2 1 3 5 3 6 4 5 6 4 6 1 2 1 2 1 1 4 2 6 3 6 2 
1020 4 4 6 5 5 6 4 5 5 1 2 1 3 5 3 6 4 5 6 4 6 1 2 1 2 1 1 4 2 6 3 6 2 
1020 4 4 6 5 5 6 4 5 5 1 2 1 3 5 3 6 4 5 6 4 6 1 2 1 2 1 1 4 2 6 3 6 5 
1020 4 4 6 5 5 6 4 5 5 1 2 1 3 5 3 6 4 5 6 4 6 1 2 1 2 1 1 4 2 6 3 6 2 
1020 4 4 6 5 5 6 4 5 5 1 2 1 3 5 3 6 4 5 6 4 6 1 2 1 2 1 1 4 2 6 3 6 2 
1000 4 4 6 5 5 6 4 5 5 1 2 1 3 5 3 6 4 5 6 4 6 1 2 1 2 1 1 4 2 6 2 2 
980 4 4 6 5 5 6 4 5 5 1 2 1 3 5 3 6 4 5 6 4 6 1 2 1 2 1 1 4 2 6 3 5 1 5 
975 4 4 6 5 5 6 4 5 5 1 2 1 3 5 3 6 4 5 6 4 6 1 2 1 2 1 1 4 2 6 3 6 3 
955 4 4 6 5 5 6 4 5 5 1 2 1 3 5 3 6 4 5 6 4 6 1 2 1 2 1 1 4 2 6 3 2 
935 4 4 6 5 5 6 4 5 5 1 2 1 3 5 3 6 4 5 6 4 6 1 2 1 1 2 1 5 6 4 3 3 4 6 
930 4 4 6 5 5 6 4 5 5 1 2 1 3 5 3 6 4 5 6 4 6 1 2 1 2 1 1 4 2 6 3 4 
930 4 4 6 5 5 6 4 5 5 1 2 1 3 5 3 6 4 5 6 4 6 1 2 1 2 1 1 4 2 6 3 1 
930 4 4 6 5 5 6 4 5 5 1 2 1 3 5 3 6 4 5 6 4 6 1 2 1 2 1 1 4 2 6 3 1 
930 4 4 6 5 5 6 4 5 5 1 2 1 3 5 3 6 4 5 6 4 6 1 2 1 2 1 1 4 2 6 3 4 
930 4 4 6 5 5 6 4 5 5 1 2 1 3 5 3 6 4 5 6 4 6 1 2 1 2 1 1 4 2 6 3 4 
865 4 4 6 5 5 6 4 5 5 1 2 1 3 5 3 6 4 5 6 4 6 1 2 1 2 1 2 4 1 4 3 
810 4 4 6 5 5 6 4 5 5 1 2 1 3 5 3 6 4 5 6 4 6 1 2 1 2 2 5 
800 4 4 6 5 5 6 4 5 5 1 2 1 3 5 3 6 4 5 6 4 6 1 2 1 2 1 6 
800 4 4 6 5 5 6 4 5 5 1 2 1 3 5 3 6 4 5 6 4 6 1 2 1 2 1 6 
800 4 4 6 5 5 6 4 5 5 1 2 1 3 5 3 6 4 5 6 4 6 1 2 1 2 1 6 
785 4 4 6 5 5 6 4 5 5 1 2 1 3 5 3 6 4 5 6 4 6 1 2 1 2 2 4 
760 4 4 6 5 5 6 4 5 5 1 2 1 3 5 3 6 4 5 6 4 6 1 2 1 2 5 
735 4 4 6 5 5 6 4 5 5 1 2 1 3 5 3 6 4 5 6 4 6 1 2 1 2 4 
735 4 4 6 5 5 6 4 5 5 1 2 1 3 5 3 6 4 5 6 4 6 1 2 1 1 5 
715 4 4 6 5 5 6 4 5 5 1 2 1 3 5 3 6 4 5 6 4 6 1 2 1 2 3 
710 4 4 6 5 5 6 4 5 5 1 2 1 3 5 3 6 4 5 6 4 6 1 2 1 5 
685 4 4 6 5 5 6 4 5 5 1 2 1 3 5 3 6 4 5 6 4 6 1 2 1 4 
665 4 4 6 5 5 6 4 5 5 1 2 1 3 5 3 6 4 5 6 4 6 1 2 1 3 
