1000064 2 1 5 5 5 5 5 5 2 6 4 1 3 2 5 3 5 4 5 4 5 1 6 
1000064 2 1 5 5 5 5 5 5 2 6 4 1 3 2 5 3 5 4 5 4 5 1 6 
1000049 2 1 5 5 5 5 5 5 2 6 4 1 3 2 5 3 5 6 6 2 
1000049 2 1 5 5 5 5 5 5 2 6 4 1 3 2 5 3 5 5 4 1 5 2 
1000049 2 1 5 5 5 5 5 5 2 6 4 1 3 2 5 3 5 4 5 4 5 3 1 5 
1000049 2 1 5 5 5 5 5 5 2 6 4 1 3 2 5 3 5 4 5 4 5 1 5 
1000049 2 1 5 5 5 5 5 5 2 6 4 1 3 2 5 3 5 4 5 4 5 2 
1000049 2 1 5 5 5 5 5 5 2 6 4 1 3 2 5 3 5 4 5 4 5 2 
1000049 2 1 5 5 5 5 5 5 2 6 4 1 3 2 5 3 5 4 5 4 5 2 
1000049 2 1 5 5 5 5 5 5 2 6 4 1 3 2 5 3 5 4 5 4 5 2 
1000024 2 1 5 5 5 5 5 5 2 6 4 1 3 2 5 3 5 4 5 4 5 1 1 
1000024 2 1 5 5 5 5 5 5 2 6 4 1 3 2 5 3 5 4 5 4 5 1 4 
1000024 2 1 5 5 5 5 5 5 2 6 4 1 3 2 5 3 5 4 5 3 3 5 1 1 
1000024 2 1 5 5 5 5 5 5 2 6 4 1 3 2 5 3 5 4 5 4 5 1 1 
1000024 2 1 5 5 5 5 5 5 2 6 4 1 3 2 5 3 5 4 5 4 5 1 1 
1000004 2 1 5 5 5 5 5 5 2 6 4 1 3 2 5 3 5 4 5 4 5 3 1 3 
620 2 1 5 5 5 5 5 5 2 6 4 1 3 2 5 3 5 4 5 4 5 3 6 
615 2 1 5 5 5 5 5 5 2 6 4 1 3 2 5 3 5 4 5 4 5 6 
615 2 1 5 5 5 5 5 5 2 6 4 1 3 2 5 3 5 4 5 4 5 6 
615 2 1 5 5 5 5 5 5 2 6 4 1 3 2 5 3 5 4 5 4 5 6 
615 2 1 5 5 5 5 5 5 2 6 4 1 3 2 5 3 5 4 5 4 5 6 
615 2 1 5 5 5 5 5 5 2 6 4 1 3 2 5 3 5 4 5 4 5 6 
615 2 1 5 5 5 5 5 5 2 6 4 1 3 2 5 3 5 4 5 4 5 6 
605 2 1 5 5 5 5 5 5 2 6 4 1 3 2 5 3 5 4 5 4 5 3 5 
600 2 1 5 5 5 5 5 5 2 6 4 1 3 2 5 3 5 4 5 4 5 5 
600 2 1 5 5 5 5 5 5 2 6 4 1 3 2 5 3 5 4 5 4 5 5 
600 2 1 5 5 5 5 5 5 2 6 4 1 3 2 5 3 5 4 5 4 5 5 
600 2 1 5 5 5 5 5 5 2 6 4 1 3 2 5 3 5 4 5 4 5 5 
595 2 1 5 5 5 5 5 5 2 6 4 1 3 2 3 5 3 3 5 6 3 6 6 1 4 6 3 4 2 2 3 2 5 5 2 
595 2 1 5 5 5 5 5 5 2 6 4 1 3 2 5 3 5 4 3 5 4 6 6 5 1 
595 2 1 5 5 5 5 5 5 2 6 4 1 3 2 5 3 6 6 5 6 
585 2 1 5 5 5 5 5 5 2 6 4 1 3 2 5 3 5 4 6 3 6 1 3 6 6 2 2 5 2 1 3 2 2 3 1 6 4 6 
585 2 1 5 5 5 5 5 5 2 6 4 1 3 2 5 3 5 4 5 3 3 5 5 
580 2 1 5 5 5 5 5 5 2 6 4 1 3 2 5 3 5 4 5 4 5 3 4 
575 2 1 5 5 5 5 5 5 2 6 4 1 3 2 5 3 5 4 5 4 5 4 
575 2 1 5 5 5 5 5 5 2 6 4 1 3 2 5 3 5 4 5 4 5 4 
575 2 1 5 5 5 5 5 5 2 6 4 1 3 2 5 3 5 4 5 4 5 4 
570 2 1 5 5 5 5 5 5 2 6 4 1 3 2 5 3 5 4 5 3 6 4 
565 2 1 5 5 5 5 5 5 2 6 4 1 3 2 5 3 5 4 5 1 6 
565 2 1 5 5 5 5 5 5 2 6 4 1 3 2 5 3 5 4 5 4 6 
565 2 1 5 5 5 5 5 5 2 6 4 1 3 2 5 3 5 4 5 1 6 
565 2 1 5 5 5 5 5 5 2 6 4 1 3 2 5 3 5 4 5 4 6 
565 2 1 5 5 5 5 5 5 2 6 4 1 3 2 5 3 5 4 5 4 6 
565 2 1 5 5 5 5 5 5 2 6 4 1 3 2 5 3 5 4 5 4 6 
565 2 1 5 5 5 5 5 5 2 6 4 1 3 2 5 3 5 4 5 1 6 
565 2 1 5 5 5 5 5 5 2 6 4 1 3 2 5 3 5 4 5 4 6 
560 2 1 5 5 5 5 5 5 2 6 4 1 3 2 5 3 5 4 3 4 4 3 1 4 4 
560 2 1 5 5 5 5 5 5 2 6 4 1 3 2 5 3 5 4 5 4 5 3 3 
560 2 1 5 5 5 5 5 5 2 6 4 1 3 2 5 3 5 4 5 4 5 3 3 
560 2 1 5 5 5 5 5 5 2 6 4 1 3 2 5 3 5 4 5 4 5 3 3 
555 2 1 5 5 5 5 5 5 2 6 4 1 3 2 5 3 5 4 5 3 1 5 
550 2 1 5 5 5 5 5 5 2 6 4 1 3 2 5 3 5 4 3 6 6 6 6 1 4 2 
550 2 1 5 5 5 5 5 5 2 6 4 1 3 2 5 3 5 4 5 4 2 
550 2 1 5 5 5 5 5 5 2 6 4 1 3 2 5 3 5 4 5 1 2 
550 2 1 5 5 5 5 5 5 2 6 4 1 3 2 5 3 5 4 5 4 2 
550 2 1 5 5 5 5 5 5 2 6 4 1 3 2 5 3 6 3 4 5 3 2 
550 2 1 5 5 5 5 5 5 2 6 4 1 3 2 5 3 5 4 5 3 3 6 
550 2 1 5 5 5 5 5 5 2 6 4 1 3 2 5 3 5 4 5 4 2 
540 2 1 5 5 5 5 5 5 2 6 4 1 3 2 5 3 5 4 6 5 
540 2 1 5 5 5 5 5 5 2 6 4 1 3 2 5 3 5 4 5 6 
540 2 1 5 5 5 5 5 5 2 6 4 1 3 2 5 3 5 4 6 2 
540 2 1 5 5 5 5 5 5 2 6 4 1 3 2 5 3 5 4 5 6 
540 2 1 5 5 5 5 5 5 2 6 4 1 3 2 5 3 5 4 5 6 
535 2 1 5 5 5 5 5 5 2 6 4 1 3 2 5 3 1 5 5 4 3 3 1 
530 2 1 5 5 5 5 5 5 2 6 4 1 3 2 5 3 5 4 5 4 3 1 
530 2 1 5 5 5 5 5 5 2 6 4 1 3 2 5 3 5 4 5 1 3 1 
530 2 1 5 5 5 5 5 5 2 6 4 1 3 2 5 3 5 5 4 3 5 
530 2 1 5 5 5 5 5 5 2 6 4 1 3 2 5 3 5 4 5 3 5 
530 2 1 5 5 5 5 5 5 2 6 4 1 3 2 5 3 5 4 5 4 3 1 
530 2 1 5 5 5 5 5 5 2 6 4 1 3 2 5 3 5 4 3 5 2 
530 2 1 5 5 5 5 5 5 2 6 4 1 3 2 5 3 5 4 5 3 5 
525 2 1 5 5 5 5 5 5 2 6 4 1 3 2 5 3 5 4 5 4 4 
525 2 1 5 5 5 5 5 5 2 6 4 1 3 2 5 3 5 4 5 4 1 
525 2 1 5 5 5 5 5 5 2 6 4 1 3 2 5 3 5 4 5 4 1 
525 2 1 5 5 5 5 5 5 2 6 4 1 3 2 5 3 5 4 5 4 1 
525 2 1 5 5 5 5 5 5 2 6 4 1 3 2 5 3 5 4 5 5 
525 2 1 5 5 5 5 5 5 2 6 4 1 3 2 5 3 5 4 5 4 4 
525 2 1 5 5 5 5 5 5 2 6 4 1 3 2 5 3 5 4 5 4 1 
525 2 1 5 5 5 5 5 5 2 6 4 1 3 2 5 3 5 4 5 4 4 
525 2 1 5 5 5 5 5 5 2 6 4 1 3 2 5 3 5 4 5 4 4 
525 2 1 5 5 5 5 5 5 2 6 4 1 3 2 5 3 5 4 5 2 
525 2 1 5 5 5 5 5 5 2 6 4 1 3 2 5 3 5 4 5 5 
525 2 1 5 5 5 5 5 5 2 6 4 1 3 2 5 3 5 4 5 4 4 
525 2 1 5 5 5 5 5 5 2 6 4 1 3 2 5 3 5 4 6 3 3 1 
525 2 1 5 5 5 5 5 5 2 6 4 1 3 2 5 3 5 4 5 5 
525 2 1 5 5 5 5 5 5 2 6 4 1 3 2 5 3 5 4 5 5 
525 2 1 5 5 5 5 5 5 2 6 4 1 3 2 5 3 5 4 5 5 
525 2 1 5 5 5 5 5 5 2 6 4 1 3 2 5 3 5 4 5 1 1 
525 2 1 5 5 5 5 5 5 2 6 4 1 3 2 5 3 5 4 5 4 4 
525 2 1 5 5 5 5 5 5 2 6 4 1 3 2 5 3 5 5 4 1 4 
525 2 1 5 5 5 5 5 5 2 6 4 1 3 2 5 3 5 4 5 1 1 
520 2 1 5 5 5 5 5 5 2 6 4 1 3 2 5 3 5 4 6 3 4 
520 2 1 5 5 5 5 5 5 2 6 4 3 2 1 5 3 5 4 6 3 4 
520 2 1 5 5 5 5 5 5 2 6 4 1 3 2 5 3 5 5 3 6 
520 2 1 5 5 5 5 5 5 2 6 4 1 3 2 5 3 5 4 6 3 4 
515 2 1 5 5 5 5 5 5 2 6 4 1 3 2 5 4 4 6 4 3 4 
515 2 1 5 5 5 5 5 5 2 6 4 1 3 2 5 3 1 4 4 6 1 
515 2 1 5 5 5 5 5 5 2 6 4 1 3 2 5 3 5 5 6 
515 2 1 5 5 5 5 5 5 2 6 4 1 3 2 5 3 5 5 6 
515 2 1 5 5 5 5 5 5 2 6 4 1 3 2 5 3 5 4 3 5 3 3 4 
515 2 1 5 5 5 5 5 5 2 6 4 1 3 2 5 3 5 6 1 1 
505 2 1 5 5 5 5 5 5 2 6 4 1 3 2 5 3 5 5 3 2 
505 2 1 5 5 5 5 5 5 2 6 4 1 3 2 5 3 5 4 4 3 2 
505 2 1 5 5 5 5 5 5 2 6 4 1 3 2 5 3 6 4 6 
500 2 1 5 5 5 5 5 5 2 6 4 1 3 2 5 3 5 5 2 
500 2 1 5 5 5 5 5 5 2 6 4 1 3 2 5 3 5 4 4 2 
480 2 1 5 5 5 5 5 5 2 6 4 1 3 2 5 3 5 4 3 2 
480 2 1 5 5 5 5 5 5 2 6 4 1 3 2 5 3 5 4 3 2 
475 2 1 5 5 5 5 5 5 2 6 4 1 3 2 5 3 5 5 1 
475 2 1 5 5 5 5 5 5 2 6 4 1 3 2 5 3 5 4 2 
455 2 1 5 5 5 5 5 5 2 6 4 1 3 2 5 3 5 4 3 1 
450 2 1 5 5 5 5 5 5 2 6 4 1 3 2 5 3 5 2 
450 2 1 5 5 5 5 5 5 2 6 4 1 3 2 5 3 4 5 1 
450 2 1 5 5 5 5 5 5 2 6 4 1 3 2 5 3 5 4 1 
450 2 1 5 5 5 5 5 5 2 6 4 1 3 2 5 3 5 4 1 
450 2 1 5 5 5 5 5 5 2 6 4 1 3 2 5 3 4 5 1 
450 2 1 5 5 5 5 5 5 2 6 4 1 3 2 5 3 5 4 1 
450 2 1 5 5 5 5 5 5 2 6 4 1 3 2 5 3 5 2 
450 2 1 5 5 5 5 5 5 2 6 4 1 3 2 5 3 3 6 4 3 4 5 
430 2 1 5 5 5 5 5 5 2 6 4 1 3 2 5 3 1 3 2 
425 2 1 5 5 5 5 5 5 2 6 4 1 3 2 5 3 5 1 
425 2 1 5 5 5 5 5 5 2 6 4 1 3 2 5 3 1 2 
425 2 1 5 5 5 5 5 5 2 6 4 1 3 2 5 3 1 4 1 
425 2 1 5 5 5 5 5 5 2 6 4 1 3 2 5 3 5 1 
425 2 1 5 5 5 5 5 5 2 6 4 1 3 2 5 3 5 1 
405 2 1 5 5 5 5 5 5 2 6 4 1 3 2 5 3 5 3 
405 2 1 5 5 5 5 5 5 2 6 4 1 3 2 5 3 5 3 
400 2 1 5 5 5 5 5 5 2 6 4 1 3 2 5 3 2 
