1355 6 5 5 5 6 4 3 4 6 2 2 3 6 5 5 5 5 4 3 4 6 2 2 2 2 1 3 5 6 2 6 4 6 5 6 5 2 
1285 6 5 5 5 6 4 3 4 6 2 2 3 6 5 5 5 5 4 3 4 6 2 2 2 2 1 3 5 6 2 6 1 4 6 3 2 6 
1280 6 5 5 5 6 4 3 4 6 2 2 3 6 5 5 5 5 4 3 4 6 2 2 2 2 1 3 5 6 2 6 4 4 6 2 6 
1270 6 5 5 5 6 4 3 4 6 2 2 3 6 5 5 5 5 4 3 4 6 2 2 2 2 1 3 5 6 2 6 4 4 6 3 2 5 
1255 6 5 5 5 6 4 3 4 6 2 2 3 6 5 5 5 5 4 3 4 6 2 2 2 2 1 3 5 6 2 6 4 4 3 2 2 4 4 
1250 6 5 5 5 6 4 3 4 6 2 2 3 6 5 5 5 5 4 3 4 6 2 2 2 2 1 3 5 6 2 6 4 4 5 1 4 5 
1245 6 5 5 5 6 4 3 4 6 2 2 3 6 5 5 5 5 4 3 4 6 2 2 2 2 1 3 5 6 2 6 4 6 3 2 5 
1240 6 5 5 5 6 4 3 4 6 2 2 3 6 5 5 5 5 4 3 4 6 2 2 2 2 1 3 5 6 2 6 1 6 4 1 5 
1240 6 5 5 5 6 4 3 4 6 2 2 3 6 5 5 5 5 4 3 4 6 2 2 2 2 1 3 5 6 2 6 4 4 6 4 5 
1225 6 5 5 5 6 4 3 4 6 2 2 3 6 5 5 5 5 4 3 4 6 2 2 2 2 1 3 5 6 2 6 4 4 5 5 1 
1220 6 5 5 5 6 4 3 4 6 2 2 3 6 5 5 5 5 4 3 4 6 2 2 2 2 1 3 5 6 2 6 4 6 4 3 4 4 
1210 6 5 5 5 6 4 3 4 6 2 2 3 6 5 5 5 5 4 3 4 6 2 2 2 2 1 3 5 6 2 6 4 6 3 6 
1210 6 5 5 5 6 4 3 4 6 2 2 3 6 5 5 5 5 4 3 4 6 2 2 2 2 1 3 5 6 6 4 3 4 6 4 6 
1205 6 5 5 5 6 4 3 4 6 2 2 3 6 5 5 5 5 4 3 4 6 2 2 2 2 1 3 5 6 2 6 4 6 6 
1205 6 5 5 5 6 4 3 4 6 2 2 3 6 5 5 5 5 4 3 4 6 2 2 2 2 1 3 5 6 2 6 4 6 6 
1205 6 5 5 5 6 4 3 4 6 2 2 3 6 5 5 5 5 4 3 4 6 2 2 2 2 1 3 5 6 2 6 4 6 6 
1195 6 5 5 5 6 4 3 4 6 2 2 3 6 5 5 5 5 4 3 4 6 2 2 2 2 1 3 5 6 6 3 4 5 3 4 6 3 3 3 4 5 
1135 6 5 5 5 6 4 3 4 6 2 2 3 6 5 5 5 5 4 3 4 6 2 2 2 2 1 3 5 6 2 1 4 4 4 2 
1125 6 5 5 5 6 4 3 4 6 2 2 3 6 5 5 5 5 4 3 4 6 2 2 2 2 1 3 5 6 2 6 4 4 1 
1125 6 5 5 5 6 4 3 4 6 2 2 3 6 5 5 5 5 4 3 4 6 2 2 2 2 1 3 5 6 2 6 4 2 
1125 6 5 5 5 6 4 3 4 6 2 2 3 6 5 5 5 5 4 3 4 6 2 2 2 2 1 3 5 6 2 6 4 4 4 
1125 6 5 5 5 6 4 3 4 6 2 2 3 6 5 5 5 5 4 3 4 6 2 2 2 2 1 3 5 6 2 6 4 2 
1125 6 5 5 5 6 4 3 4 6 2 2 3 6 5 5 5 5 4 3 4 6 2 2 2 2 1 3 5 6 2 6 4 5 
1125 6 5 5 5 6 4 3 4 6 2 2 3 6 5 5 5 5 4 3 4 6 2 2 2 2 1 3 5 6 2 6 4 2 
1125 6 5 5 5 6 4 3 4 6 2 2 3 6 5 5 5 5 4 3 4 6 2 2 2 2 1 3 5 6 6 1 5 5 
1125 6 5 5 5 6 4 3 4 6 2 2 3 6 5 5 5 5 4 3 4 6 2 2 2 2 1 3 5 6 2 6 4 2 
1125 6 5 5 5 6 4 3 4 6 2 2 3 6 5 5 5 5 4 3 4 6 2 2 2 2 1 3 5 6 2 6 1 2 
1125 6 5 5 5 6 4 3 4 6 2 2 3 6 5 5 5 5 4 3 4 6 2 2 2 2 1 3 5 6 2 6 4 2 
1125 6 5 5 5 6 4 3 4 6 2 2 3 6 5 5 5 5 4 3 4 6 2 2 2 2 1 3 5 6 2 6 4 5 
1125 6 5 5 5 6 4 3 4 6 2 2 3 6 5 5 5 5 4 3 4 6 2 2 2 2 1 3 5 6 2 6 4 2 
1125 6 5 5 5 6 4 3 4 6 2 2 3 6 5 5 5 5 4 3 4 6 2 2 2 2 1 3 5 6 2 6 4 5 
1125 6 5 5 5 6 4 3 4 6 2 2 3 6 5 5 5 5 4 3 4 6 2 2 2 2 1 3 5 6 2 6 4 4 4 
1125 6 5 5 5 6 4 3 4 6 2 2 3 6 5 5 5 5 4 3 4 6 2 2 2 2 1 3 5 6 2 6 4 5 
1125 6 5 5 5 6 4 3 4 6 2 2 3 6 5 5 5 5 4 3 4 6 2 2 2 2 1 3 5 6 2 6 4 2 
1125 6 5 5 5 6 4 3 4 6 2 2 3 6 5 5 5 5 4 3 4 6 2 2 2 2 1 3 5 6 2 6 4 4 1 
1120 6 5 5 5 6 4 3 4 6 2 2 3 6 5 5 5 5 4 3 4 6 2 2 2 2 1 6 6 5 5 2 4 
1115 6 5 5 5 6 4 3 4 6 2 2 3 6 5 5 5 5 4 3 4 6 2 2 2 2 1 3 5 6 2 6 6 
1115 6 5 5 5 6 4 3 4 6 2 2 3 6 5 5 5 5 4 3 4 6 2 2 2 2 1 3 5 6 5 6 6 
1115 6 5 5 5 6 4 3 4 6 2 2 3 6 5 5 5 5 4 3 4 6 2 2 2 2 1 3 5 6 5 6 6 
1110 6 5 5 5 6 4 3 4 6 2 2 3 6 5 5 5 5 4 3 4 6 2 2 2 2 1 6 6 6 4 5 4 
1100 6 5 5 5 6 4 3 4 6 2 2 3 6 5 5 5 5 4 3 4 6 2 2 2 2 1 3 5 6 2 6 4 1 
1100 6 5 5 5 6 4 3 4 6 2 2 3 6 5 5 5 5 4 3 4 6 2 2 2 2 1 3 5 6 2 6 5 
1100 6 5 5 5 6 4 3 4 6 2 2 3 6 5 5 5 5 4 3 4 6 2 2 2 2 1 3 5 6 2 6 5 
1100 6 5 5 5 6 4 3 4 6 2 2 3 6 5 5 5 5 4 3 4 6 2 2 2 2 1 3 5 6 2 5 6 
1100 6 5 5 5 6 4 3 4 6 2 2 3 6 5 5 5 5 4 3 4 6 2 2 2 2 1 3 5 6 2 6 4 1 
1100 6 5 5 5 6 4 3 4 6 2 2 3 6 5 5 5 5 4 3 4 6 2 2 2 2 1 3 5 6 2 6 4 1 
1100 6 5 5 5 6 4 3 4 6 2 2 3 6 5 5 5 5 4 3 4 6 2 2 2 2 1 3 5 6 2 6 1 1 
1100 6 5 5 5 6 4 3 4 6 2 2 3 6 5 5 5 5 4 3 4 6 2 2 2 2 1 3 5 6 2 6 5 
1100 6 5 5 5 6 4 3 4 6 2 2 3 6 5 5 5 5 4 3 4 6 2 2 2 2 1 3 5 6 2 6 2 
1100 6 5 5 5 6 4 3 4 6 2 2 3 6 5 5 5 5 4 3 4 6 2 2 2 2 1 3 5 6 2 6 4 6 2 1 
1100 6 5 5 5 6 4 3 4 6 2 2 3 6 5 5 5 5 4 3 4 6 2 2 2 2 1 3 5 6 5 4 1 6 
1100 6 5 5 5 6 4 3 4 6 2 2 3 6 5 5 5 5 4 3 4 6 2 2 2 2 1 3 5 6 2 6 4 1 
1100 6 5 5 5 6 4 3 4 6 2 2 3 6 5 5 5 5 4 3 4 6 2 2 2 2 1 3 5 6 2 6 5 
1090 6 5 5 5 6 4 3 4 6 2 2 3 6 5 5 5 5 4 3 4 6 2 2 2 2 1 3 4 6 6 6 2 
1090 6 5 5 5 6 4 3 4 6 2 2 3 6 5 5 5 5 4 3 4 6 2 2 2 2 1 3 5 6 5 4 3 1 5 
1085 6 5 5 5 6 4 3 4 6 2 2 3 6 5 5 5 5 4 3 4 6 2 2 2 2 1 3 5 6 6 1 4 3 3 1 
1085 6 5 5 5 6 4 3 4 6 2 2 3 6 5 5 5 5 4 3 4 6 2 2 2 2 1 3 5 6 2 5 5 
1085 6 5 5 5 6 4 3 4 6 2 2 3 6 5 5 5 5 4 3 4 6 2 2 2 2 1 3 5 6 2 4 4 2 
1080 6 5 5 5 6 4 3 4 6 2 2 3 6 5 5 5 5 4 3 4 6 2 2 2 2 1 3 5 6 2 6 4 3 
1080 6 5 5 5 6 4 3 4 6 2 2 3 6 5 5 5 5 4 3 4 6 2 2 2 2 1 3 5 6 2 6 4 3 
1075 6 5 5 5 6 4 3 4 6 2 2 3 6 5 5 5 5 4 3 4 6 2 2 2 2 1 3 5 6 2 1 6 
1065 6 5 5 5 6 4 3 4 6 2 2 3 6 5 5 5 5 4 3 4 6 2 2 2 2 1 3 5 6 6 6 
1065 6 5 5 5 6 4 3 4 6 2 2 3 6 5 5 5 5 4 3 4 6 2 2 2 2 1 3 5 6 1 4 1 3 5 
1065 6 5 5 5 6 4 3 4 6 2 2 3 6 5 5 5 5 4 3 4 6 2 2 2 2 1 3 5 6 5 1 3 5 
1060 6 5 5 5 6 4 3 4 6 2 2 3 6 5 5 5 5 4 3 4 6 2 2 2 2 1 3 5 6 2 1 5 
1060 6 5 5 5 6 4 3 4 6 2 2 3 6 5 5 5 5 4 3 4 6 2 2 2 2 1 3 5 5 6 1 2 
1060 6 5 5 5 6 4 3 4 6 2 2 3 6 5 5 5 5 4 3 4 6 2 2 2 2 1 3 5 6 2 5 1 
1060 6 5 5 5 6 4 3 4 6 2 2 3 6 5 5 5 5 4 3 4 6 2 2 2 2 1 3 5 6 5 5 1 
1060 6 5 5 5 6 4 3 4 6 2 2 3 6 5 5 5 5 4 3 4 6 2 2 2 2 1 3 5 6 2 1 2 
1055 6 5 5 5 6 4 3 4 6 2 2 3 6 5 5 5 5 4 3 4 6 2 2 2 2 1 3 5 6 2 6 3 
1055 6 5 5 5 6 4 3 4 6 2 2 3 6 5 5 5 5 4 3 4 6 2 2 2 2 1 3 5 6 2 6 3 
1055 6 5 5 5 6 4 3 4 6 2 2 3 6 5 5 5 5 4 3 4 6 2 2 2 2 1 3 5 6 6 3 5 
1055 6 5 5 5 6 4 3 4 6 2 2 3 6 5 5 5 5 4 3 4 6 2 1 2 2 2 1 2 6 5 3 2 3 1 
1055 6 5 5 5 6 4 3 4 6 2 2 3 6 5 5 5 5 4 3 4 6 2 2 2 2 1 3 5 6 2 6 3 
1055 6 5 5 5 6 4 3 4 6 2 2 3 6 5 5 5 5 4 3 4 6 2 2 2 2 1 3 5 6 2 6 3 
1055 6 5 5 5 6 4 3 4 6 2 2 3 6 5 5 5 5 4 3 4 6 2 2 2 2 1 3 5 6 2 6 3 
1055 6 5 5 5 6 4 3 4 6 2 2 3 6 5 5 5 5 4 3 4 6 2 2 2 2 1 3 5 6 2 3 6 
1050 6 5 5 5 6 4 3 4 6 2 2 3 6 5 5 5 5 4 3 4 6 2 2 2 2 1 3 5 6 6 2 
1050 6 5 5 5 6 4 3 4 6 2 2 3 6 5 5 5 5 4 3 4 6 2 2 2 2 1 3 5 6 6 5 
1050 6 5 5 5 6 4 3 4 6 2 2 3 6 5 5 5 5 4 3 4 6 2 2 2 2 1 3 5 6 6 5 
1050 6 5 5 5 6 4 3 4 6 2 2 3 6 5 5 5 5 4 3 4 6 2 2 2 2 1 3 5 6 6 2 
1050 6 5 5 5 6 4 3 4 6 2 2 3 6 5 5 5 5 4 3 4 6 2 2 2 2 1 3 5 6 6 2 
1045 6 5 5 5 6 4 3 4 6 2 2 3 6 5 5 5 5 4 3 4 6 2 2 2 2 1 3 5 6 6 2 6 
1045 6 5 5 5 6 4 3 4 6 2 2 3 6 5 5 5 5 4 3 4 6 2 2 2 2 1 3 5 5 5 4 2 
1045 6 5 5 5 6 4 3 4 6 2 2 3 6 5 5 5 5 4 3 4 6 2 2 2 2 1 3 5 5 4 1 4 2 
1045 6 5 5 5 6 4 3 4 6 2 2 3 6 5 5 5 5 4 3 4 6 2 2 2 2 1 3 5 6 6 2 2 
1040 6 5 5 5 6 4 3 4 6 2 2 3 6 5 5 5 5 4 3 4 6 2 2 2 2 1 3 5 6 2 5 3 
1040 6 5 5 5 6 4 3 4 6 2 2 3 6 5 5 5 5 4 3 4 6 2 2 2 2 1 3 5 6 2 5 3 
1040 6 5 5 5 6 4 3 4 6 2 2 3 6 5 5 5 5 4 3 4 6 2 2 2 2 1 3 5 6 6 3 4 3 3 
1040 6 5 5 5 6 4 3 4 6 2 2 3 6 5 5 5 5 4 3 4 6 2 2 2 2 1 3 5 1 5 1 3 6 
1040 6 5 5 5 6 4 3 4 6 2 2 3 6 5 5 5 5 4 3 4 6 2 2 2 2 1 3 5 6 2 5 3 
1035 6 5 5 5 6 4 3 4 6 2 2 3 6 5 5 5 5 4 3 4 6 2 2 2 2 1 3 5 6 2 1 1 
1035 6 5 5 5 6 4 3 4 6 2 2 3 6 5 5 5 5 4 3 4 6 2 2 2 2 1 3 5 6 2 2 
1035 6 5 5 5 6 4 3 4 6 2 2 3 6 5 5 5 5 4 3 4 6 2 2 2 2 1 3 5 6 2 2 
1035 6 5 5 5 6 4 3 4 6 2 2 3 6 5 5 5 5 4 3 4 6 2 2 2 2 1 3 5 6 4 4 1 1 
1035 6 5 5 5 6 4 3 4 6 2 2 3 6 5 5 5 5 4 3 4 6 2 2 2 2 1 3 5 6 2 2 
1035 6 5 5 5 6 4 3 4 6 2 2 3 6 5 5 5 5 4 3 4 6 2 2 2 2 1 3 5 6 2 2 
1035 6 5 5 5 6 4 3 4 6 2 2 3 6 5 5 5 5 4 3 4 6 2 2 2 2 1 3 5 6 2 2 
1035 6 5 5 5 6 4 3 4 6 2 2 3 6 5 5 5 5 4 3 4 6 2 2 2 2 1 3 2 4 6 4 2 
1035 6 5 5 5 6 4 3 4 6 2 2 3 6 5 5 5 5 4 3 4 6 2 2 2 2 2 3 5 5 1 6 
1035 6 5 5 5 6 4 3 4 6 2 2 3 6 5 5 5 5 4 3 4 6 2 2 2 2 1 3 5 6 2 1 1 
1035 6 5 5 5 6 4 3 4 6 2 2 3 6 5 5 5 5 4 3 4 6 2 2 2 2 1 3 5 6 4 4 2 
1035 6 5 5 5 6 4 3 4 6 2 2 3 6 5 5 5 5 4 3 4 6 2 2 2 2 1 3 5 6 5 2 
1030 6 5 5 5 6 4 3 4 6 2 2 3 6 5 5 5 5 4 3 4 6 2 2 2 2 1 6 3 6 4 3 2 
1030 6 5 5 5 6 4 3 4 6 2 2 3 6 5 5 5 5 4 3 4 6 2 2 2 2 1 3 5 6 6 3 1 
1025 6 5 5 5 6 4 3 4 6 2 2 3 6 5 5 5 5 4 3 4 6 2 2 2 2 1 3 5 6 4 6 
1025 6 5 5 5 6 4 3 4 6 2 2 3 6 5 5 5 5 4 3 4 6 2 2 2 2 1 3 5 6 1 6 
1020 6 5 5 5 6 4 3 4 6 2 2 3 6 5 5 5 5 4 3 4 6 2 2 2 2 1 1 5 3 5 4 5 
1010 6 5 5 5 6 4 3 4 6 2 2 3 6 5 5 5 5 4 3 4 6 2 2 2 2 1 3 5 6 1 2 
1010 6 5 5 5 6 4 3 4 6 2 2 3 6 5 5 5 5 4 3 4 6 2 2 2 2 1 3 5 6 6 3 3 
1010 6 5 5 5 6 4 3 4 6 2 2 3 6 5 5 5 5 4 3 4 6 2 2 2 2 1 3 5 6 6 3 3 
1010 6 5 5 5 6 4 3 4 6 2 2 3 6 5 5 5 5 4 3 4 6 2 2 2 2 1 3 5 6 1 2 
1000 6 5 5 5 6 4 3 4 6 2 2 3 6 5 5 5 5 4 3 4 6 2 2 2 2 1 6 3 6 5 
995 6 5 5 5 6 4 3 4 6 2 2 3 6 5 5 5 5 4 3 4 6 2 2 2 2 1 6 5 6 
995 6 5 5 5 6 4 3 4 6 2 2 3 6 5 5 5 5 4 3 4 6 2 2 2 2 1 3 5 6 2 3 3 
990 6 5 5 5 6 4 3 4 6 2 2 3 6 5 5 5 5 4 3 4 6 2 2 2 2 1 3 5 6 3 4 1 
990 6 5 5 5 6 4 3 4 6 2 2 3 6 5 5 5 5 4 3 4 6 2 2 2 2 1 3 5 6 1 3 1 
985 6 5 5 5 6 4 3 4 6 2 2 3 6 5 5 5 5 4 3 4 6 2 2 2 2 1 3 5 6 4 1 
985 6 5 5 5 6 4 3 4 6 2 2 3 6 5 5 5 5 4 3 4 6 2 2 2 2 1 3 5 6 4 1 
970 6 5 5 5 6 4 3 4 6 2 2 3 6 5 5 5 5 4 3 4 6 2 2 2 2 1 3 5 6 3 4 3 
970 6 5 5 5 6 4 3 4 6 2 2 3 6 5 5 5 5 4 3 4 6 2 2 2 2 1 3 4 2 4 2 
970 6 5 5 5 6 4 3 4 6 2 2 3 6 5 5 5 5 4 3 4 6 2 2 2 2 2 3 1 5 2 
945 6 5 5 5 6 4 3 4 6 2 2 3 6 5 5 5 5 4 3 4 6 2 2 2 2 1 3 5 3 6 3 
940 6 5 5 5 6 4 3 4 6 2 2 3 6 5 5 5 5 4 3 4 6 2 2 2 2 1 3 5 3 6 3 1 
920 6 5 5 5 6 4 3 4 6 2 2 3 6 5 5 5 5 4 3 4 6 2 2 2 2 1 3 5 4 1 
920 6 5 5 5 6 4 3 4 6 2 2 3 6 5 5 5 5 4 3 4 6 2 2 2 2 1 3 1 2 1 
905 6 5 5 5 6 4 3 4 6 2 2 3 6 5 5 5 5 4 3 4 6 2 2 2 2 1 6 4 
865 6 5 5 5 6 4 3 4 6 2 2 3 6 5 5 5 5 4 3 4 6 2 2 2 1 1 1 3 5 5 5 
