320 5 6 5 5 5 5 5 2 5 4 6 6 
300 5 6 5 5 5 5 5 2 6 6 3 2 
300 5 6 5 5 5 5 5 2 3 6 6 2 
290 5 6 5 5 5 5 5 2 5 1 5 2 3 
280 5 6 5 5 5 5 5 2 6 2 2 1 2 5 6 6 4 
280 5 6 5 5 5 5 5 2 6 2 2 1 2 5 6 6 4 4 
280 5 6 5 5 5 5 5 2 6 2 2 1 2 5 6 6 4 
280 5 6 5 5 5 5 5 2 6 2 2 1 2 5 6 6 4 4 
280 5 6 5 5 5 5 5 2 6 2 2 1 2 5 6 6 4 4 
280 5 6 5 5 5 5 5 2 6 2 2 1 2 5 6 6 4 4 1 
280 5 6 5 5 5 5 5 2 6 2 2 1 2 5 6 6 4 4 
280 5 6 5 5 5 5 5 2 6 2 2 1 2 5 6 6 4 4 1 
280 5 6 5 5 5 5 5 2 6 2 2 1 2 5 6 6 4 4 1 
280 5 6 5 5 5 5 5 2 6 2 2 1 2 5 6 6 4 4 1 
280 5 6 5 5 5 5 5 2 6 2 2 1 2 5 6 6 4 4 1 
280 5 6 5 5 5 5 5 2 6 2 2 1 2 5 6 6 4 4 1 
280 5 6 5 5 5 5 5 2 6 2 2 1 2 5 6 6 4 4 1 
280 5 6 5 5 5 5 5 2 6 2 2 1 2 5 6 6 4 4 
280 5 6 5 5 5 5 5 2 6 2 2 1 2 5 6 6 4 4 
280 5 6 5 5 5 5 5 2 6 2 2 1 2 5 6 6 4 4 
280 5 6 5 5 5 5 5 2 6 2 2 1 2 5 6 6 4 
280 5 6 5 5 5 5 5 2 6 2 2 1 2 5 6 6 4 4 1 
280 5 6 5 5 5 5 5 2 6 2 2 1 2 5 6 6 4 
280 5 6 5 5 5 5 5 2 6 2 2 1 2 5 6 6 4 4 1 
280 5 6 5 5 5 5 5 2 6 2 2 1 2 5 6 6 4 
280 5 6 5 5 5 5 5 2 6 2 2 1 2 5 6 6 4 
280 5 6 5 5 5 5 5 2 6 2 2 1 2 5 6 6 4 4 1 
280 5 6 5 5 5 5 5 2 6 2 2 1 2 5 6 6 4 
215 5 6 5 5 5 4 4 4 1 2 6 3 3 1 6 
115 5 6 5 5 5 4 4 4 1 5 
90 5 6 5 5 5 4 4 4 2 5 
90 5 6 5 5 5 4 4 4 2 
90 5 6 5 5 5 4 2 5 
90 5 6 5 5 5 4 4 2 4 
85 5 6 5 5 5 4 3 6 1 
80 5 6 5 5 5 4 4 6 
65 5 6 5 5 5 4 4 1 4 
0 5 6 5 5 5 4 3 3 
-40 5 6 5 5 5 5 5 2 6 2 2 1 2 5 6 6 4 4 1 3 
-85 5 6 5 5 5 5 5 2 5 2 4 4 6 2 5 5 1 5 
-90 5 6 5 5 5 5 5 2 6 5 4 3 2 3 6 3 3 6 
-100 5 6 5 5 5 4 4 4 3 2 2 6 6 6 2 2 
-135 5 6 5 5 5 4 4 4 1 5 5 2 3 1 5 5 1 2 
-135 5 6 5 5 5 5 5 2 1 5 6 3 4 3 5 1 
-135 5 6 5 5 5 5 5 2 6 2 5 2 6 5 4 4 6 3 
-135 5 6 5 5 5 5 5 2 6 3 5 6 2 2 3 1 6 3 5 
-225 5 6 5 5 5 5 5 2 3 5 5 5 1 5 4 
-225 5 6 5 5 5 5 5 2 3 5 3 3 5 
