585 1 4 5 5 5 5 3 5 1 2 6 5 6 5 6 2 4 
370 2 4 5 5 5 5 3 5 1 3 1 1 6 4 1 5 2 3 2 2 
-20 1 2 4 5 5 5 5 4 1 3 3 1 3 
-25 5 6 4 5 5 5 5 3 5 1 4 
-25 5 4 5 5 5 5 3 5 4 
-30 5 5 4 5 5 5 3 5 1 1 
-35 1 6 4 5 5 5 5 3 5 1 3 4 
-40 5 6 4 5 5 5 5 3 5 1 4 4 
-40 5 6 4 5 5 5 5 3 5 4 2 
-40 5 6 4 5 5 5 5 3 5 1 1 
-40 5 6 4 5 5 5 5 3 5 1 1 
-40 5 6 4 5 5 5 5 3 5 5 5 
-40 5 6 4 5 5 5 5 3 5 3 4 
-40 5 6 4 5 5 5 5 3 5 1 6 
-45 5 6 4 5 5 5 5 3 4 4 
-45 6 5 4 5 5 5 5 3 5 5 1 4 5 
-50 5 4 5 5 5 5 3 6 6 1 1 1 2 
-55 5 4 5 5 5 5 3 5 1 1 6 1 2 2 1 
-60 5 6 4 5 5 5 5 3 5 3 2 
-70 6 4 5 5 5 5 3 5 1 4 4 4 6 2 
-70 6 6 4 5 5 5 5 3 5 3 2 5 
-75 1 4 5 5 4 2 4 
-80 4 2 4 5 5 5 5 3 5 5 2 
-85 1 4 5 5 5 5 3 5 1 4 2 1 2 6 5 
-85 5 6 4 5 5 5 5 3 5 3 1 5 2 
-90 5 6 4 5 5 5 5 3 5 5 3 
-90 5 6 4 5 5 5 5 3 5 1 4 6 
-90 5 6 4 5 5 5 5 3 5 5 5 
-105 3 4 5 5 5 5 2 1 2 5 5 
-115 6 2 4 5 5 5 5 3 5 1 3 
-160 5 6 4 5 5 5 5 3 5 1 4 3 
-160 5 6 4 5 5 5 5 3 5 1 2 
-160 5 6 4 5 5 5 5 3 5 1 6 
-165 5 6 4 5 5 5 5 3 4 
-165 5 6 4 5 5 5 5 3 2 
-175 3 4 5 5 5 5 3 5 1 6 
-205 5 6 4 5 5 5 5 3 5 3 2 3 
-205 4 4 5 5 6 
-205 5 5 4 5 5 5 5 5 3 
-325 6 4 5 5 5 5 3 5 1 4 2 2 
-330 1 4 5 5 5 5 3 5 1 4 3 
-335 5 6 4 5 5 5 5 3 4 
-365 5 6 4 5 5 5 5 3 5 1 2 
-370 5 6 4 5 5 5 5 3 6 
-370 6 4 5 5 5 3 
-390 5 6 4 5 5 5 5 3 1 
-415 5 6 4 5 5 5 5 3 6 
-415 4 4 5 5 5 5 3 1 2 
