415 6 5 5 5 5 5 3 5 6 5 5 5 6 6 2 
345 6 5 5 5 5 5 3 5 6 2 1 6 3 6 5 
335 6 5 5 5 5 5 3 5 6 5 5 5 2 
310 6 5 5 5 5 5 3 5 6 5 5 5 4 
310 6 5 5 5 5 5 3 5 6 5 2 5 4 
310 6 5 5 5 5 5 3 5 6 3 3 2 6 5 
300 6 5 5 5 5 5 3 5 6 5 1 6 4 
300 6 5 5 5 5 5 3 5 6 5 5 6 
300 6 5 5 5 5 5 3 5 6 5 5 6 
300 6 5 5 5 5 5 3 5 6 5 5 6 
290 6 5 5 5 5 5 3 5 6 6 6 1 
290 6 5 5 5 5 5 3 5 6 2 5 3 5 
285 6 5 5 5 5 5 3 5 6 5 5 2 
285 6 5 5 5 5 5 3 5 6 5 2 2 
285 6 5 5 5 5 5 3 5 6 5 2 2 
285 6 5 5 5 5 5 3 5 6 5 5 2 
285 6 5 5 5 5 5 3 5 6 5 5 2 
285 6 5 5 5 5 5 3 5 6 5 5 2 
285 6 5 5 5 5 5 3 5 6 5 5 2 
265 6 5 5 5 5 5 3 5 6 5 5 3 1 
265 6 5 5 5 5 5 3 5 6 5 1 3 4 1 
265 6 5 5 5 5 5 3 5 6 5 5 3 1 
265 6 5 5 5 5 5 3 5 6 2 1 3 2 
260 6 5 5 5 5 5 3 5 6 5 1 1 4 
260 6 5 5 5 5 5 3 5 6 5 4 5 
260 6 5 5 5 5 5 3 5 6 5 1 2 
260 6 5 5 5 5 5 3 5 6 5 4 2 
260 6 5 5 5 5 5 3 5 6 5 1 4 4 
260 6 5 5 5 5 5 3 5 6 5 2 1 
260 6 5 5 5 5 5 3 5 6 5 5 1 
255 6 5 5 5 5 5 3 5 6 5 3 6 
250 6 5 5 5 5 5 3 5 6 5 6 
245 6 5 5 5 5 5 3 5 6 3 3 2 2 
200 6 5 5 5 3 5 5 5 6 3 1 3 3 1 5 
130 6 5 5 5 5 5 2 6 
120 6 5 5 5 5 5 3 2 5 
115 6 5 5 5 3 5 3 4 5 6 
115 6 5 5 5 5 5 2 2 
110 6 5 5 5 3 5 5 1 6 
110 6 5 5 5 3 5 1 2 6 
110 6 5 5 5 6 3 4 4 4 2 
105 6 5 5 5 5 5 1 6 
100 6 5 5 5 3 5 5 4 3 2 
95 6 5 5 5 3 5 5 2 4 
95 6 5 5 5 3 5 1 2 2 
95 6 5 5 5 3 5 5 2 1 
95 6 5 5 5 3 5 5 4 4 1 
90 6 5 5 5 5 5 5 1 
90 6 5 5 5 5 4 4 1 5 
90 6 5 5 5 5 5 2 1 
85 6 5 5 5 3 5 5 6 
85 6 5 5 5 3 5 2 6 
85 6 5 5 5 3 5 6 5 
85 6 5 5 5 3 5 5 6 
75 6 5 5 5 3 5 5 2 3 
75 6 5 5 5 3 5 5 5 3 
65 6 5 5 5 3 5 4 6 3 
50 6 5 5 5 3 5 5 3 1 
50 6 5 5 5 3 5 5 1 3 
50 6 5 5 5 3 5 1 2 3 
45 6 5 5 5 5 5 1 3 
30 6 5 5 5 3 5 5 3 3 
-10 6 5 5 5 5 1 
-10 6 5 5 5 5 1 
