745 5 6 5 5 5 5 4 3 2 1 6 1 4 2 5 5 6 3 6 2 2 1 2 5 
745 5 6 5 5 5 5 4 3 2 1 6 1 4 2 5 5 6 3 6 2 2 2 1 5 
745 5 6 5 5 5 5 4 3 2 1 6 1 4 2 5 5 6 3 6 2 1 2 2 5 
720 5 6 5 5 5 5 4 3 2 1 6 1 4 2 5 5 6 3 6 1 1 2 2 2 3 
720 5 6 5 5 5 5 4 3 2 1 6 1 4 2 5 5 6 3 6 2 2 2 1 1 3 
720 5 6 5 5 5 5 4 3 2 1 6 1 4 2 5 5 6 3 6 2 2 1 2 1 3 
720 5 6 5 5 5 5 4 3 2 1 6 1 4 2 5 5 6 3 6 2 1 2 2 4 
710 5 6 5 5 5 5 4 3 2 1 6 1 4 2 5 5 6 3 6 2 1 2 6 
710 5 6 5 5 5 5 4 3 2 1 6 1 4 2 5 5 6 3 6 2 2 1 6 
710 5 6 5 5 5 5 4 3 2 1 6 1 4 2 5 5 6 3 6 2 2 1 6 
710 5 6 5 5 5 5 4 3 2 1 6 1 4 2 5 5 6 3 6 2 2 1 6 
710 5 6 5 5 5 5 4 3 2 1 6 1 4 2 5 5 6 3 6 2 2 1 6 
710 5 6 5 5 5 5 4 3 2 1 6 1 4 2 5 5 6 3 6 2 2 1 6 
710 5 6 5 5 5 5 4 3 2 1 6 1 4 2 5 5 6 3 6 2 2 1 6 
710 5 6 5 5 5 5 4 3 2 1 6 1 4 2 5 5 6 3 6 2 2 1 6 
710 5 6 5 5 5 5 4 3 2 1 6 1 4 2 5 5 6 3 6 2 2 1 6 
710 5 6 5 5 5 5 4 3 2 1 6 1 4 2 5 5 6 3 6 2 2 1 6 
710 5 6 5 5 5 5 4 3 2 1 6 1 4 2 5 5 6 3 6 2 2 1 6 
695 5 6 5 5 5 5 4 3 2 1 6 1 4 2 5 5 6 3 6 2 2 1 5 
695 5 6 5 5 5 5 4 3 2 1 6 1 4 2 5 5 6 3 6 2 2 1 5 
695 5 6 5 5 5 5 4 3 2 1 6 1 4 2 5 5 6 3 6 2 2 1 5 
695 5 6 5 5 5 5 4 3 2 1 6 1 4 2 5 5 6 3 6 1 2 1 1 2 5 
695 5 6 5 5 5 5 4 3 2 1 6 1 4 2 5 5 6 3 6 2 2 1 5 
695 5 6 5 5 5 5 4 3 2 1 6 1 4 2 5 5 6 3 6 2 2 1 1 4 
695 5 6 5 5 5 5 4 3 2 1 6 1 4 2 5 5 6 3 6 2 2 1 5 
695 5 6 5 5 5 5 4 3 2 1 6 1 4 2 5 5 6 3 6 2 2 1 5 
685 5 6 5 5 5 5 4 3 2 1 6 1 4 2 5 5 6 3 6 2 2 6 
685 5 6 5 5 5 5 4 3 2 1 6 1 4 2 5 5 6 3 6 2 2 6 
685 5 6 5 5 5 5 4 3 2 1 6 1 4 2 5 5 6 3 6 2 2 6 
685 5 6 5 5 5 5 4 3 2 1 6 1 4 2 5 5 6 3 6 2 2 6 
685 5 6 5 5 5 5 4 3 2 1 6 1 4 2 5 5 6 3 6 2 2 6 
685 5 6 5 5 5 5 4 3 2 1 6 1 4 2 5 5 6 3 6 2 2 6 
685 5 6 5 5 5 5 4 3 2 1 6 1 4 2 5 5 6 3 6 2 2 6 
685 5 6 5 5 5 5 4 3 2 1 6 1 4 2 5 5 6 3 6 2 2 6 
685 5 6 5 5 5 5 4 3 2 1 6 1 4 2 5 5 6 3 6 2 2 6 
685 5 6 5 5 5 5 4 3 2 1 6 1 4 2 5 5 6 3 6 2 2 6 
685 5 6 5 5 5 5 4 3 2 1 6 1 4 2 5 5 6 3 6 2 2 6 
675 5 6 5 5 5 5 4 3 2 1 6 1 4 2 5 5 6 3 6 2 2 1 1 3 
675 5 6 5 5 5 5 4 3 2 1 6 1 4 2 5 5 6 3 6 2 1 2 1 3 
670 5 6 5 5 5 5 4 3 2 1 6 1 4 2 5 5 6 3 6 2 2 5 
670 5 6 5 5 5 5 4 3 2 1 6 1 4 2 5 5 6 3 6 2 2 5 
670 5 6 5 5 5 5 4 3 2 1 6 1 4 2 5 5 6 3 6 2 2 1 4 
670 5 6 5 5 5 5 4 3 2 1 6 1 4 2 5 5 6 3 6 2 2 1 4 
670 5 6 5 5 5 5 4 3 2 1 6 1 4 2 5 5 6 3 6 2 1 2 4 
670 5 6 5 5 5 5 4 3 2 1 6 1 4 2 5 5 6 3 6 2 2 1 4 
670 5 6 5 5 5 5 4 3 2 1 6 1 4 2 5 5 6 3 6 2 1 1 5 
670 5 6 5 5 5 5 4 3 2 1 6 1 4 2 5 5 6 3 6 2 2 5 
670 5 6 5 5 5 5 4 3 2 1 6 1 4 2 5 5 6 3 6 2 1 1 5 
670 5 6 5 5 5 5 4 3 2 1 6 1 4 2 5 5 6 3 6 2 2 5 
670 5 6 5 5 5 5 4 3 2 1 6 1 4 2 5 5 6 3 6 2 2 1 4 
670 5 6 5 5 5 5 4 3 2 1 6 1 4 2 5 5 6 3 6 2 2 1 4 
660 5 6 5 5 5 5 4 3 2 1 6 1 4 2 5 5 6 3 6 2 1 6 
655 5 6 5 5 5 5 4 3 2 1 6 1 4 2 5 5 6 5 4 3 2 1 1 4 
650 5 6 5 5 5 5 4 3 2 1 6 1 4 2 5 5 6 3 6 2 2 1 3 
650 5 6 5 5 5 5 4 3 2 1 6 1 4 2 5 5 6 3 6 2 2 1 3 
650 5 6 5 5 5 5 4 3 2 1 6 1 4 2 5 5 6 3 6 2 2 1 3 
650 5 6 5 5 5 5 4 3 2 1 6 1 4 2 5 5 6 3 6 2 2 1 3 
650 5 6 5 5 5 5 4 3 2 1 6 1 4 2 5 5 6 3 6 2 2 1 3 
645 5 6 5 5 5 5 4 3 2 1 6 1 4 2 5 5 6 3 6 2 2 4 
645 5 6 5 5 5 5 4 3 2 1 6 1 4 2 5 5 6 3 6 2 1 1 4 
645 5 6 5 5 5 5 4 3 2 1 6 1 4 2 5 5 6 3 6 2 2 4 
645 5 6 5 5 5 5 4 3 2 1 6 1 4 2 5 5 6 3 6 2 2 4 
645 5 6 5 5 5 5 4 3 2 1 6 1 4 2 5 5 6 3 6 2 2 4 
645 5 6 5 5 5 5 4 3 2 1 6 1 4 2 5 5 6 3 6 2 2 4 
645 5 6 5 5 5 5 4 3 2 1 6 1 4 2 5 5 6 3 6 2 2 4 
645 5 6 5 5 5 5 4 3 2 1 6 1 4 2 5 5 6 3 6 2 2 4 
645 5 6 5 5 5 5 4 3 2 1 6 1 4 2 5 5 6 3 6 2 1 5 
645 5 6 5 5 5 5 4 3 2 1 6 1 4 2 5 5 6 3 6 1 2 1 4 
645 5 6 5 5 5 5 4 3 2 1 6 1 4 2 5 5 6 3 6 2 1 5 
645 5 6 5 5 5 5 4 3 2 1 6 1 4 2 5 5 6 3 6 2 1 1 4 
645 5 6 5 5 5 5 4 3 2 1 6 1 4 2 5 5 6 3 6 2 1 5 
635 5 6 5 5 5 5 4 3 2 1 6 1 4 2 5 5 6 3 6 2 6 
635 5 6 5 5 5 5 4 3 2 1 6 1 4 2 5 5 6 3 6 2 6 
635 5 6 5 5 5 5 4 3 2 1 6 1 4 2 5 5 6 3 6 2 6 
625 5 6 5 5 5 5 4 3 2 1 6 1 4 2 5 5 6 3 6 2 2 3 
625 5 6 5 5 5 5 4 3 2 1 6 1 4 2 5 5 6 3 6 2 2 3 
625 5 6 5 5 5 5 4 3 2 1 6 1 4 2 5 5 6 3 6 2 2 3 
625 5 6 5 5 5 5 4 3 2 1 6 1 4 2 5 5 6 3 6 2 2 3 
625 5 6 5 5 5 5 4 3 2 1 6 1 4 2 5 5 6 3 6 2 2 3 
620 5 6 5 5 5 5 4 3 2 1 6 1 4 2 5 5 6 3 6 2 5 
620 5 6 5 5 5 5 4 3 2 1 6 1 4 2 5 5 6 3 6 2 5 
620 5 6 5 5 5 5 4 3 2 1 6 1 4 2 5 5 6 3 6 2 5 
620 5 6 5 5 5 5 4 3 2 1 6 1 4 2 5 5 6 3 6 2 1 4 
620 5 6 5 5 5 5 4 3 2 1 6 1 4 2 5 5 6 3 6 2 5 
615 5 6 5 5 5 5 4 3 2 1 6 1 4 2 5 5 6 5 6 5 
615 5 6 5 5 5 5 4 3 2 1 6 1 4 2 5 5 6 5 6 5 
615 5 6 5 5 5 5 4 3 2 1 6 1 4 2 5 5 6 5 6 2 
610 5 6 5 5 5 5 4 3 2 1 6 1 4 2 5 5 6 3 6 1 6 
600 5 6 5 5 5 5 4 3 2 1 6 1 4 2 5 5 6 3 6 2 1 3 
600 5 6 5 5 5 5 4 3 2 1 6 1 4 2 5 5 6 3 6 2 1 3 
600 5 6 5 5 5 5 4 3 2 1 6 1 4 2 5 5 6 3 6 2 1 3 
600 5 6 5 5 5 5 4 3 2 1 6 1 4 2 5 5 6 3 6 2 1 3 
600 5 6 5 5 5 5 4 3 2 1 6 1 4 2 5 5 6 3 6 1 2 3 
600 5 6 5 5 5 5 4 3 2 1 6 1 4 2 5 5 6 5 4 2 4 
595 5 6 5 5 5 5 4 3 2 1 6 1 4 2 5 5 6 3 6 1 1 4 
595 5 6 5 5 5 5 4 3 2 1 6 1 4 2 5 5 6 3 6 2 4 
595 5 6 5 5 5 5 4 3 2 1 6 1 4 2 5 5 6 3 6 2 4 
595 5 6 5 5 5 5 4 3 2 1 6 1 4 2 5 5 6 3 6 2 4 
595 5 6 5 5 5 5 4 3 2 1 6 1 4 2 5 5 6 3 6 2 4 
595 5 6 5 5 5 5 4 3 2 1 6 1 4 2 5 5 6 3 6 2 4 
590 5 6 5 5 5 5 4 3 2 1 6 1 4 2 5 5 6 5 6 4 
585 5 6 5 5 5 5 4 3 2 1 6 1 4 2 5 5 6 3 6 6 
585 5 6 5 5 5 5 4 3 2 1 6 1 4 2 5 5 6 3 6 6 
585 5 6 5 5 5 5 4 3 2 1 6 1 4 2 5 5 6 3 6 6 
585 5 6 5 5 5 5 4 3 2 1 6 1 4 2 5 5 6 3 6 6 
575 5 6 5 5 5 5 4 3 2 1 6 1 4 2 5 5 6 3 6 2 3 
575 5 6 5 5 5 5 4 3 2 1 6 1 4 2 5 5 6 3 6 2 3 
575 5 6 5 5 5 5 4 3 2 1 6 1 4 2 5 5 6 3 6 2 3 
575 5 6 5 5 5 5 4 3 2 1 6 1 4 2 5 5 6 3 6 2 3 
575 5 6 5 5 5 5 4 3 2 1 6 1 4 2 5 5 6 3 6 2 3 
570 5 6 5 5 5 5 4 3 2 1 6 1 4 2 5 5 6 3 6 5 
570 5 6 5 5 5 5 4 3 2 1 6 1 4 2 5 5 6 5 6 3 
550 5 6 5 5 5 5 4 3 2 1 6 1 4 2 5 5 6 3 6 1 3 
545 5 6 5 5 5 5 4 3 2 1 6 1 4 2 5 5 6 3 6 4 
545 5 6 5 5 5 5 4 3 2 1 6 1 4 2 5 5 6 3 6 4 
545 5 6 5 5 5 5 4 3 2 1 6 1 4 2 5 5 6 3 6 4 
540 5 6 5 5 5 5 4 3 2 1 6 1 4 2 5 5 6 3 3 4 3 5 
535 5 6 5 5 5 5 4 3 2 1 6 1 4 2 5 5 6 4 3 3 2 
530 5 6 5 5 5 5 4 3 2 1 6 1 4 2 5 5 6 3 1 5 
515 5 6 5 5 5 5 4 3 2 1 6 1 4 2 5 5 6 6 
510 5 6 5 5 5 5 4 3 2 1 6 1 4 2 5 5 6 3 3 5 
505 5 6 5 5 5 5 4 3 2 1 6 1 4 2 5 5 6 3 2 
505 5 6 5 5 5 5 4 3 2 1 6 1 4 2 5 5 6 5 3 
505 5 6 5 5 5 5 4 3 2 1 6 1 4 2 5 5 6 3 5 
505 5 6 5 5 5 5 4 3 2 1 6 1 4 2 5 5 6 5 3 
500 5 6 5 5 5 5 4 3 2 1 6 1 4 2 5 5 6 2 
500 5 6 5 5 5 5 4 3 2 1 6 1 4 2 5 5 6 2 
475 5 6 5 5 5 5 4 3 2 1 6 1 4 2 5 5 6 1 
