815 5 6 5 5 5 5 5 2 6 2 2 1 2 5 6 6 5 6 6 2 5 4 
815 5 6 5 5 5 5 5 2 6 2 2 1 2 5 6 6 5 6 6 2 
815 5 6 5 5 5 5 5 2 6 2 2 1 2 5 6 6 5 6 6 2 5 
815 5 6 5 5 5 5 5 2 6 2 2 1 2 5 6 6 5 6 6 2 
815 5 6 5 5 5 5 5 2 6 2 2 1 2 5 6 6 5 6 6 2 5 4 
815 5 6 5 5 5 5 5 2 6 2 2 1 2 5 6 6 5 6 6 2 5 4 
815 5 6 5 5 5 5 5 2 6 2 2 1 2 5 6 6 5 6 6 2 5 
815 5 6 5 5 5 5 5 2 6 2 2 1 2 5 6 6 5 6 6 2 5 
815 5 6 5 5 5 5 5 2 6 2 2 1 2 5 6 6 5 6 6 2 5 
815 5 6 5 5 5 5 5 2 6 2 2 1 2 5 6 6 5 6 6 2 5 
815 5 6 5 5 5 5 5 2 6 2 2 1 2 5 6 6 5 6 6 2 5 4 6 
815 5 6 5 5 5 5 5 2 6 2 2 1 2 5 6 6 5 6 6 2 5 4 
815 5 6 5 5 5 5 5 2 6 2 2 1 2 5 6 6 5 6 6 2 5 4 
815 5 6 5 5 5 5 5 2 6 2 2 1 2 5 6 6 5 6 6 2 
815 5 6 5 5 5 5 5 2 6 2 2 1 2 5 6 6 5 6 6 2 5 
815 5 6 5 5 5 5 5 2 6 2 2 1 2 5 6 6 5 6 6 2 5 4 
815 5 6 5 5 5 5 5 2 6 2 2 1 2 5 6 6 5 6 6 2 5 
815 5 6 5 5 5 5 5 2 6 2 2 1 2 5 6 6 5 6 6 2 5 4 6 
815 5 6 5 5 5 5 5 2 6 2 2 1 2 5 6 6 5 6 6 2 5 4 
815 5 6 5 5 5 5 5 2 6 2 2 1 2 5 6 6 5 6 6 2 5 4 
815 5 6 5 5 5 5 5 2 6 2 2 1 2 5 6 6 5 6 6 2 5 
815 5 6 5 5 5 5 5 2 6 2 2 1 2 5 6 6 5 6 6 2 5 
815 5 6 5 5 5 5 5 2 6 2 2 1 2 5 6 6 5 6 6 2 
815 5 6 5 5 5 5 5 2 6 2 2 1 2 5 6 6 5 6 6 2 5 
815 5 6 5 5 5 5 5 2 6 2 2 1 2 5 6 6 5 6 6 2 5 
785 5 6 5 5 5 5 5 2 6 2 2 1 2 5 6 6 5 6 6 2 
770 5 6 5 5 5 5 5 2 6 2 2 1 2 5 6 6 5 6 6 2 5 4 4 6 1 6 4 2 
765 5 6 5 5 5 5 5 2 6 2 2 1 2 5 6 6 5 6 6 2 6 1 3 6 1 
760 5 6 5 5 5 5 5 2 6 2 2 1 2 5 6 6 5 6 6 2 5 4 
750 5 6 5 5 5 5 5 2 6 2 2 1 2 5 6 6 4 6 4 2 2 
745 5 6 5 5 5 5 5 2 6 2 2 1 2 5 6 6 5 6 6 2 2 
740 5 6 5 5 5 5 5 2 6 2 2 1 2 5 6 6 5 6 6 2 5 5 
735 5 6 5 5 5 5 5 2 6 2 2 1 2 5 6 6 4 6 3 3 6 
730 5 6 5 5 5 5 5 2 6 2 2 1 2 5 6 6 5 6 6 2 5 4 5 3 1 2 
725 5 6 5 5 5 5 5 2 6 2 2 1 2 5 6 6 4 4 6 2 1 
725 5 6 5 5 5 5 5 2 6 2 2 1 2 5 6 6 5 6 6 2 
725 5 6 5 5 5 5 5 2 6 2 2 1 2 5 6 6 4 4 4 6 2 5 
720 5 6 5 5 5 5 5 2 6 2 2 1 2 5 6 6 4 3 4 
720 5 6 5 5 5 5 5 2 6 2 2 1 2 5 6 6 4 3 2 3 5 
720 5 6 5 5 5 5 5 2 6 2 2 1 2 5 6 6 4 3 5 5 4 
710 5 6 5 5 5 5 5 2 6 2 2 1 2 5 6 6 5 6 6 2 1 6 2 3 
710 5 6 5 5 5 5 5 2 6 2 2 1 2 5 6 6 5 6 6 2 5 
710 5 6 5 5 5 5 5 2 6 2 2 1 2 5 6 6 5 6 6 2 5 5 5 3 
705 5 6 5 5 5 5 5 2 6 2 2 1 2 5 6 6 5 6 6 2 3 5 5 2 
705 5 6 5 5 5 5 5 2 6 2 2 1 2 5 6 6 1 6 5 4 3 6 
680 5 6 5 5 5 5 5 2 6 2 2 1 2 5 6 6 4 3 6 4 
675 5 6 5 5 5 5 5 2 6 2 2 1 2 5 6 6 5 6 6 2 5 1 2 3 1 5 
615 5 6 5 5 5 5 5 2 6 2 2 1 2 5 6 6 5 6 6 2 
