835 6 5 5 5 5 5 3 5 6 5 5 5 6 6 5 3 4 1 6 2 2 2 1 2 4 6 
825 6 5 5 5 5 5 3 5 6 5 5 5 6 6 5 3 4 1 6 2 2 2 1 6 
825 6 5 5 5 5 5 3 5 6 5 5 5 6 6 5 3 4 1 6 2 2 2 1 6 
825 6 5 5 5 5 5 3 5 6 5 5 5 6 6 5 3 4 1 6 2 2 2 1 6 
825 6 5 5 5 5 5 3 5 6 5 5 5 6 6 5 3 4 1 6 2 2 2 1 6 
810 6 5 5 5 5 5 3 5 6 5 5 5 6 6 5 3 4 1 6 2 2 2 1 5 
810 6 5 5 5 5 5 3 5 6 5 5 5 6 6 5 3 4 1 6 2 2 2 1 1 4 
800 6 5 5 5 5 5 3 5 6 5 5 5 6 6 5 3 4 1 6 2 2 2 6 
800 6 5 5 5 5 5 3 5 6 5 5 5 6 6 5 3 4 1 6 2 2 2 6 
800 6 5 5 5 5 5 3 5 6 5 5 5 6 6 5 3 4 1 6 2 2 2 6 
800 6 5 5 5 5 5 3 5 6 5 5 5 6 6 5 3 4 1 6 2 2 2 6 
785 6 5 5 5 5 5 3 5 6 5 5 5 6 6 5 3 4 1 6 2 2 2 1 4 
785 6 5 5 5 5 5 3 5 6 5 5 5 6 6 5 3 4 1 6 2 2 2 5 
785 6 5 5 5 5 5 3 5 6 5 5 5 6 6 5 3 4 1 6 2 2 2 5 
785 6 5 5 5 5 5 3 5 6 5 5 5 6 6 5 3 4 1 6 2 2 2 1 4 
785 6 5 5 5 5 5 3 5 6 5 5 5 6 6 5 3 4 1 6 2 2 2 1 4 
775 6 5 5 5 5 5 3 5 6 5 5 5 6 6 5 3 4 1 6 2 2 1 6 
770 6 5 5 5 5 5 3 5 6 5 5 5 6 1 6 6 4 1 2 2 2 6 
765 6 5 5 5 5 5 3 5 6 5 5 5 6 6 5 3 4 1 6 2 2 2 1 3 
765 6 5 5 5 5 5 3 5 6 5 5 5 6 6 5 3 4 1 6 2 2 2 1 3 
760 6 5 5 5 5 5 3 5 6 5 5 5 6 6 5 3 4 1 6 2 2 2 4 
750 6 5 5 5 5 5 3 5 6 5 5 5 6 6 5 3 4 1 6 2 2 6 
750 6 5 5 5 5 5 3 5 6 5 5 5 6 6 5 3 4 1 6 2 2 6 
750 6 5 5 5 5 5 3 5 6 5 5 5 6 6 5 3 4 1 6 2 2 6 
750 6 5 5 5 5 5 3 5 6 5 5 5 6 6 5 3 4 1 6 2 2 6 
740 6 5 5 5 5 5 3 5 6 5 5 5 6 6 5 3 4 1 6 2 2 2 3 
740 6 5 5 5 5 5 3 5 6 5 5 5 6 6 6 3 3 1 4 2 2 2 1 4 
740 6 5 5 5 5 5 3 5 6 5 5 5 6 6 5 3 4 1 6 2 2 2 3 
740 6 5 5 5 5 5 3 5 6 5 5 5 6 6 5 3 4 1 6 2 2 2 3 
735 6 5 5 5 5 5 3 5 6 5 5 5 6 6 5 3 4 1 6 2 2 5 
710 6 5 5 5 5 5 3 5 6 5 5 5 6 6 5 3 4 1 6 2 2 4 
710 6 5 5 5 5 5 3 5 6 5 5 5 6 6 5 3 4 1 6 2 2 4 
710 6 5 5 5 5 5 3 5 6 5 5 5 6 6 5 3 4 1 6 2 2 4 
705 6 5 5 5 5 5 3 5 6 5 5 5 6 1 5 6 4 2 1 2 6 
690 6 5 5 5 5 5 3 5 6 5 5 5 6 6 5 3 4 1 6 2 2 3 
690 6 5 5 5 5 5 3 5 6 5 5 5 6 6 5 3 4 1 6 2 2 3 
680 6 5 5 5 5 5 3 5 6 5 5 5 6 6 6 2 2 2 5 
645 6 5 5 5 5 5 3 5 6 5 5 5 6 6 6 1 4 5 6 
645 6 5 5 5 5 5 3 5 6 5 5 5 6 5 6 1 3 2 2 5 
635 6 5 5 5 5 5 3 5 6 5 5 5 6 6 6 3 4 2 2 4 
630 6 5 5 5 5 5 3 5 6 5 5 5 6 5 6 6 2 5 
625 6 5 5 5 5 5 3 5 6 5 5 5 6 6 3 5 2 1 3 1 5 
615 6 5 5 5 5 5 3 5 6 5 5 5 6 6 3 4 4 3 4 2 6 
600 6 5 5 5 5 5 3 5 6 5 5 5 6 4 6 3 3 4 2 2 4 
590 6 5 5 5 5 5 3 5 6 5 5 5 6 6 3 6 1 3 4 5 
565 6 5 5 5 5 5 3 5 6 5 5 5 6 1 6 3 6 5 3 
555 6 5 5 5 5 5 3 5 6 5 5 5 6 6 3 5 5 3 1 3 
550 6 5 5 5 5 5 3 5 6 5 2 5 6 4 5 6 5 3 3 3 1 2 2 
495 6 5 5 5 5 5 3 5 6 5 5 5 6 6 4 3 2 
465 6 5 5 5 5 5 3 5 6 5 5 5 6 6 2 
465 6 5 5 5 5 5 3 5 6 5 5 5 6 1 6 1 
445 6 5 5 5 5 5 3 5 6 5 5 5 3 6 6 1 
405 6 5 5 5 5 5 3 5 6 5 5 5 6 4 4 3 
405 6 5 5 5 5 5 3 5 6 5 5 5 6 5 3 
400 6 5 5 5 5 5 3 5 6 5 5 5 6 2 
400 6 5 5 5 5 5 3 5 6 5 5 5 6 2 
395 6 5 5 5 5 5 3 5 6 5 1 6 6 4 3 1 
385 6 5 5 5 5 5 3 5 6 3 6 6 6 5 
380 6 5 5 5 5 5 3 5 6 6 6 6 2 
370 6 5 5 5 5 5 3 5 6 2 1 6 3 6 1 
335 6 5 5 5 5 5 3 5 6 5 5 5 5 
315 6 5 5 5 5 5 3 5 6 5 5 5 3 1 
310 6 5 5 5 5 5 3 5 6 5 5 5 1 
265 6 5 5 5 5 5 3 5 6 5 3 2 1 
