145 4 2 5 5 5 5 5 3 5 6 
145 4 2 5 5 5 5 5 3 5 6 
145 4 2 5 5 5 5 5 3 5 6 
145 4 2 5 5 5 5 5 3 5 6 
140 4 2 5 5 5 5 5 2 6 
130 4 2 5 5 5 5 5 3 5 2 
130 4 2 5 5 5 5 5 3 5 5 
130 4 2 5 5 5 5 5 3 5 5 
130 4 2 5 5 5 5 5 3 5 5 
130 4 2 5 5 5 5 5 3 5 2 
125 4 2 5 5 5 5 5 4 4 5 
125 4 2 5 5 5 5 5 2 5 
120 4 2 5 5 5 5 5 3 4 6 
120 4 2 5 5 5 5 5 3 4 6 
105 4 2 5 5 5 5 5 4 3 2 
105 4 2 5 5 5 5 5 3 5 1 
105 4 2 5 5 5 5 5 3 5 1 
105 4 2 5 5 5 5 5 3 5 4 
105 4 2 5 5 5 5 5 3 5 4 
100 4 2 5 5 5 5 5 5 1 
100 4 2 5 5 5 5 5 5 1 
100 4 2 5 5 5 5 5 3 3 6 
100 4 2 5 5 5 5 5 5 4 
100 4 2 5 5 5 5 5 5 1 
95 4 2 5 5 5 5 5 3 6 
95 4 2 5 5 5 5 5 3 6 
90 4 2 5 5 5 5 5 6 
90 4 2 5 5 5 5 5 6 
90 4 2 5 5 5 5 5 6 
85 4 2 5 5 5 5 5 3 3 5 
85 4 2 5 5 5 5 5 3 2 3 
85 4 2 5 5 5 5 5 3 3 5 
85 4 2 5 5 5 5 5 3 5 3 
80 4 2 5 5 5 5 5 4 3 1 
80 4 2 5 5 5 5 5 2 3 
80 4 2 5 5 5 5 5 5 3 
75 4 2 5 5 5 5 5 1 4 
75 4 2 5 5 5 5 5 1 1 
65 4 2 5 5 5 5 6 1 
60 4 2 5 5 5 5 5 3 4 3 6 
60 4 2 5 5 5 5 5 4 3 3 5 
55 4 2 5 5 5 5 5 1 3 
25 4 2 5 5 5 5 2 
25 4 2 5 5 5 5 2 
25 4 2 5 5 5 5 2 
0 4 2 5 5 5 5 1 
0 4 2 5 5 5 5 1 
-20 4 2 5 5 5 5 3 
