825 5 6 5 5 5 5 5 2 6 2 2 1 2 5 6 6 5 6 6 2 5 4 6 1 3 
800 5 6 5 5 5 5 5 2 5 6 6 6 1 6 4 1 5 3 5 
790 5 6 5 5 5 5 5 2 5 2 3 2 2 2 5 6 5 5 4 
780 5 6 5 5 5 5 5 2 6 2 2 1 2 5 6 6 5 1 2 2 2 2 5 1 
765 5 6 5 5 5 5 5 2 6 2 2 1 2 5 6 6 4 3 4 6 6 3 6 4 
760 5 6 5 5 5 5 5 2 6 2 2 1 2 5 1 6 2 2 4 1 3 5 3 
755 5 6 5 5 5 5 5 2 6 2 2 1 2 5 6 6 5 1 5 5 1 2 2 1 
755 5 6 5 5 5 5 5 2 5 6 6 4 2 2 1 3 6 
740 5 6 5 5 5 5 5 2 5 4 6 6 6 3 4 2 5 3 6 
735 5 6 5 5 5 5 5 2 6 2 2 1 2 5 6 6 4 4 4 6 2 5 3 4 3 
725 5 6 5 5 5 5 5 2 5 4 6 5 1 5 6 3 4 2 2 5 
720 5 6 5 5 5 5 5 2 6 2 2 1 2 5 1 4 3 4 2 1 3 2 2 
720 5 6 5 5 5 5 5 2 6 2 2 1 2 5 6 6 5 1 2 1 1 6 2 
720 5 6 5 5 5 5 5 2 6 2 2 1 2 5 6 6 4 6 4 2 2 1 4 3 
710 5 6 5 5 5 5 5 2 6 2 2 1 2 5 6 4 2 5 4 3 2 4 5 2 
705 5 6 5 5 5 5 5 2 6 2 2 1 2 5 6 6 4 3 2 3 5 5 6 5 
700 5 6 5 5 5 5 5 2 6 2 2 1 2 5 6 6 4 3 6 4 4 5 5 4 3 
695 5 6 5 5 5 5 5 2 6 2 2 1 2 5 3 5 4 1 6 6 1 3 4 
695 5 6 5 5 5 5 5 2 6 2 2 1 2 5 6 6 1 6 5 4 3 6 3 3 
695 5 6 5 5 5 5 5 2 6 2 2 1 2 5 6 6 4 4 6 2 1 4 1 4 5 
685 5 6 5 5 5 5 5 2 5 4 6 3 5 6 4 3 6 
680 5 6 5 5 5 5 5 2 5 4 2 3 1 6 5 5 1 5 6 
655 5 6 5 5 5 5 5 2 6 2 2 1 2 5 6 6 4 3 1 3 1 5 6 6 
655 5 6 5 5 5 5 5 2 6 2 2 1 2 5 6 6 4 6 3 3 5 4 2 
655 5 6 5 5 5 5 5 2 6 2 2 1 2 5 6 6 4 3 5 3 1 6 4 
650 5 6 5 5 5 5 5 2 5 4 1 2 1 1 6 1 5 4 
645 5 6 5 5 5 5 5 2 5 2 1 4 3 4 5 5 6 
645 5 6 5 5 5 5 5 2 6 2 2 1 2 5 6 3 1 1 1 1 3 1 1 
640 5 6 5 5 5 5 5 2 6 2 2 1 2 5 6 6 5 3 3 1 4 5 2 
640 5 6 5 5 5 5 5 2 5 4 6 2 3 1 6 4 6 3 1 4 4 
600 5 6 5 5 5 5 5 2 5 4 6 3 1 3 5 1 6 2 1 2 4 4 
590 5 6 5 5 5 5 5 2 5 4 6 5 3 2 3 1 2 
570 5 6 5 5 5 5 5 2 5 3 1 3 3 5 5 6 1 
335 5 6 5 5 5 5 5 2 5 1 3 5 4 6 
320 5 6 5 5 5 5 5 2 5 3 4 5 4 2 
320 5 6 5 5 5 5 5 2 5 4 6 6 
315 5 6 5 5 5 5 5 2 5 1 5 1 5 
315 5 6 5 5 5 5 5 2 6 6 3 6 
305 5 6 5 5 5 5 5 2 5 4 6 2 
305 5 6 5 5 5 5 5 2 5 4 6 5 
305 5 6 5 5 5 5 5 2 5 4 6 5 
290 5 6 5 5 5 5 5 2 5 4 5 5 
290 5 6 5 5 5 5 5 2 5 4 2 2 
285 5 6 5 5 5 5 5 2 5 3 5 6 
280 5 6 5 5 5 5 5 2 5 4 6 1 
265 5 6 5 5 5 5 5 2 5 4 3 6 3 
255 5 6 5 5 5 5 5 2 3 5 3 4 3 1 1 6 
-115 5 6 5 5 5 5 5 2 5 
