140 4 2 5 5 5 5 5 2 6 
140 4 2 5 5 5 5 5 5 6 
125 4 2 5 5 5 5 5 5 2 
125 4 2 5 5 5 5 5 5 2 
125 4 2 5 5 5 5 5 5 5 
125 4 2 5 5 5 5 5 5 2 
125 4 2 5 5 5 5 5 5 2 
125 4 2 5 5 5 5 5 5 2 
125 4 2 5 5 5 5 5 5 2 
125 4 2 5 5 5 5 5 5 5 
125 4 2 5 5 5 5 5 2 5 
125 4 2 5 5 5 5 5 5 2 
115 4 2 5 5 5 5 4 6 5 
115 4 2 5 5 5 5 4 6 2 
115 4 2 5 5 5 5 5 4 6 
115 4 2 5 5 5 5 4 6 2 
100 4 2 5 5 5 5 5 5 4 
100 4 2 5 5 5 5 5 4 2 
100 4 2 5 5 5 5 5 5 4 
100 4 2 5 5 5 5 5 5 1 
100 4 2 5 5 5 5 5 5 1 
100 4 2 5 5 5 5 5 2 4 
100 4 2 5 5 5 5 5 5 1 
100 4 2 5 5 5 5 5 5 4 
100 4 2 5 5 5 5 5 5 1 
100 4 2 5 5 5 5 5 2 4 
100 4 2 5 5 5 5 5 4 2 
90 4 2 5 5 5 5 5 6 
80 4 2 5 5 5 5 5 2 3 
80 4 2 5 5 5 5 5 3 5 2 
80 4 2 5 5 5 5 5 2 3 
80 4 2 5 5 5 5 5 5 3 
75 4 2 5 5 5 5 4 5 1 
75 4 2 5 5 5 5 5 4 1 5 
75 4 2 5 5 5 5 5 1 1 
75 4 2 5 5 5 5 5 4 1 3 
65 4 2 5 5 5 5 6 4 
65 4 2 5 5 5 5 6 4 
55 4 2 5 5 5 5 5 4 3 2 
55 4 2 5 5 5 5 4 3 2 3 
55 4 2 5 5 5 5 4 3 2 1 
45 4 2 5 5 5 5 6 3 
25 4 2 5 5 5 5 2 
25 4 2 5 5 5 5 2 
25 4 2 5 5 5 4 4 2 
25 4 2 5 5 5 5 2 
-20 4 2 5 5 5 5 3 
-20 4 2 5 5 5 5 3 
