210 4 2 5 5 5 5 5 3 4 3 2 5 2 6 
145 4 2 5 5 5 5 5 3 5 6 
140 4 2 5 5 5 5 5 5 6 
140 4 2 5 5 5 5 5 2 6 
140 4 2 5 5 5 5 5 5 6 
130 4 2 5 5 5 5 5 3 2 5 
130 4 2 5 5 5 5 5 3 5 5 
130 4 2 5 5 5 5 5 3 5 5 
125 4 2 5 5 5 5 5 5 2 
125 4 2 5 5 5 5 5 5 2 
125 4 2 5 5 5 5 5 3 4 3 6 
120 4 2 5 5 5 5 5 3 4 6 
115 4 2 5 5 5 5 5 4 6 
115 4 2 5 5 5 5 5 1 6 
105 4 2 5 5 5 5 5 3 5 1 
105 4 2 5 5 5 5 5 3 4 2 
105 4 2 5 5 5 5 5 3 2 4 
105 4 2 5 5 5 5 5 3 5 1 
105 4 2 5 5 5 5 5 3 5 1 
105 4 2 5 5 5 5 5 3 2 4 
105 4 2 5 5 5 5 5 3 5 1 
105 4 2 5 5 5 5 5 4 3 2 
100 4 2 5 5 5 5 5 3 3 6 
100 4 2 5 5 5 5 5 1 2 
100 4 2 5 5 5 5 5 4 5 
100 4 2 5 5 5 5 5 2 1 
100 4 2 5 5 5 5 5 4 4 1 
100 4 2 5 5 5 5 5 2 4 
95 4 2 5 5 5 5 5 3 6 
95 4 2 5 5 5 5 5 3 6 
95 4 2 5 5 5 5 5 3 6 
95 4 2 5 5 5 5 5 3 6 
90 4 2 5 5 5 5 5 6 
85 4 2 5 5 5 5 5 3 2 3 
85 4 2 5 5 5 5 5 3 2 3 
85 4 2 5 5 5 5 5 3 5 3 
85 4 2 5 5 5 5 5 3 4 4 3 
85 4 2 5 5 5 5 5 3 4 3 4 
85 4 2 5 5 5 5 5 3 5 3 
85 4 2 5 5 5 5 5 3 5 3 
85 4 2 5 5 5 5 5 3 5 3 
85 4 2 5 5 5 5 5 3 5 3 
80 4 2 5 5 5 5 5 3 1 1 
80 4 2 5 5 5 5 5 5 3 
80 4 2 5 5 5 5 5 3 1 1 
80 4 2 5 5 5 5 5 3 1 1 
60 4 2 5 5 5 5 5 3 3 4 
-20 4 2 5 5 5 5 3 
