940 5 6 5 5 5 5 4 3 2 1 6 1 4 2 5 5 6 3 6 2 2 1 2 1 2 4 2 3 4 6 
935 5 6 5 5 5 5 4 3 2 1 6 1 4 2 5 5 6 3 6 2 2 1 2 1 2 3 4 6 6 3 2 
895 5 6 5 5 5 5 4 3 2 1 6 1 4 2 5 5 6 3 6 2 2 1 2 2 2 2 2 
890 5 6 5 5 5 5 4 3 2 1 6 1 4 2 5 5 6 3 6 2 2 1 2 1 2 6 3 4 4 
885 5 6 5 5 5 5 4 3 2 1 6 1 4 2 5 5 6 3 6 2 2 1 2 1 2 6 5 
885 5 6 5 5 5 5 4 3 2 1 6 1 4 2 5 5 6 3 6 2 2 1 2 1 2 6 2 
870 5 6 5 5 5 5 4 3 2 1 6 1 4 2 5 5 6 3 6 2 2 1 2 1 2 1 5 4 
870 5 6 5 5 5 5 4 3 2 1 6 1 4 2 5 5 6 3 6 2 2 1 2 1 1 2 2 1 
860 5 6 5 5 5 5 4 3 2 1 6 1 4 2 5 5 6 3 6 2 2 1 2 1 2 6 4 
860 5 6 5 5 5 5 4 3 2 1 6 1 4 2 5 5 6 3 6 2 2 1 2 1 2 1 6 
860 5 6 5 5 5 5 4 3 2 1 6 1 4 2 5 5 6 3 6 2 2 1 2 1 2 6 4 
825 5 6 5 5 5 5 4 3 2 1 6 1 4 2 5 5 6 3 6 2 2 1 2 1 2 3 2 
825 5 6 5 5 5 5 4 3 2 1 6 1 4 2 5 5 6 3 6 2 2 1 2 2 1 3 2 
825 5 6 5 5 5 5 4 3 2 1 6 1 4 2 5 5 6 3 6 2 2 1 2 1 1 1 3 5 
820 5 6 5 5 5 5 4 3 2 1 6 1 4 2 5 5 6 3 6 2 2 1 2 1 2 5 
820 5 6 5 5 5 5 4 3 2 1 6 1 4 2 5 5 6 3 6 2 2 1 2 1 2 2 
820 5 6 5 5 5 5 4 3 2 1 6 1 4 2 5 5 6 3 6 2 2 1 2 1 2 5 
820 5 6 5 5 5 5 4 3 2 1 6 1 4 2 5 5 6 3 6 2 2 1 2 1 2 2 
820 5 6 5 5 5 5 4 3 2 1 6 1 4 2 5 5 6 3 6 2 2 1 2 1 2 2 
820 5 6 5 5 5 5 4 3 2 1 6 1 4 2 5 5 6 3 6 2 2 1 2 1 2 5 
820 5 6 5 5 5 5 4 3 2 1 6 1 4 2 5 5 6 3 6 2 2 1 2 1 2 5 
820 5 6 5 5 5 5 4 3 2 1 6 1 4 2 5 5 6 3 6 2 2 1 2 1 2 2 
820 5 6 5 5 5 5 4 3 2 1 6 1 4 2 5 5 6 3 6 2 2 1 2 1 2 2 
820 5 6 5 5 5 5 4 3 2 1 6 1 4 2 5 5 6 3 6 2 2 1 2 1 1 2 1 
820 5 6 5 5 5 5 4 3 2 1 6 1 4 2 5 5 6 3 6 2 2 1 2 2 2 1 
820 5 6 5 5 5 5 4 3 2 1 6 1 4 2 5 5 6 3 6 2 2 1 2 1 2 2 
820 5 6 5 5 5 5 4 3 2 1 6 1 4 2 5 5 6 3 6 2 2 1 2 1 2 2 
820 5 6 5 5 5 5 4 3 2 1 6 1 4 2 5 5 6 3 6 2 2 1 2 1 2 5 
820 5 6 5 5 5 5 4 3 2 1 6 1 4 2 5 5 6 3 6 2 2 1 2 1 2 5 
810 5 6 5 5 5 5 4 3 2 1 6 1 4 2 5 5 6 3 6 2 2 1 2 1 1 6 
810 5 6 5 5 5 5 4 3 2 1 6 1 4 2 5 5 6 3 6 2 2 1 2 2 6 
810 5 6 5 5 5 5 4 3 2 1 6 1 4 2 5 5 6 3 6 2 2 1 1 1 2 6 
795 5 6 5 5 5 5 4 3 2 1 6 1 4 2 5 5 6 3 6 2 1 2 2 2 5 
795 5 6 5 5 5 5 4 3 2 1 6 1 4 2 5 5 6 3 6 2 2 1 2 2 5 
795 5 6 5 5 5 5 4 3 2 1 6 1 4 2 5 5 6 3 6 2 2 1 2 2 5 
795 5 6 5 5 5 5 4 3 2 1 6 1 4 2 5 5 6 3 6 2 2 1 2 2 5 
795 5 6 5 5 5 5 4 3 2 1 6 1 4 2 5 5 6 3 6 2 2 1 2 2 5 
785 5 6 5 5 5 5 4 3 2 1 6 1 4 2 5 5 6 3 6 2 2 1 2 1 6 
785 5 6 5 5 5 5 4 3 2 1 6 1 4 2 5 5 6 3 6 2 2 1 2 1 6 
785 5 6 5 5 5 5 4 3 2 1 6 1 4 2 5 5 6 3 6 2 2 1 2 1 6 
785 5 6 5 5 5 5 4 3 2 1 6 1 4 2 5 5 6 3 6 2 2 1 2 1 6 
780 5 6 5 5 5 5 4 3 2 1 6 1 4 2 5 5 6 3 6 2 2 1 2 1 2 3 3 
780 5 6 5 5 5 5 4 3 2 1 6 1 4 2 5 5 6 3 6 2 2 1 2 1 2 3 3 
770 5 6 5 5 5 5 4 3 2 1 6 1 4 2 5 5 6 3 6 2 2 1 2 1 5 
770 5 6 5 5 5 5 4 3 2 1 6 1 4 2 5 5 6 3 6 2 2 2 1 2 4 
770 5 6 5 5 5 5 4 3 2 1 6 1 4 2 5 5 6 3 6 2 2 2 1 1 5 
770 5 6 5 5 5 5 4 3 2 1 6 1 4 2 5 5 6 3 6 2 2 1 2 1 5 
770 5 6 5 5 5 5 4 3 2 1 6 1 4 2 5 5 6 3 6 2 2 1 2 1 5 
760 5 6 5 5 5 5 4 3 2 1 6 1 4 2 5 5 6 3 6 2 2 1 2 6 
760 5 6 5 5 5 5 4 3 2 1 6 1 4 2 5 5 6 3 6 2 2 1 2 6 
760 5 6 5 5 5 5 4 3 2 1 6 1 4 2 5 5 6 3 6 2 2 1 2 6 
760 5 6 5 5 5 5 4 3 2 1 6 1 4 2 5 5 6 3 6 2 2 1 2 6 
760 5 6 5 5 5 5 4 3 2 1 6 1 4 2 5 5 6 3 6 2 2 2 1 6 
750 5 6 5 5 5 5 4 3 2 1 6 1 4 2 5 5 6 3 6 2 2 1 2 1 1 3 
750 5 6 5 5 5 5 4 3 2 1 6 1 4 2 5 5 6 3 6 2 2 2 2 1 3 
750 5 6 5 5 5 5 4 3 2 1 6 1 4 2 5 5 6 3 6 2 2 1 2 2 3 
745 5 6 5 5 5 5 4 3 2 1 6 1 4 2 5 5 6 3 6 2 2 2 2 4 
745 5 6 5 5 5 5 4 3 2 1 6 1 4 2 5 5 6 3 6 2 2 1 2 1 4 
745 5 6 5 5 5 5 4 3 2 1 6 1 4 2 5 5 6 3 6 2 2 1 2 5 
745 5 6 5 5 5 5 4 3 2 1 6 1 4 2 5 5 6 3 6 2 1 2 1 1 5 
745 5 6 5 5 5 5 4 3 2 1 6 1 4 2 5 5 6 3 6 2 2 1 2 5 
745 5 6 5 5 5 5 4 3 2 1 6 1 4 2 5 5 6 3 6 2 2 1 2 5 
745 5 6 5 5 5 5 4 3 2 1 6 1 4 2 5 5 6 3 6 2 2 1 2 1 4 
745 5 6 5 5 5 5 4 3 2 1 6 1 4 2 5 5 6 3 6 2 2 1 2 5 
745 5 6 5 5 5 5 4 3 2 1 6 1 4 2 5 5 6 3 6 2 2 1 1 1 5 
745 5 6 5 5 5 5 4 3 2 1 6 1 4 2 5 5 6 3 6 2 2 1 2 5 
745 5 6 5 5 5 5 4 3 2 1 6 1 4 2 5 5 6 3 6 2 2 1 1 2 4 
745 5 6 5 5 5 5 4 3 2 1 6 1 4 2 5 5 6 3 6 2 2 1 2 5 
745 5 6 5 5 5 5 4 3 2 1 6 1 4 2 5 5 6 3 6 2 2 1 2 1 4 
735 5 6 5 5 5 5 4 3 2 1 6 1 4 2 5 5 6 3 6 2 2 2 6 
735 5 6 5 5 5 5 4 3 2 1 6 1 4 2 5 5 6 3 6 2 2 2 6 
725 5 6 5 5 5 5 4 3 2 1 6 1 4 2 5 5 6 3 6 2 2 1 2 1 3 
725 5 6 5 5 5 5 4 3 2 1 6 1 4 2 5 5 6 3 6 2 2 1 2 1 3 
725 5 6 5 5 5 5 4 3 2 1 6 1 4 2 5 5 6 3 6 2 2 1 2 1 3 
725 5 6 5 5 5 5 4 3 2 1 6 1 4 2 5 5 6 3 6 2 2 1 2 1 3 
725 5 6 5 5 5 5 4 3 2 1 6 1 4 2 5 5 6 3 6 2 2 1 2 1 3 
725 5 6 5 5 5 5 4 3 2 1 6 1 4 2 5 5 6 3 6 2 2 1 2 1 3 
720 5 6 5 5 5 5 4 3 2 1 6 1 4 2 5 5 6 3 6 2 2 1 2 4 
720 5 6 5 5 5 5 4 3 2 1 6 1 4 2 5 5 6 3 6 2 2 1 2 4 
720 5 6 5 5 5 5 4 3 2 1 6 1 4 2 5 5 6 3 6 2 2 1 2 4 
720 5 6 5 5 5 5 4 3 2 1 6 1 4 2 5 5 6 3 6 2 2 1 2 4 
720 5 6 5 5 5 5 4 3 2 1 6 1 4 2 5 5 6 3 6 2 2 1 1 1 4 
720 5 6 5 5 5 5 4 3 2 1 6 1 4 2 5 5 6 3 6 2 2 1 2 4 
720 5 6 5 5 5 5 4 3 2 1 6 1 4 2 5 5 6 3 6 2 2 1 2 4 
720 5 6 5 5 5 5 4 3 2 1 6 1 4 2 5 5 6 3 6 2 2 1 2 4 
720 5 6 5 5 5 5 4 3 2 1 6 1 4 2 5 5 6 3 6 1 1 2 2 5 
710 5 6 5 5 5 5 4 3 2 1 6 1 4 2 5 5 6 3 6 2 2 1 6 
710 5 6 5 5 5 5 4 3 2 1 6 1 4 2 5 5 6 3 6 2 2 1 6 
710 5 6 5 5 5 5 4 3 2 1 6 1 4 2 5 5 6 3 6 2 2 1 6 
700 5 6 5 5 5 5 4 3 2 1 6 1 4 2 5 5 6 3 6 2 2 1 2 3 
700 5 6 5 5 5 5 4 3 2 1 6 1 4 2 5 5 6 3 6 2 2 1 2 3 
700 5 6 5 5 5 5 4 3 2 1 6 1 4 2 5 5 6 3 6 2 2 1 2 3 
700 5 6 5 5 5 5 4 3 2 1 6 1 4 2 5 5 6 3 6 2 2 1 2 3 
700 5 6 5 5 5 5 4 3 2 1 6 1 4 2 5 5 6 3 6 2 2 1 2 3 
700 5 6 5 5 5 5 4 3 2 1 6 1 4 2 5 5 6 3 6 2 2 1 2 3 
700 5 6 5 5 5 5 4 3 2 1 6 1 4 2 5 5 6 3 6 2 2 1 2 3 
695 5 6 5 5 5 5 4 3 2 1 6 1 4 2 5 5 6 3 6 2 2 1 5 
695 5 6 5 5 5 5 4 3 2 1 6 1 4 2 5 5 6 3 6 2 2 1 5 
695 5 6 5 5 5 5 4 3 2 1 6 1 4 2 5 5 6 3 6 2 2 1 5 
685 5 6 5 5 5 5 4 3 2 1 6 1 4 2 5 5 6 3 6 2 2 6 
685 5 6 5 5 5 5 4 3 2 1 6 1 4 2 5 5 6 3 6 2 2 6 
685 5 6 5 5 5 5 4 3 2 1 6 1 4 2 5 5 6 3 6 2 2 6 
685 5 6 5 5 5 5 4 3 2 1 6 1 4 2 5 5 6 3 6 2 2 6 
675 5 6 5 5 5 5 4 3 2 1 6 1 4 2 5 5 6 3 6 2 2 1 1 3 
675 5 6 5 5 5 5 4 3 2 1 6 1 4 2 5 5 6 3 6 2 2 1 1 3 
675 5 6 5 5 5 5 4 3 2 1 6 1 4 2 5 5 6 3 6 2 2 2 3 
670 5 6 5 5 5 5 4 3 2 1 6 1 4 2 5 5 6 3 6 2 2 5 
670 5 6 5 5 5 5 4 3 2 1 6 1 4 2 5 5 6 3 6 2 2 5 
670 5 6 5 5 5 5 4 3 2 1 6 1 4 2 5 5 6 3 6 2 2 1 4 
670 5 6 5 5 5 5 4 3 2 1 6 1 4 2 5 5 6 3 6 2 2 1 4 
670 5 6 5 5 5 5 4 3 2 1 6 1 4 2 5 5 6 3 6 2 2 1 4 
650 5 6 5 5 5 5 4 3 2 1 6 1 4 2 5 5 6 3 6 2 2 1 3 
645 5 6 5 5 5 5 4 3 2 1 6 1 4 2 5 5 6 3 6 2 2 4 
645 5 6 5 5 5 5 4 3 2 1 6 1 4 2 5 5 6 3 6 2 2 4 
645 5 6 5 5 5 5 4 3 2 1 6 1 4 2 5 5 6 3 6 1 2 5 
645 5 6 5 5 5 5 4 3 2 1 6 1 4 2 5 5 6 3 6 2 1 5 
645 5 6 5 5 5 5 4 3 2 1 6 1 4 2 5 5 6 3 6 2 2 4 
635 5 6 5 5 5 5 4 3 2 1 6 1 4 2 5 5 6 3 6 2 6 
625 5 6 5 5 5 5 4 3 2 1 6 1 4 2 5 5 6 3 6 2 2 3 
625 5 6 5 5 5 5 4 3 2 1 6 1 4 2 5 5 6 3 6 2 2 3 
625 5 6 5 5 5 5 4 3 2 1 6 1 4 2 5 5 6 3 6 2 2 3 
620 5 6 5 5 5 5 4 3 2 1 6 1 4 2 5 5 6 3 6 2 5 
620 5 6 5 5 5 5 4 3 2 1 6 1 4 2 5 5 6 3 6 2 5 
595 5 6 5 5 5 5 4 3 2 1 6 1 4 2 5 5 6 3 6 2 4 
595 5 6 5 5 5 5 4 3 2 1 6 1 4 2 5 5 6 3 6 2 4 
575 5 6 5 5 5 5 4 3 2 1 6 1 4 2 5 5 6 3 6 2 3 
575 5 6 5 5 5 5 4 3 2 1 6 1 4 2 5 5 6 3 6 2 3 
550 5 6 5 5 5 5 4 3 2 1 6 1 4 2 5 5 6 3 6 1 3 
