25 4 5 5 5 5 3 5 1 4 2 2 4 4 4 
25 4 5 5 5 5 3 5 1 4 4 
25 4 5 5 5 5 3 5 1 4 4 
-20 4 5 5 5 5 3 5 1 4 2 2 
-20 4 5 5 5 5 3 5 1 4 2 2 4 4 2 4 5 1 
-20 4 5 5 5 5 3 5 1 4 5 
-20 4 5 5 5 5 3 5 1 4 2 2 4 3 1 
-50 4 5 5 5 5 3 5 4 
-50 4 5 5 5 5 3 5 1 4 2 2 4 4 2 6 1 
-50 4 5 5 5 5 3 5 1 4 5 
-50 4 5 5 5 5 3 5 1 4 1 
-50 4 5 5 5 5 3 5 1 5 
-50 4 5 5 5 5 3 5 1 2 
-50 4 5 5 5 5 3 5 1 2 
-50 4 5 5 5 5 3 5 1 4 
-55 4 5 5 5 5 3 5 1 4 5 
-55 4 5 5 5 5 3 5 1 4 5 
-55 4 5 5 5 5 3 5 1 4 6 3 
-95 4 5 5 5 5 1 3 
-100 4 5 5 5 5 3 5 4 
-105 4 5 5 5 5 3 5 1 4 6 
-105 4 5 5 5 5 3 5 3 
-105 4 5 5 5 5 3 5 1 4 2 4 4 6 3 
-125 4 5 5 5 5 3 5 1 4 3 6 
-125 4 5 5 5 5 3 3 
-125 4 5 5 5 5 3 
-150 1 4 5 5 5 5 3 5 1 4 2 2 4 1 
-155 4 5 5 5 5 3 5 1 4 2 2 1 
-155 4 5 5 5 5 3 5 1 4 4 1 
-155 4 5 5 5 5 3 5 1 4 2 
-175 4 4 5 5 5 3 
-180 4 5 5 5 5 3 5 4 
-200 4 5 5 5 5 3 5 1 1 
-200 4 5 5 5 5 3 5 1 4 
-200 4 5 5 5 5 3 5 1 4 2 2 4 
-205 4 5 5 5 5 3 5 1 6 
-205 4 5 5 5 5 3 5 1 4 2 1 6 
-205 4 5 5 5 5 3 2 
-205 4 5 5 5 5 3 5 1 5 
-205 4 5 5 5 5 3 5 1 4 2 2 2 
-220 4 5 5 5 5 3 5 4 
-225 4 5 5 5 5 3 5 6 
-225 3 4 5 5 5 5 4 2 
-225 4 5 5 5 5 3 5 1 4 2 2 4 4 2 
-250 4 5 5 5 5 3 5 1 4 2 1 
-505 4 5 5 5 5 3 
-530 4 5 5 5 5 3 5 1 4 2 
-560 4 5 5 5 5 3 
