1535 6 5 5 5 6 4 3 4 6 2 2 3 6 5 5 5 5 4 3 4 6 2 2 2 2 1 3 5 6 2 6 4 6 5 6 5 4 6 6 1 2 
1535 6 5 5 5 6 4 3 4 6 2 2 3 6 5 5 5 5 4 3 4 6 2 2 2 2 1 3 5 6 2 6 4 6 5 6 5 4 6 6 4 2 
1525 6 5 5 5 6 4 3 4 6 2 2 3 6 5 5 5 5 4 3 4 6 2 2 2 2 1 3 5 6 2 6 4 6 5 6 5 4 6 6 6 
1525 6 5 5 5 6 4 3 4 6 2 2 3 6 5 5 5 5 4 3 4 6 2 2 2 2 1 3 5 6 2 6 4 6 5 6 5 4 6 6 6 
1525 6 5 5 5 6 4 3 4 6 2 2 3 6 5 5 5 5 4 3 4 6 2 2 2 2 1 3 5 6 2 6 4 6 5 6 5 4 6 6 6 
1510 6 5 5 5 6 4 3 4 6 2 2 3 6 5 5 5 5 4 3 4 6 2 2 2 2 1 3 5 6 2 6 4 6 5 6 5 4 6 6 2 
1510 6 5 5 5 6 4 3 4 6 2 2 3 6 5 5 5 5 4 3 4 6 2 2 2 2 1 3 5 6 2 6 4 6 5 6 5 4 6 6 5 
1510 6 5 5 5 6 4 3 4 6 2 2 3 6 5 5 5 5 4 3 4 6 2 2 2 2 1 3 5 6 2 6 4 6 5 6 5 4 6 6 2 
1510 6 5 5 5 6 4 3 4 6 2 2 3 6 5 5 5 5 4 3 4 6 2 2 2 2 1 3 5 6 2 6 4 6 5 6 5 4 6 6 2 
1510 6 5 5 5 6 4 3 4 6 2 2 3 6 5 5 5 5 4 3 4 6 2 2 2 2 1 3 5 6 2 6 4 6 5 6 5 4 6 6 4 1 
1510 6 5 5 5 6 4 3 4 6 2 2 3 6 5 5 5 5 4 3 4 6 2 2 2 2 1 3 5 6 2 6 4 6 5 6 5 4 6 6 1 1 
1510 6 5 5 5 6 4 3 4 6 2 2 3 6 5 5 5 5 4 3 4 6 2 2 2 2 1 3 5 6 2 6 4 6 5 6 5 4 6 6 4 4 
1510 6 5 5 5 6 4 3 4 6 2 2 3 6 5 5 5 5 4 3 4 6 2 2 2 2 1 3 5 6 2 6 4 6 5 6 5 4 6 6 2 
1510 6 5 5 5 6 4 3 4 6 2 2 3 6 5 5 5 5 4 3 4 6 2 2 2 2 1 3 5 6 2 6 4 6 5 6 5 4 6 6 2 
1510 6 5 5 5 6 4 3 4 6 2 2 3 6 5 5 5 5 4 3 4 6 2 2 2 2 1 3 5 6 2 6 4 6 5 6 5 4 6 6 4 1 
1510 6 5 5 5 6 4 3 4 6 2 2 3 6 5 5 5 5 4 3 4 6 2 2 2 2 1 3 5 6 2 6 4 6 5 6 5 4 6 6 5 
1510 6 5 5 5 6 4 3 4 6 2 2 3 6 5 5 5 5 4 3 4 6 2 2 2 2 1 3 5 6 2 6 4 6 5 6 5 4 6 6 5 
1510 6 5 5 5 6 4 3 4 6 2 2 3 6 5 5 5 5 4 3 4 6 2 2 2 2 1 3 5 6 2 6 4 6 5 6 5 4 6 6 1 1 
1510 6 5 5 5 6 4 3 4 6 2 2 3 6 5 5 5 5 4 3 4 6 2 2 2 2 1 3 5 6 2 6 4 6 5 6 5 4 6 6 5 
1510 6 5 5 5 6 4 3 4 6 2 2 3 6 5 5 5 5 4 3 4 6 2 2 2 2 1 3 5 6 2 6 4 6 5 6 5 4 6 6 5 
1510 6 5 5 5 6 4 3 4 6 2 2 3 6 5 5 5 5 4 3 4 6 2 2 2 2 1 3 5 6 2 6 4 6 5 6 5 4 6 6 5 
1510 6 5 5 5 6 4 3 4 6 2 2 3 6 5 5 5 5 4 3 4 6 2 2 2 2 1 3 5 6 2 6 4 6 5 6 5 4 6 6 1 4 
1490 6 5 5 5 6 4 3 4 6 2 2 3 6 5 5 5 5 4 3 4 6 2 2 2 2 1 3 5 6 2 6 4 6 5 6 5 4 6 6 4 3 4 
1475 6 5 5 5 6 4 3 4 6 2 2 3 6 5 5 5 5 4 3 4 6 2 2 2 2 1 3 5 6 2 6 4 6 5 6 5 4 6 3 5 1 
1465 6 5 5 5 6 4 3 4 6 2 2 3 6 5 5 5 5 4 3 4 6 2 2 2 2 1 3 5 6 2 6 4 6 5 6 5 4 6 6 3 
1465 6 5 5 5 6 4 3 4 6 2 2 3 6 5 5 5 5 4 3 4 6 2 2 2 2 1 3 5 6 2 6 4 6 5 6 5 4 6 6 3 
1465 6 5 5 5 6 4 3 4 6 2 2 3 6 5 5 5 5 4 3 4 6 2 2 2 2 1 3 5 6 2 6 4 6 5 6 5 4 6 6 3 
1465 6 5 5 5 6 4 3 4 6 2 2 3 6 5 5 5 5 4 3 4 6 2 2 2 2 1 3 5 6 2 6 4 6 5 6 5 4 6 6 3 
1465 6 5 5 5 6 4 3 4 6 2 2 3 6 5 5 5 5 4 3 4 6 2 2 2 2 1 3 5 6 2 6 4 6 5 6 5 4 6 6 3 
1465 6 5 5 5 6 4 3 4 6 2 2 3 6 5 5 5 5 4 3 4 6 2 2 2 2 1 3 5 6 2 6 4 6 5 6 5 4 6 6 3 
1465 6 5 5 5 6 4 3 4 6 2 2 3 6 5 5 5 5 4 3 4 6 2 2 2 2 1 3 5 6 2 6 4 6 5 6 5 4 6 6 3 
1450 6 5 5 5 6 4 3 4 6 2 2 3 6 5 5 5 5 4 3 4 6 2 2 2 2 1 3 5 6 2 6 4 6 5 6 5 4 6 3 2 
1445 6 5 5 5 6 4 3 4 6 2 2 3 6 5 5 5 5 4 3 4 6 2 2 2 2 1 3 5 6 2 6 4 6 5 6 5 4 6 5 
1445 6 5 5 5 6 4 3 4 6 2 2 3 6 5 5 5 5 4 3 4 6 2 2 2 2 1 3 5 6 2 6 4 6 5 6 5 4 6 5 
1445 6 5 5 5 6 4 3 4 6 2 2 3 6 5 5 5 5 4 3 4 6 2 2 2 2 1 3 5 6 2 6 4 6 5 6 5 4 6 2 
1445 6 5 5 5 6 4 3 4 6 2 2 3 6 5 5 5 5 4 3 4 6 2 2 2 2 1 3 5 6 2 6 4 6 5 6 5 4 6 5 
1445 6 5 5 5 6 4 3 4 6 2 2 3 6 5 5 5 5 4 3 4 6 2 2 2 2 1 3 5 6 2 6 4 6 5 6 5 4 6 2 
1445 6 5 5 5 6 4 3 4 6 2 2 3 6 5 5 5 5 4 3 4 6 2 2 2 2 1 3 5 6 2 6 4 6 5 6 5 4 6 5 
1420 6 5 5 5 6 4 3 4 6 2 2 3 6 5 5 5 5 4 3 4 6 2 2 2 2 1 3 5 6 2 6 4 6 5 6 5 4 6 1 
1420 6 5 5 5 6 4 3 4 6 2 2 3 6 5 5 5 5 4 3 4 6 2 2 2 2 1 3 5 6 2 6 4 6 5 6 5 4 6 1 
1420 6 5 5 5 6 4 3 4 6 2 2 3 6 5 5 5 5 4 3 4 6 2 2 2 2 1 3 5 6 2 6 4 6 5 6 5 4 6 4 
1420 6 5 5 5 6 4 3 4 6 2 2 3 6 5 5 5 5 4 3 4 6 2 2 2 2 1 3 5 6 2 6 4 6 5 6 5 4 6 4 
1420 6 5 5 5 6 4 3 4 6 2 2 3 6 5 5 5 5 4 3 4 6 2 2 2 2 1 3 5 6 2 6 4 6 5 6 5 4 6 4 
1420 6 5 5 5 6 4 3 4 6 2 2 3 6 5 5 5 5 4 3 4 6 2 2 2 2 1 3 5 6 2 6 4 6 5 6 5 4 6 1 
1420 6 5 5 5 6 4 3 4 6 2 2 3 6 5 5 5 5 4 3 4 6 2 2 2 2 1 3 5 6 2 6 4 6 5 6 5 4 6 4 
1420 6 5 5 5 6 4 3 4 6 2 2 3 6 5 5 5 5 4 3 4 6 2 2 2 2 1 3 5 6 2 6 4 6 5 6 5 4 6 4 
1420 6 5 5 5 6 4 3 4 6 2 2 3 6 5 5 5 5 4 3 4 6 2 2 2 2 1 3 5 6 2 6 4 6 5 6 5 4 6 1 
1415 6 5 5 5 6 4 3 4 6 2 2 3 6 5 5 5 5 4 3 4 6 2 2 2 2 1 3 5 6 2 6 4 6 5 6 5 4 3 3 2 1 
1385 6 5 5 5 6 4 3 4 6 2 2 3 6 5 5 5 5 4 3 4 6 2 2 2 2 1 3 5 6 2 6 4 6 5 6 5 4 3 2 
1385 6 5 5 5 6 4 3 4 6 2 2 3 6 5 5 5 5 4 3 4 6 2 2 2 2 1 3 5 6 2 6 4 6 5 6 5 4 4 3 1 
1385 6 5 5 5 6 4 3 4 6 2 2 3 6 5 5 5 5 4 3 4 6 2 2 2 2 1 3 5 6 2 6 4 6 5 6 5 4 4 3 1 
1385 6 5 5 5 6 4 3 4 6 2 2 3 6 5 5 5 5 4 3 4 6 2 2 2 2 1 3 5 6 2 6 4 6 5 6 5 4 3 2 
1385 6 5 5 5 6 4 3 4 6 2 2 3 6 5 5 5 5 4 3 4 6 2 2 2 2 1 3 5 6 2 6 4 6 5 6 5 2 1 2 4 3 
1385 6 5 5 5 6 4 3 4 6 2 2 3 6 5 5 5 5 4 3 4 6 2 2 2 2 1 3 5 6 2 6 4 6 5 6 5 4 3 5 
1380 6 5 5 5 6 4 3 4 6 2 2 3 6 5 5 5 5 4 3 4 6 2 2 2 2 1 3 5 6 2 6 4 6 5 6 5 4 2 
1380 6 5 5 5 6 4 3 4 6 2 2 3 6 5 5 5 5 4 3 4 6 2 2 2 2 1 3 5 6 2 6 4 6 5 6 5 4 4 4 
1380 6 5 5 5 6 4 3 4 6 2 2 3 6 5 5 5 5 4 3 4 6 2 2 2 2 1 3 5 6 2 6 4 6 5 6 5 4 5 
1380 6 5 5 5 6 4 3 4 6 2 2 3 6 5 5 5 5 4 3 4 6 2 2 2 2 1 3 5 6 2 6 4 6 5 6 5 4 4 4 
1380 6 5 5 5 6 4 3 4 6 2 2 3 6 5 5 5 5 4 3 4 6 2 2 2 2 1 3 5 6 2 6 4 6 5 6 5 4 5 
1380 6 5 5 5 6 4 3 4 6 2 2 3 6 5 5 5 5 4 3 4 6 2 2 2 2 1 3 5 6 2 6 4 6 5 6 5 4 2 
1380 6 5 5 5 6 4 3 4 6 2 2 3 6 5 5 5 5 4 3 4 6 2 2 2 2 1 3 5 6 2 6 4 6 5 6 5 4 2 
1380 6 5 5 5 6 4 3 4 6 2 2 3 6 5 5 5 5 4 3 4 6 2 2 2 2 1 3 5 6 2 6 4 6 5 6 5 4 5 
1370 6 5 5 5 6 4 3 4 6 2 2 3 6 5 5 5 5 4 3 4 6 2 2 2 2 1 3 5 6 2 6 4 6 5 6 6 2 
1360 6 5 5 5 6 4 3 4 6 2 2 3 6 5 5 5 5 4 3 4 6 2 2 2 2 1 3 5 6 2 6 4 6 5 6 5 3 5 
1355 6 5 5 5 6 4 3 4 6 2 2 3 6 5 5 5 5 4 3 4 6 2 2 2 2 1 3 5 6 2 6 4 6 5 6 5 4 1 
1355 6 5 5 5 6 4 3 4 6 2 2 3 6 5 5 5 5 4 3 4 6 2 2 2 2 1 3 5 6 2 6 4 6 5 6 5 4 1 
1355 6 5 5 5 6 4 3 4 6 2 2 3 6 5 5 5 5 4 3 4 6 2 2 2 2 1 3 5 6 2 6 4 6 5 6 5 4 1 
1355 6 5 5 5 6 4 3 4 6 2 2 3 6 5 5 5 5 4 3 4 6 2 2 2 2 1 3 5 6 2 6 4 6 5 6 5 4 1 
1345 6 5 5 5 6 4 3 4 6 2 2 3 6 5 5 5 5 4 3 4 6 2 2 2 2 1 3 5 6 2 6 4 6 5 6 6 1 
1345 6 5 5 5 6 4 3 4 6 2 2 3 6 5 5 5 5 4 3 4 6 2 2 2 2 1 3 5 6 2 6 4 6 5 6 6 1 
1295 6 5 5 5 6 4 3 4 6 2 2 3 6 5 5 5 5 4 3 4 6 2 2 2 2 1 3 5 6 2 6 4 4 5 4 3 2 6 
1290 6 5 5 5 6 4 3 4 6 2 2 3 6 5 5 5 5 4 3 4 6 2 2 2 2 1 3 5 6 2 6 4 6 3 1 4 3 4 6 
1285 6 5 5 5 6 4 3 4 6 2 2 3 6 5 5 5 5 4 3 4 6 2 2 2 2 1 3 5 6 2 6 4 6 5 4 3 6 
1280 6 5 5 5 6 4 3 4 6 2 2 3 6 5 5 5 5 4 3 4 6 2 2 2 2 1 3 5 6 2 6 4 6 4 2 6 
1265 6 5 5 5 6 4 3 4 6 2 2 3 6 5 5 5 5 4 3 4 6 2 2 2 2 1 3 5 6 2 6 4 6 5 4 2 
1260 6 5 5 5 6 4 3 4 6 2 2 3 6 5 5 5 5 4 3 4 6 2 2 2 2 1 3 5 6 2 6 4 4 6 2 2 4 1 
1245 6 5 5 5 6 4 3 4 6 2 2 3 6 5 5 5 5 4 3 4 6 2 2 2 2 1 3 5 6 2 6 1 4 2 2 2 5 
1240 6 5 5 5 6 4 3 4 6 2 2 3 6 5 5 5 5 4 3 4 6 2 2 2 2 1 3 5 6 2 6 4 6 1 1 5 
1240 6 5 5 5 6 4 3 4 6 2 2 3 6 5 5 5 5 4 3 4 6 2 2 2 2 1 3 5 6 2 6 4 6 5 2 
1230 6 5 5 5 6 4 3 4 6 2 2 3 6 5 5 5 5 4 3 4 6 2 2 2 2 1 3 5 6 2 6 4 6 4 6 
1230 6 5 5 5 6 4 3 4 6 2 2 3 6 5 5 5 5 4 3 4 6 2 2 2 2 1 3 5 6 2 6 4 4 6 6 
1220 6 5 5 5 6 4 3 4 6 2 2 3 6 5 5 5 5 4 3 4 6 2 2 2 2 1 3 5 6 2 6 4 4 3 2 6 
1215 6 5 5 5 6 4 3 4 6 2 2 3 6 5 5 5 5 4 3 4 6 2 2 2 2 1 3 5 6 2 6 4 4 6 4 1 
1210 6 5 5 5 6 4 3 4 6 2 2 3 6 5 5 5 5 4 3 4 6 2 2 2 2 1 3 5 6 2 6 4 6 3 6 
1210 6 5 5 5 6 4 3 4 6 2 2 3 6 5 5 5 5 4 3 4 6 2 2 2 2 1 3 5 6 6 2 6 2 2 4 1 
1210 6 5 5 5 6 4 3 4 6 2 2 3 6 5 5 5 5 4 3 4 6 2 2 2 2 1 3 5 6 2 6 4 6 3 6 
1205 6 5 5 5 6 4 3 4 6 2 2 3 6 5 5 5 5 4 3 4 6 2 2 2 2 1 3 5 6 2 6 4 6 6 
1125 6 5 5 5 6 4 3 4 6 2 2 3 6 5 5 5 5 4 3 4 6 2 2 2 2 1 3 5 6 2 6 4 5 
1125 6 5 5 5 6 4 3 4 6 2 2 3 6 5 5 5 5 4 3 4 6 2 2 2 2 1 3 5 6 2 6 4 2 
1125 6 5 5 5 6 4 3 4 6 2 2 3 6 5 5 5 5 4 3 4 6 2 2 2 2 1 3 5 6 2 6 4 4 4 
1125 6 5 5 5 6 4 3 4 6 2 2 3 6 5 5 5 5 4 3 4 6 2 2 2 2 1 3 5 6 2 6 1 2 
1125 6 5 5 5 6 4 3 4 6 2 2 3 6 5 5 5 5 4 3 4 6 2 2 2 2 1 3 5 6 2 6 1 5 
1115 6 5 5 5 6 4 3 4 6 2 2 3 6 5 5 5 5 4 3 4 6 2 2 2 2 1 3 5 6 2 6 6 
1115 6 5 5 5 6 4 3 4 6 2 2 3 6 5 5 5 5 4 3 4 6 2 2 2 2 1 3 5 6 2 6 6 
1115 6 5 5 5 6 4 3 4 6 2 2 3 6 5 5 5 5 4 3 4 6 2 2 2 2 1 3 5 6 2 6 6 
1115 6 5 5 5 6 4 3 4 6 2 2 3 6 5 5 5 5 4 3 4 6 2 2 2 2 1 3 5 6 5 4 5 5 3 
1100 6 5 5 5 6 4 3 4 6 2 2 3 6 5 5 5 5 4 3 4 6 2 2 2 2 1 3 5 6 2 6 2 
1100 6 5 5 5 6 4 3 4 6 2 2 3 6 5 5 5 5 4 3 4 6 2 2 2 2 1 3 5 6 2 6 4 1 
1100 6 5 5 5 6 4 3 4 6 2 2 3 6 5 5 5 5 4 3 4 6 2 2 2 2 1 3 5 6 2 6 2 
1100 6 5 5 5 6 4 3 4 6 2 2 3 6 5 5 5 5 4 3 4 6 2 2 2 2 1 3 5 6 2 6 4 1 
1100 6 5 5 5 6 4 3 4 6 2 2 3 6 5 5 5 5 4 3 4 6 2 2 2 2 1 3 5 6 2 6 5 
1100 6 5 5 5 6 4 3 4 6 2 2 3 6 5 5 5 5 4 3 4 6 2 2 2 2 1 3 5 6 2 6 5 
1095 6 5 5 5 6 4 3 4 6 2 2 3 6 5 5 5 5 4 3 4 6 2 2 2 2 1 3 5 6 6 3 4 5 3 4 6 3 
1090 6 5 5 5 6 4 3 4 6 2 2 3 6 5 5 5 5 4 3 4 6 2 2 2 2 1 3 5 6 6 4 6 
1090 6 5 5 5 6 4 3 4 6 2 2 3 6 5 5 5 5 4 3 4 6 2 2 2 2 1 3 4 6 6 1 4 6 
1090 6 5 5 5 6 4 3 4 6 2 2 3 6 5 5 5 5 4 3 4 6 2 2 2 2 1 3 5 6 2 4 3 5 1 
1085 6 5 5 5 6 4 3 4 6 2 2 3 6 5 5 5 5 4 3 4 6 2 2 2 2 1 3 5 6 2 1 4 2 
1080 6 5 5 5 6 4 3 4 6 2 2 3 6 5 5 5 5 4 3 4 6 2 2 2 2 1 3 5 6 2 6 1 3 
1080 6 5 5 5 6 4 3 4 6 2 2 3 6 5 5 5 5 4 3 4 6 2 2 2 2 1 3 5 6 2 6 4 3 
1080 6 5 5 5 6 4 3 4 6 2 2 3 6 5 5 5 5 4 3 4 6 2 2 2 2 1 3 5 6 2 6 4 3 
1075 6 5 5 5 6 4 3 4 6 2 2 3 6 5 5 5 5 4 3 4 6 2 2 2 2 1 3 5 6 6 1 4 4 
1065 6 5 5 5 6 4 3 4 6 2 2 3 6 5 5 5 5 4 3 4 6 2 2 2 2 1 3 5 6 3 5 1 4 1 
1055 6 5 5 5 6 4 3 4 6 2 2 3 6 5 5 5 5 4 3 4 6 2 2 2 2 1 3 5 6 2 6 3 
1035 6 5 5 5 6 4 3 4 6 2 2 3 6 5 5 5 5 4 3 4 6 2 2 2 2 1 3 5 6 5 1 1 
1035 6 5 5 5 6 4 3 4 6 2 2 3 6 5 5 5 5 4 3 4 6 2 2 2 2 1 3 5 6 5 2 
1035 6 5 5 5 6 4 3 4 6 2 2 3 6 5 5 5 5 4 3 4 6 2 2 2 2 1 3 5 6 5 2 
1035 6 5 5 5 6 4 3 4 6 2 2 3 6 5 5 5 5 4 3 4 6 2 2 2 2 1 3 5 6 2 1 1 
1035 6 5 5 5 6 4 3 4 6 2 2 3 6 5 5 5 5 4 3 4 6 2 2 2 2 1 3 5 6 2 2 
1010 6 5 5 5 6 4 3 4 6 2 2 3 6 5 5 5 5 4 3 4 6 2 2 2 2 1 3 5 6 1 5 
1010 6 5 5 5 6 4 3 4 6 2 2 3 6 5 5 5 5 4 3 4 6 2 2 2 2 1 3 5 6 4 5 
990 6 5 5 5 6 4 3 4 6 2 2 3 6 5 5 5 5 4 3 4 6 2 2 2 2 1 3 5 6 5 3 
990 6 5 5 5 6 4 3 4 6 2 2 3 6 5 5 5 5 4 3 4 6 2 2 2 2 1 3 5 6 5 3 
990 6 5 5 5 6 4 3 4 6 2 2 3 6 5 5 5 5 4 3 4 6 2 2 2 2 1 3 5 6 3 2 
970 6 5 5 5 6 4 3 4 6 2 2 3 6 5 5 5 5 4 3 4 6 2 2 2 2 1 3 5 4 4 2 
965 6 5 5 5 6 4 3 4 6 2 2 3 6 5 5 5 5 4 3 4 6 2 2 2 2 1 3 5 6 3 4 
965 6 5 5 5 6 4 3 4 6 2 2 3 6 5 5 5 5 4 3 4 6 2 2 2 2 1 3 5 6 3 4 
940 6 5 5 5 6 4 3 4 6 2 2 3 6 5 5 5 5 4 3 4 6 2 2 2 2 1 6 6 5 5 2 3 
940 6 5 5 5 6 4 3 4 6 2 2 3 6 5 5 5 5 4 3 4 6 2 2 2 2 1 6 6 6 4 4 
