145 4 2 5 5 5 5 5 3 5 6 
140 4 2 5 5 5 5 5 4 4 6 
140 4 2 5 5 5 5 5 4 4 6 
140 4 2 5 5 5 5 5 5 6 
140 4 2 5 5 5 5 5 5 6 
125 4 2 5 5 5 5 5 2 2 
125 4 2 5 5 5 5 5 5 2 
125 4 2 5 5 5 5 5 5 2 
125 4 2 5 5 5 5 5 5 5 
125 4 2 5 5 5 5 5 4 4 5 
125 4 2 5 5 5 5 5 5 5 
125 4 2 5 5 5 5 5 5 2 
125 4 2 5 5 5 5 5 5 2 
120 4 2 5 5 5 5 5 4 3 6 
115 4 2 5 5 5 5 4 6 2 
105 4 2 5 5 5 5 5 3 5 4 
105 4 2 5 5 5 5 5 4 3 2 
100 4 2 5 5 5 5 5 5 4 
100 4 2 5 5 5 5 5 5 1 
100 4 2 5 5 5 5 5 5 1 
100 4 2 5 5 5 5 5 4 5 
100 4 2 5 5 5 5 5 5 1 
100 4 2 5 5 5 5 5 4 2 
100 4 2 5 5 5 5 5 2 4 
100 4 2 5 5 5 5 5 2 4 
100 4 2 5 5 5 5 5 2 4 
100 4 2 5 5 5 5 5 2 1 
100 4 2 5 5 5 5 5 2 4 
95 4 2 5 5 5 5 5 3 6 
85 4 2 5 5 5 5 5 3 5 3 
80 4 2 5 5 5 5 5 3 1 1 
80 4 2 5 5 5 5 5 5 3 
80 4 2 5 5 5 5 5 5 3 
80 4 2 5 5 5 5 5 3 1 1 
75 4 2 5 5 5 5 5 1 4 
75 4 2 5 5 5 5 5 1 4 
70 4 2 5 5 5 5 4 6 3 
65 4 2 5 5 5 5 6 4 
65 4 2 5 5 5 5 6 1 
60 4 2 5 5 5 5 5 3 3 1 
60 4 2 5 5 5 5 5 3 1 3 
60 4 2 5 5 5 5 5 4 3 3 5 
25 4 2 5 5 5 5 2 
25 4 2 5 5 5 5 2 
25 4 2 5 5 5 5 2 
10 4 2 5 5 5 5 3 1 3 
0 4 2 5 5 5 5 1 
0 4 2 5 5 5 5 1 
