130 6 5 5 5 5 5 2 6 
130 6 5 5 5 5 5 2 6 
125 6 5 5 3 4 5 5 6 6 
125 6 5 5 3 4 5 5 6 6 
120 6 5 5 3 4 5 5 4 5 2 
120 6 5 5 3 4 5 5 4 2 2 
110 6 5 5 3 4 5 5 5 6 
110 6 5 5 3 4 5 5 6 2 
110 6 5 5 3 4 5 5 6 2 
110 6 5 5 3 4 5 5 6 5 
110 6 5 5 5 5 3 2 1 6 
110 6 5 5 3 4 5 5 6 5 
105 6 5 5 3 4 5 5 6 2 6 
105 6 5 5 3 4 5 5 6 2 3 
105 6 5 5 3 4 5 5 6 2 6 
105 6 5 5 3 4 5 5 6 2 3 
105 6 5 5 3 4 5 5 6 2 1 
105 6 5 5 3 4 5 5 6 2 3 
105 6 5 5 3 4 5 5 6 2 1 
105 6 5 5 3 4 5 5 6 2 4 
95 6 5 5 3 4 5 5 2 2 
95 6 5 5 5 6 6 5 
95 6 5 5 3 4 5 5 4 2 4 
90 6 5 5 5 5 4 2 2 
85 6 5 5 3 4 5 5 6 1 
80 6 5 5 5 6 2 2 
75 6 5 5 3 4 5 5 4 5 3 
75 6 5 5 5 5 3 4 4 3 2 4 
75 6 5 5 5 5 3 3 2 2 
70 6 5 5 5 5 3 2 1 4 
70 6 5 5 5 6 4 6 
70 6 5 5 5 5 4 3 1 4 1 
70 6 5 5 5 3 5 5 1 4 
70 6 5 5 3 4 5 5 5 1 
65 6 5 5 3 4 5 5 6 3 
65 6 5 5 5 3 4 3 6 2 
65 6 5 5 3 6 6 6 
55 6 5 5 5 5 6 4 
50 6 5 5 3 4 5 5 1 3 4 
15 6 5 5 5 5 4 1 
-5 6 5 5 5 3 4 2 
-10 6 5 5 5 5 1 
-15 6 5 5 5 5 3 3 3 3 
-15 6 5 5 5 5 3 3 3 3 
-60 6 5 5 5 4 
-60 6 5 5 5 1 
-60 6 5 5 5 1 
-60 6 5 5 5 1 
-60 6 5 5 5 1 
-70 6 5 5 6 
-270 6 5 5 3 4 5 5 6 
-270 6 5 5 3 4 5 5 6 
-270 6 5 5 3 4 5 5 6 
-270 6 5 5 3 4 5 5 6 
-270 6 5 5 3 4 5 5 6 
-270 6 5 5 3 4 5 5 6 
-270 6 5 5 3 4 5 5 6 
-270 6 5 5 3 4 5 5 6 
-270 6 5 5 3 4 5 5 6 
-435 6 5 5 3 5 1 
-450 6 5 5 6 4 5 3 
-450 6 5 5 6 
-455 6 5 5 5 3 3 5 5 
-500 6 5 6 
