1025 4 1 6 5 5 5 5 5 6 1 6 5 6 5 6 5 4 2 1 2 2 2 2 2 3 6 4 4 3 2 1 
1005 4 1 6 5 5 5 5 5 6 1 6 5 6 5 6 5 4 2 1 2 2 2 2 2 3 4 1 4 4 5 
1000 4 1 6 5 5 5 5 5 6 1 6 5 6 5 6 5 4 2 1 2 2 2 2 3 2 5 1 3 6 
990 4 1 6 5 5 5 5 5 6 1 6 5 6 5 6 5 4 2 1 2 2 2 2 2 3 4 6 2 5 
980 4 1 6 5 5 5 5 5 6 1 6 5 6 5 6 5 4 2 1 2 2 2 2 2 3 4 4 4 2 
955 4 1 6 5 5 5 5 5 6 1 6 5 6 5 6 5 4 2 1 2 2 2 2 2 5 3 5 
945 4 1 6 5 5 5 5 5 6 1 6 5 6 5 6 5 4 2 1 2 2 2 2 2 3 6 1 
945 4 1 6 5 5 5 5 5 6 1 6 5 6 5 6 5 4 2 1 2 2 2 2 2 3 6 1 
900 4 1 6 5 5 5 5 5 6 1 6 5 6 5 6 5 4 2 1 2 2 2 2 3 2 2 5 
900 4 1 6 5 5 5 5 5 6 1 6 5 6 5 6 5 4 2 1 2 2 2 2 2 3 2 4 
900 4 1 6 5 5 5 5 5 6 1 6 5 6 5 6 5 4 2 1 2 2 2 2 2 3 2 3 
875 4 1 6 5 5 5 5 5 6 1 6 5 6 5 6 5 4 2 1 2 2 2 2 2 3 1 6 
870 4 1 6 5 5 5 5 5 6 1 6 5 6 5 6 5 4 2 1 2 2 2 2 2 1 3 
870 4 1 6 5 5 5 5 5 6 1 6 5 6 5 6 5 4 2 1 2 2 2 2 2 4 6 
820 4 1 6 5 5 5 5 5 6 1 6 5 6 5 6 5 4 2 1 2 2 2 2 1 2 
820 4 1 6 5 5 5 5 5 6 1 6 5 6 5 6 5 4 2 1 2 2 2 2 4 4 
805 4 1 6 5 5 5 5 5 6 1 6 5 6 5 6 5 4 2 1 2 2 2 2 3 3 4 
-30 4 1 6 5 5 5 5 5 6 1 6 5 6 5 6 5 4 2 1 2 2 2 2 3 2 5 1 4 4 4 6 
-80 4 1 6 5 5 5 5 5 6 1 6 5 6 5 6 5 4 2 1 2 2 2 2 3 2 5 1 4 2 3 5 
-85 4 1 6 5 5 5 5 5 6 1 6 5 6 5 6 5 4 2 1 2 2 2 2 3 2 5 1 4 4 4 4 
-90 4 1 6 5 5 5 5 5 6 1 6 5 6 5 6 5 4 2 1 2 2 2 2 3 2 5 1 4 4 6 3 
-105 4 1 6 5 5 5 5 5 6 1 6 5 6 5 6 5 4 2 1 2 2 2 2 3 2 5 1 1 3 5 4 
-110 4 1 6 5 5 5 5 5 6 1 6 5 6 5 6 5 4 2 1 2 2 2 2 3 2 5 1 4 3 3 5 
-140 4 1 6 5 5 5 5 5 6 1 6 5 6 5 6 5 4 2 1 2 2 2 2 3 2 5 1 4 4 6 4 2 
-145 4 1 6 5 5 5 5 5 6 1 6 5 6 5 6 5 4 2 1 2 2 2 2 2 3 1 4 
-145 4 1 6 5 5 5 5 5 6 1 6 5 6 5 6 5 4 2 1 2 2 2 2 2 3 4 5 5 
-145 4 1 6 5 5 5 5 5 6 1 6 5 6 5 6 5 4 2 1 2 2 2 2 2 3 4 6 6 5 
-145 4 1 6 5 5 5 5 5 6 1 6 5 6 5 6 5 4 2 1 2 2 2 2 2 3 4 6 4 3 
-145 4 1 6 5 5 5 5 5 6 1 6 5 6 5 6 5 4 2 1 2 2 2 2 2 3 4 4 6 
-145 4 1 6 5 5 5 5 5 6 1 6 5 6 5 6 5 4 2 1 2 2 2 2 2 3 4 1 2 
-145 4 1 6 5 5 5 5 5 6 1 6 5 6 5 6 5 4 2 1 2 2 2 2 2 3 4 6 3 4 
-145 4 1 6 5 5 5 5 5 6 1 6 5 6 5 6 5 4 2 1 2 2 2 2 2 3 4 6 3 3 
-145 4 1 6 5 5 5 5 5 6 1 6 5 6 5 6 5 4 2 1 2 2 2 2 2 3 4 5 2 
-145 4 1 6 5 5 5 5 5 6 1 6 5 6 5 6 5 4 2 1 2 2 2 2 2 3 3 3 
-145 4 1 6 5 5 5 5 5 6 1 6 5 6 5 6 5 4 2 1 2 2 2 2 2 3 1 3 
-145 4 1 6 5 5 5 5 5 6 1 6 5 6 5 6 5 4 2 1 2 2 2 2 2 3 1 6 
-145 4 1 6 5 5 5 5 5 6 1 6 5 6 5 6 5 4 2 1 2 2 2 2 2 3 4 2 2 
-145 4 1 6 5 5 5 5 5 6 1 6 5 6 5 6 5 4 2 1 2 2 2 2 2 3 4 1 
-145 4 1 6 5 5 5 5 5 6 1 6 5 6 5 6 5 4 2 1 2 2 2 2 2 3 4 6 
-145 4 1 6 5 5 5 5 5 6 1 6 5 6 5 6 5 4 2 1 2 2 2 2 2 3 4 6 6 5 
-145 4 1 6 5 5 5 5 5 6 1 6 5 6 5 6 5 4 2 1 2 2 2 2 2 3 6 3 
-145 4 1 6 5 5 5 5 5 6 1 6 5 6 5 6 5 4 2 1 2 2 2 2 2 3 3 2 
-145 4 1 6 5 5 5 5 5 6 1 6 5 6 5 6 5 4 2 1 2 2 2 2 2 3 5 6 
-145 4 1 6 5 5 5 5 5 6 1 6 5 6 5 6 5 4 2 1 2 2 2 2 2 3 4 6 2 1 
-145 4 1 6 5 5 5 5 5 6 1 6 5 6 5 6 5 4 2 1 2 2 2 2 2 3 3 1 
-165 4 1 6 5 5 5 5 5 6 1 6 5 6 5 6 5 4 2 1 2 2 2 2 3 2 5 1 4 4 6 6 
-165 4 1 6 5 5 5 5 5 6 1 6 5 6 5 6 5 4 2 1 2 2 2 2 3 2 5 1 4 4 6 4 3 
-165 4 1 6 5 5 5 5 5 6 1 6 5 6 5 6 5 4 2 1 2 2 2 2 3 2 5 1 4 4 6 2 
-165 4 1 6 5 5 5 5 5 6 1 6 5 6 5 6 5 4 2 1 2 2 2 2 3 2 5 1 4 4 6 5 2 1 3 3 
-200 4 1 6 5 5 5 5 5 6 1 6 5 6 5 6 5 4 2 1 2 2 2 2 3 2 5 1 2 6 
-200 4 1 6 5 5 5 5 5 6 1 6 5 6 5 6 5 4 2 1 2 2 2 2 3 2 5 1 4 4 5 2 
-225 4 1 6 5 5 5 5 5 6 1 6 5 6 5 6 5 4 2 1 2 2 2 2 3 2 5 1 4 4 3 5 6 2 
-225 4 1 6 5 5 5 5 5 6 1 6 5 6 5 6 5 4 2 1 2 2 2 2 3 2 5 1 4 4 4 1 
-520 4 1 6 5 5 5 5 5 6 1 6 5 6 5 6 5 4 2 1 2 2 2 2 2 3 4 
-520 4 1 6 5 5 5 5 5 6 1 6 5 6 5 6 5 4 2 1 2 2 2 2 2 3 
-520 4 1 6 5 5 5 5 5 6 1 6 5 6 5 6 5 4 2 1 2 2 2 2 2 3 4 
-520 4 1 6 5 5 5 5 5 6 1 6 5 6 5 6 5 4 2 1 2 2 2 2 2 3 
-520 4 1 6 5 5 5 5 5 6 1 6 5 6 5 6 5 4 2 1 2 2 2 2 2 3 
-520 4 1 6 5 5 5 5 5 6 1 6 5 6 5 6 5 4 2 1 2 2 2 2 2 3 4 6 
-520 4 1 6 5 5 5 5 5 6 1 6 5 6 5 6 5 4 2 1 2 2 2 2 2 3 
-520 4 1 6 5 5 5 5 5 6 1 6 5 6 5 6 5 4 2 1 2 2 2 2 2 3 4 
-520 4 1 6 5 5 5 5 5 6 1 6 5 6 5 6 5 4 2 1 2 2 2 2 2 3 
-520 4 1 6 5 5 5 5 5 6 1 6 5 6 5 6 5 4 2 1 2 2 2 2 2 3 
-520 4 1 6 5 5 5 5 5 6 1 6 5 6 5 6 5 4 2 1 2 2 2 2 2 3 
