400 4 2 5 5 5 5 5 3 4 3 2 4 2 2 5 6 1 1 
385 4 2 5 5 5 5 5 3 4 3 2 1 5 2 2 4 5 1 5 
335 4 2 5 5 5 5 5 3 4 3 2 5 2 5 1 5 
325 4 2 5 5 5 5 5 3 4 3 2 5 2 1 4 6 
320 4 2 5 5 5 5 5 3 4 3 2 5 6 4 3 6 
315 4 2 5 5 5 5 5 3 4 3 2 2 5 4 1 3 5 
315 4 2 5 5 5 5 5 3 4 3 2 4 6 6 2 
310 4 2 5 5 5 5 5 3 4 3 2 5 5 2 5 
310 4 2 5 5 5 5 5 3 4 3 2 5 2 5 5 
310 4 2 5 5 5 5 5 3 4 3 2 5 4 2 4 5 
305 4 2 5 5 5 5 5 3 4 3 2 5 6 3 4 5 
300 4 2 5 5 5 5 5 3 4 3 2 5 1 6 5 
300 4 2 5 5 5 5 5 3 4 3 2 3 5 3 6 6 
295 4 2 5 5 5 5 5 3 4 3 2 5 1 3 1 4 3 2 4 
290 4 2 5 5 5 5 5 3 4 3 2 5 2 1 3 5 
290 4 2 5 5 5 5 5 3 4 3 2 5 2 3 5 4 
290 4 2 5 5 5 5 5 3 4 3 2 3 2 2 5 1 
285 4 2 5 5 5 5 5 3 4 3 2 5 5 1 1 4 
285 4 2 5 5 5 5 5 3 4 3 2 5 2 5 4 
280 4 2 5 5 5 5 5 3 4 3 2 5 1 3 1 6 
280 4 2 5 5 5 5 5 3 4 3 2 5 6 3 2 
280 4 2 5 5 5 5 5 3 4 3 2 5 2 3 6 
275 4 2 5 5 5 5 5 3 4 3 2 6 5 1 4 
270 4 2 5 5 5 5 5 6 2 6 6 
260 4 2 5 5 5 5 5 6 1 4 4 6 1 3 
145 4 2 5 5 5 5 5 3 5 6 
130 4 2 5 5 5 5 5 3 2 5 
130 4 2 5 5 5 5 5 3 5 2 
125 4 2 5 5 5 5 5 2 2 
125 4 2 5 5 5 5 5 4 1 5 
120 4 2 5 5 5 5 5 3 1 6 
110 4 2 5 5 5 5 5 3 4 3 5 
105 4 2 5 5 5 5 5 3 5 4 
105 4 2 5 5 5 5 5 3 5 1 
105 4 2 5 5 5 5 5 3 4 5 
105 4 2 5 5 5 5 5 3 5 1 
105 4 2 5 5 5 5 5 3 5 4 
105 4 2 5 5 5 5 5 3 5 4 
100 4 2 5 5 5 5 5 5 4 
100 4 2 5 5 5 5 5 1 2 
100 4 2 5 5 5 5 5 1 5 
100 4 2 5 5 5 5 5 5 4 
85 4 2 5 5 5 5 5 3 5 3 
80 4 2 5 5 5 5 5 2 3 
80 4 2 5 5 5 5 5 3 1 4 
45 4 2 5 5 5 5 6 3 
-10 4 2 5 5 5 5 5 3 4 3 2 2 6 6 
-25 4 2 5 5 5 5 5 3 4 3 2 5 6 5 
