125 6 5 5 5 3 4 6 2 6 
110 6 5 5 5 3 4 6 2 2 
110 6 5 5 5 3 4 6 2 2 
85 6 5 5 5 3 4 4 2 6 
85 6 5 5 5 3 4 6 4 2 
85 6 5 5 5 3 4 6 5 4 
80 6 5 5 5 3 4 6 3 6 
75 6 5 5 5 3 4 6 6 
75 6 5 5 5 3 4 6 6 
75 6 5 5 5 3 4 6 6 
75 6 5 5 5 3 4 6 6 
65 6 5 5 5 3 4 3 5 6 
65 6 5 5 5 3 4 6 3 2 
65 6 5 5 5 3 4 6 3 5 
65 6 5 5 5 3 4 6 3 5 
60 6 5 5 5 3 4 6 1 1 
60 6 5 5 5 3 4 6 4 4 1 
60 6 5 5 5 3 4 6 4 1 3 
60 6 5 5 5 3 4 4 6 1 
50 6 5 5 5 6 6 3 
40 6 5 5 5 3 4 6 3 4 
20 6 5 5 5 3 4 6 3 3 
20 6 5 5 5 3 4 6 3 3 
-5 6 5 5 5 3 4 4 1 
-30 6 5 5 5 3 4 1 
-30 6 5 5 5 3 4 1 
-70 6 5 5 6 
-85 6 5 5 2 
-110 6 5 5 1 
-110 6 5 5 1 
-110 6 5 5 4 
-110 6 5 5 1 
-110 6 5 5 1 
-110 6 5 5 1 
-130 6 5 5 3 
-130 6 5 5 3 
-130 6 5 5 3 
-130 6 5 5 3 
-130 6 5 5 3 
-130 6 5 5 3 5 4 
-135 6 5 2 
-160 6 5 4 
-160 6 5 4 
-180 6 5 3 
-180 6 5 3 
-200 2 5 
-210 6 1 
-210 6 1 
