40 5 6 5 5 5 4 2 4 
-110 5 6 5 5 5 4 4 4 1 5 4 1 3 2 2 4 5 3 3 3 6 5 2 1 
-110 5 6 5 5 5 4 4 4 1 5 4 1 3 2 2 4 5 3 3 3 6 5 
-110 5 6 5 5 5 4 4 4 1 5 4 1 3 2 2 4 5 3 3 3 6 5 2 1 
-110 5 6 5 5 5 4 4 4 1 5 4 1 3 2 2 4 5 3 3 3 6 5 2 1 
-110 5 6 5 5 5 4 4 4 1 5 4 1 3 2 2 4 5 3 3 3 6 5 2 1 
-110 5 6 5 5 5 4 4 4 1 5 4 1 3 2 2 4 5 3 3 3 6 5 2 
-110 5 6 5 5 5 4 4 4 1 5 4 1 3 2 2 4 5 3 3 3 6 5 2 
-110 5 6 5 5 5 4 4 4 1 5 4 1 3 2 2 4 5 3 3 3 6 5 
-110 5 6 5 5 5 4 4 4 1 5 4 1 3 2 2 4 5 3 3 3 6 5 2 1 
-110 5 6 5 5 5 4 4 4 1 5 4 1 3 2 2 4 5 3 3 3 6 5 2 
-110 5 6 5 5 5 4 4 4 1 5 4 1 3 2 2 4 5 3 3 3 6 5 
-110 5 6 5 5 5 4 4 4 1 5 4 1 3 2 2 4 5 3 3 3 6 5 2 
-110 5 6 5 5 5 4 4 4 1 5 4 1 3 2 2 4 5 3 3 3 6 5 2 1 
-110 5 6 5 5 5 4 4 4 1 5 4 1 3 2 2 4 5 3 3 3 6 5 
-110 5 6 5 5 5 4 4 4 1 5 4 1 3 2 2 4 5 3 3 3 6 5 2 
-110 5 6 5 5 5 4 4 4 1 5 4 1 3 2 2 4 5 3 3 3 6 5 2 
-110 5 6 5 5 5 4 4 4 1 5 4 1 3 2 2 4 5 3 3 3 6 5 2 1 
-110 5 6 5 5 5 4 4 4 1 5 4 1 3 2 2 4 5 3 3 3 6 5 2 1 
-110 5 6 5 5 5 4 4 4 1 5 4 1 3 2 2 4 5 3 3 3 6 5 
-110 5 6 5 5 5 4 4 4 1 5 4 1 3 2 2 4 5 3 3 3 6 5 2 1 
-110 5 6 5 5 5 4 4 4 1 5 4 1 3 2 2 4 5 3 3 3 6 5 
-110 5 6 5 5 5 4 4 4 1 5 4 1 3 2 2 4 5 3 3 3 6 5 2 1 
-110 5 6 5 5 5 4 4 4 1 5 4 1 3 2 2 4 5 3 3 3 6 5 2 1 
-110 5 6 5 5 5 4 4 4 1 5 4 1 3 2 2 4 5 3 3 3 6 5 2 1 
-110 5 6 5 5 5 4 4 4 1 5 4 1 
-110 5 6 5 5 5 4 4 4 1 5 4 
-110 5 6 5 5 5 4 4 4 1 5 4 
-110 5 6 5 5 5 4 4 4 1 5 4 1 
-110 5 6 5 5 5 4 4 4 1 5 4 1 2 4 
-110 5 6 5 5 5 4 4 4 1 5 4 1 2 
-110 5 6 5 5 5 4 4 4 1 5 4 
-110 5 6 5 5 5 4 4 4 1 5 4 
-110 5 6 5 5 5 4 4 4 1 5 
-110 5 6 5 5 5 4 4 4 1 5 4 1 2 2 
-110 5 6 5 5 5 4 4 4 1 5 4 1 
-110 5 6 5 5 5 4 4 4 1 5 4 
-110 5 6 5 5 5 4 4 4 1 5 
-110 5 6 5 5 5 4 4 4 1 5 4 1 2 3 
-110 5 6 5 5 5 4 4 4 1 5 4 
-110 5 6 5 5 5 4 4 4 1 5 4 
-110 5 6 5 5 5 4 4 4 1 5 4 1 
-110 5 6 5 5 5 4 4 4 1 5 4 1 5 
-110 5 6 5 5 5 4 4 4 1 5 
-110 5 6 5 5 5 4 4 4 1 5 4 1 
-110 5 6 5 5 5 4 4 4 1 5 4 1 3 2 2 
-160 5 6 5 5 5 4 4 4 1 5 4 1 3 2 2 4 5 3 3 3 6 5 2 1 3 1 
-205 5 6 5 5 5 5 5 1 5 5 
