1295 4 1 6 5 5 5 5 5 6 1 6 5 6 5 6 5 4 2 1 2 2 2 2 3 1 3 6 6 4 4 1 6 2 4 6 2 
1235 4 1 6 5 5 5 5 5 6 1 6 5 6 5 6 5 4 2 1 2 2 2 2 2 3 6 4 4 6 4 5 4 2 5 
1225 4 1 6 5 5 5 5 5 6 1 6 5 6 5 6 5 4 2 1 2 2 2 2 2 3 6 4 4 6 5 4 4 1 6 
1210 4 1 6 5 5 5 5 5 6 1 6 5 6 5 6 5 4 2 1 2 2 2 2 2 3 6 4 4 6 6 2 2 6 
1185 4 1 6 5 5 5 5 5 6 1 6 5 6 5 6 5 4 2 1 2 2 2 2 2 3 6 4 4 3 2 6 1 4 3 1 1 5 
1175 4 1 6 5 5 5 5 5 6 1 6 5 6 5 6 5 4 2 1 2 2 2 2 3 2 5 1 4 4 6 6 6 
1175 4 1 6 5 5 5 5 5 6 1 6 5 6 5 6 5 4 2 1 2 2 2 2 2 3 6 4 4 3 2 6 3 1 3 5 
1170 4 1 6 5 5 5 5 5 6 1 6 5 6 5 6 5 4 2 1 2 2 2 2 2 3 6 4 4 3 2 3 4 2 6 
1165 4 1 6 5 5 5 5 5 6 1 6 5 6 5 6 5 4 2 1 2 2 2 2 2 3 6 4 4 3 5 6 2 3 2 2 4 3 1 
1155 4 1 6 5 5 5 5 5 6 1 6 5 6 5 6 5 4 2 1 2 2 2 2 2 3 6 4 4 3 2 6 6 
1155 4 1 6 5 5 5 5 5 6 1 6 5 6 5 6 5 4 2 1 2 2 2 2 2 3 6 4 4 3 2 6 6 
1155 4 1 6 5 5 5 5 5 6 1 6 5 6 5 6 5 4 2 1 2 2 2 2 2 3 6 4 4 3 2 6 6 
1085 4 1 6 5 5 5 5 5 6 1 6 5 6 5 6 5 4 2 1 2 2 2 2 2 3 6 4 4 6 2 
1075 4 1 6 5 5 5 5 5 6 1 6 5 6 5 6 5 4 2 1 2 2 2 2 2 3 6 4 4 3 2 5 
1075 4 1 6 5 5 5 5 5 6 1 6 5 6 5 6 5 4 2 1 2 2 2 2 2 3 6 4 4 3 2 5 
1075 4 1 6 5 5 5 5 5 6 1 6 5 6 5 6 5 4 2 1 2 2 2 2 2 3 6 4 4 3 1 1 5 
1075 4 1 6 5 5 5 5 5 6 1 6 5 6 5 6 5 4 2 1 2 2 2 2 2 3 6 4 4 3 2 2 
1060 4 1 6 5 5 5 5 5 6 1 6 5 6 5 6 5 4 2 1 2 2 2 2 2 3 4 6 6 2 
1055 4 1 6 5 5 5 5 5 6 1 6 5 6 5 6 5 4 2 1 2 2 2 2 2 3 6 4 4 3 2 3 1 
1055 4 1 6 5 5 5 5 5 6 1 6 5 6 5 6 5 4 2 1 2 2 2 2 2 3 6 4 4 3 1 3 5 
1050 4 1 6 5 5 5 5 5 6 1 6 5 6 5 6 5 4 2 1 2 2 2 2 2 3 6 4 4 3 2 4 
1050 4 1 6 5 5 5 5 5 6 1 6 5 6 5 6 5 4 2 1 2 2 2 2 2 3 6 4 4 3 1 2 
1050 4 1 6 5 5 5 5 5 6 1 6 5 6 5 6 5 4 2 1 2 2 2 2 2 3 6 4 4 3 1 2 
1050 4 1 6 5 5 5 5 5 6 1 6 5 6 5 6 5 4 2 1 2 2 2 2 2 3 6 4 4 3 2 1 
1050 4 1 6 5 5 5 5 5 6 1 6 5 6 5 6 5 4 2 1 2 2 2 2 2 3 6 4 4 3 5 1 
1050 4 1 6 5 5 5 5 5 6 1 6 5 6 5 6 5 4 2 1 2 2 2 2 2 3 6 4 4 3 2 4 
1050 4 1 6 5 5 5 5 5 6 1 6 5 6 5 6 5 4 2 1 2 2 2 2 2 3 6 4 4 3 2 4 
1050 4 1 6 5 5 5 5 5 6 1 6 5 6 5 6 5 4 2 1 2 2 2 2 2 3 6 4 4 3 4 2 
1050 4 1 6 5 5 5 5 5 6 1 6 5 6 5 6 5 4 2 1 2 2 2 2 3 2 5 1 4 4 4 2 1 
1050 4 1 6 5 5 5 5 5 6 1 6 5 6 5 6 5 4 2 1 2 2 2 2 3 2 5 1 4 4 4 2 5 
1045 4 1 6 5 5 5 5 5 6 1 6 5 6 5 6 5 4 2 1 2 2 2 2 2 3 6 4 4 4 2 
1045 4 1 6 5 5 5 5 5 6 1 6 5 6 5 6 5 4 2 1 2 2 2 2 2 3 6 4 4 1 5 
1045 4 1 6 5 5 5 5 5 6 1 6 5 6 5 6 5 4 2 1 2 2 2 2 2 3 6 4 4 1 5 
1030 4 1 6 5 5 5 5 5 6 1 6 5 6 5 6 5 4 2 1 2 2 2 2 2 3 5 2 1 5 
1025 4 1 6 5 5 5 5 5 6 1 6 5 6 5 6 5 4 2 1 2 2 2 2 2 3 6 4 4 5 3 
1020 4 1 6 5 5 5 5 5 6 1 6 5 6 5 6 5 4 2 1 2 2 2 2 2 3 6 4 4 2 
1000 4 1 6 5 5 5 5 5 6 1 6 5 6 5 6 5 4 2 1 2 2 2 2 3 2 5 1 3 6 
1000 4 1 6 5 5 5 5 5 6 1 6 5 6 5 6 5 4 2 1 2 2 2 2 3 2 5 1 4 2 3 4 
990 4 1 6 5 5 5 5 5 6 1 6 5 6 5 6 5 4 2 1 2 2 2 2 2 6 5 4 
970 4 1 6 5 5 5 5 5 6 1 6 5 6 5 6 5 4 2 1 2 2 2 2 2 3 6 5 
960 4 1 6 5 5 5 5 5 6 1 6 5 6 5 6 5 4 2 1 2 2 2 2 2 3 5 3 2 
960 4 1 6 5 5 5 5 5 6 1 6 5 6 5 6 5 4 2 1 2 2 2 2 3 2 5 1 4 3 
955 4 1 6 5 5 5 5 5 6 1 6 5 6 5 6 5 4 2 1 2 2 2 2 2 3 4 4 4 1 
955 4 1 6 5 5 5 5 5 6 1 6 5 6 5 6 5 4 2 1 2 2 2 2 2 5 3 5 
950 4 1 6 5 5 5 5 5 6 1 6 5 6 5 6 5 4 2 1 2 2 2 2 3 2 5 1 1 4 
945 4 1 6 5 5 5 5 5 6 1 6 5 6 5 6 5 4 2 1 2 2 2 2 2 3 6 1 
930 4 1 6 5 5 5 5 5 6 1 6 5 6 5 6 5 4 2 1 2 2 2 2 2 3 4 2 
930 4 1 6 5 5 5 5 5 6 1 6 5 6 5 6 5 4 2 1 2 2 2 2 2 3 4 1 1 
905 4 1 6 5 5 5 5 5 6 1 6 5 6 5 6 5 4 2 1 2 2 2 2 3 1 4 2 
900 4 1 6 5 5 5 5 5 6 1 6 5 6 5 6 5 4 2 1 2 2 2 2 2 2 
885 4 1 6 5 5 5 5 5 6 1 6 5 6 5 6 5 4 2 1 2 2 2 2 2 3 4 3 
875 4 1 6 5 5 5 5 5 6 1 6 5 6 5 6 5 4 2 1 2 2 2 2 2 1 
860 4 1 6 5 5 5 5 5 6 1 6 5 6 5 6 5 4 2 1 2 2 2 2 2 3 3 
860 4 1 6 5 5 5 5 5 6 1 6 5 6 5 6 5 4 2 1 2 2 2 2 2 3 3 
860 4 1 6 5 5 5 5 5 6 1 6 5 6 5 6 5 4 2 1 2 2 2 2 2 3 3 
825 4 1 6 5 5 5 5 5 6 1 6 5 6 5 6 5 4 2 1 2 2 2 2 1 
815 4 1 6 5 5 5 5 5 6 1 6 5 6 5 6 5 4 2 1 2 2 2 6 
800 4 1 6 5 5 5 5 5 6 1 6 5 6 5 6 5 4 2 1 2 2 2 5 
695 4 1 6 5 5 5 5 5 6 1 6 5 6 5 6 5 4 2 1 2 2 2 2 2 3 6 4 4 3 2 
695 4 1 6 5 5 5 5 5 6 1 6 5 6 5 6 5 4 2 1 2 2 2 2 2 3 6 4 4 3 2 
690 4 1 6 5 5 5 5 5 6 1 6 5 6 5 6 5 4 2 1 2 2 2 2 3 2 5 1 4 4 6 
525 4 1 6 5 5 5 5 5 6 1 6 5 6 5 6 5 4 2 1 2 2 2 2 2 3 
500 4 1 6 5 5 5 5 5 6 1 6 5 6 5 6 5 4 2 1 2 2 2 2 2 3 
65 4 1 6 5 5 5 5 5 6 1 6 5 6 5 6 5 4 2 1 2 2 2 2 2 3 6 4 4 5 6 4 6 6 
