1305 6 5 5 5 5 5 3 5 6 5 5 5 6 6 5 3 4 1 6 2 2 2 1 2 4 2 6 5 6 4 6 1 1 4 3 5 2 
1295 6 5 5 5 5 5 3 5 6 5 5 5 6 6 5 3 4 1 6 2 2 2 1 2 4 5 3 4 5 4 4 5 2 6 4 6 1 
1280 6 5 5 5 5 5 3 5 6 5 5 5 6 6 5 3 4 1 6 2 2 2 1 2 4 2 6 5 6 4 6 2 3 4 5 
1275 6 5 5 5 5 5 3 5 6 5 5 5 6 6 5 3 4 1 6 2 2 2 1 2 4 2 6 5 6 4 6 2 1 4 2 
1270 6 5 5 5 5 5 3 5 6 5 5 5 6 6 5 3 4 1 6 2 2 2 1 2 4 2 6 5 6 4 6 2 6 
1265 6 5 5 5 5 5 3 5 6 5 5 5 6 6 5 3 4 1 6 2 2 2 1 2 4 2 6 5 6 4 6 2 6 3 
1265 6 5 5 5 5 5 3 5 6 5 5 5 6 6 5 3 4 1 6 2 2 2 1 2 4 2 6 5 6 4 6 2 6 6 
1265 6 5 5 5 5 5 3 5 6 5 5 5 6 6 5 3 4 1 6 2 2 2 1 2 4 2 6 5 6 4 2 1 2 4 4 
1255 6 5 5 5 5 5 3 5 6 5 5 5 6 6 5 3 4 1 6 2 2 2 1 2 4 2 6 5 6 4 4 1 2 6 
1255 6 5 5 5 5 5 3 5 6 5 5 5 6 6 5 3 4 1 6 2 2 2 1 2 4 2 6 5 6 4 6 2 5 
1250 6 5 5 5 5 5 3 5 6 5 5 5 6 6 5 3 4 1 6 2 2 2 1 2 4 2 6 5 6 4 6 2 3 5 
1250 6 5 5 5 5 5 3 5 6 5 5 5 6 6 5 3 4 1 6 2 2 2 1 2 4 2 6 5 6 4 4 3 3 4 2 5 
1235 6 5 5 5 5 5 3 5 6 5 5 5 6 6 5 3 4 1 6 2 2 2 1 2 4 2 6 5 6 4 6 2 3 4 3 3 
1235 6 5 5 5 5 5 3 5 6 5 5 5 6 6 5 3 4 1 6 2 2 2 1 2 4 2 6 5 6 4 6 3 4 2 
1230 6 5 5 5 5 5 3 5 6 5 5 5 6 6 5 3 4 1 6 2 2 2 1 2 4 2 6 5 6 4 6 4 2 
1220 6 5 5 5 5 5 3 5 6 5 5 5 6 6 5 3 4 1 6 2 2 2 1 2 4 2 6 5 6 4 5 3 1 4 1 
1220 6 5 5 5 5 5 3 5 6 5 5 5 6 6 5 3 4 1 6 2 2 2 1 2 4 2 6 5 6 4 4 2 3 3 2 5 
1195 6 5 5 5 5 5 3 5 6 5 5 5 6 6 5 3 4 1 6 2 2 2 1 2 4 5 3 4 5 4 1 3 4 4 2 5 1 5 
1185 6 5 5 5 5 5 3 5 6 5 5 5 6 6 5 3 4 1 6 2 2 2 1 2 4 2 6 5 6 4 4 3 6 
1140 6 5 5 5 5 5 3 5 6 5 5 5 6 6 5 3 4 1 6 2 2 2 1 2 4 5 3 4 5 4 1 4 4 5 1 
1120 6 5 5 5 5 5 3 5 6 5 5 5 6 6 5 3 4 1 6 2 2 2 1 2 4 2 6 5 6 4 6 2 
1110 6 5 5 5 5 5 3 5 6 5 5 5 6 6 5 3 4 1 6 2 2 2 1 2 4 5 3 4 5 4 1 3 4 6 
1105 6 5 5 5 5 5 3 5 6 5 5 5 6 6 5 3 4 1 6 2 2 2 1 2 4 5 3 4 5 4 6 2 
1105 6 5 5 5 5 5 3 5 6 5 5 5 6 6 5 3 4 1 6 2 2 2 1 2 4 5 3 4 5 4 1 4 6 
1105 6 5 5 5 5 5 3 5 6 5 5 5 6 6 5 3 4 1 6 2 2 2 1 2 4 5 3 4 5 4 6 2 
1090 6 5 5 5 5 5 3 5 6 5 5 5 6 6 5 3 4 1 6 2 2 2 1 2 4 2 6 5 6 4 6 1 1 
1090 6 5 5 5 5 5 3 5 6 5 5 5 6 6 5 3 4 1 6 2 2 2 1 2 4 2 6 5 6 4 3 2 
1090 6 5 5 5 5 5 3 5 6 5 5 5 6 6 5 3 4 1 6 2 2 2 1 2 4 5 3 4 5 4 5 2 
1090 6 5 5 5 5 5 3 5 6 5 5 5 6 6 5 3 4 1 6 2 2 2 1 2 4 2 6 5 6 4 3 5 2 
1090 6 5 5 5 5 5 3 5 6 5 5 5 6 6 5 3 4 1 6 2 2 2 1 2 4 5 3 4 5 4 5 2 
1085 6 5 5 5 5 5 3 5 6 5 5 5 6 6 5 3 4 1 6 2 2 2 1 2 4 5 3 4 5 4 1 3 6 
1075 6 5 5 5 5 5 3 5 6 5 5 5 6 6 5 3 4 1 6 2 2 2 1 2 4 5 3 4 5 4 1 6 1 
1070 6 5 5 5 5 5 3 5 6 5 5 5 6 6 5 3 4 1 6 2 2 2 1 2 4 5 3 4 5 4 1 3 2 
1070 6 5 5 5 5 5 3 5 6 5 5 5 6 6 5 3 4 1 6 2 2 2 1 2 4 5 3 4 5 4 1 3 5 
1070 6 5 5 5 5 5 3 5 6 5 5 5 6 6 5 3 4 1 6 2 2 2 1 2 4 5 3 4 5 4 1 3 2 
1065 6 5 5 5 5 5 3 5 6 5 5 5 6 6 5 3 4 1 6 2 2 2 1 2 4 5 3 4 5 4 1 2 
1065 6 5 5 5 5 5 3 5 6 5 5 5 6 6 5 3 4 1 6 2 2 2 1 2 4 5 3 4 5 4 4 2 
1065 6 5 5 5 5 5 3 5 6 5 5 5 6 6 5 3 4 1 6 2 2 2 1 2 4 5 3 4 5 4 1 2 
1065 6 5 5 5 5 5 3 5 6 5 5 5 6 6 5 3 4 1 6 2 2 2 1 2 4 5 3 4 5 4 5 4 
1065 6 5 5 5 5 5 3 5 6 5 5 5 6 6 5 3 4 1 6 2 2 2 1 2 4 5 3 4 5 4 1 4 1 
1045 6 5 5 5 5 5 3 5 6 5 5 5 6 6 5 3 4 1 6 2 2 2 1 2 4 5 3 4 5 4 4 4 3 
1040 6 5 5 5 5 5 3 5 6 5 5 5 6 6 5 3 4 1 6 2 2 2 1 2 4 5 3 4 5 4 2 
1040 6 5 5 5 5 5 3 5 6 5 5 5 6 6 5 3 4 1 6 2 2 2 1 2 4 5 3 4 5 4 1 1 
1040 6 5 5 5 5 5 3 5 6 5 5 5 6 6 5 3 4 1 6 2 2 2 1 2 4 5 3 4 5 4 2 
1040 6 5 5 5 5 5 3 5 6 5 5 5 6 6 5 3 4 1 6 2 2 2 1 2 4 5 3 4 5 4 1 1 
1040 6 5 5 5 5 5 3 5 6 5 5 5 6 6 5 3 4 1 6 2 2 2 1 2 4 5 3 4 5 4 1 1 
1040 6 5 5 5 5 5 3 5 6 5 5 5 6 6 5 3 4 1 6 2 2 2 1 2 4 5 3 4 5 4 2 
1040 6 5 5 5 5 5 3 5 6 5 5 5 6 6 5 3 4 1 6 2 2 2 1 2 4 5 3 4 5 4 1 1 
995 6 5 5 5 5 5 3 5 6 5 5 5 6 6 5 3 4 1 6 2 2 2 1 2 4 5 3 4 5 4 3 
995 6 5 5 5 5 5 3 5 6 5 5 5 6 6 5 3 4 1 6 2 2 2 1 2 4 5 3 4 5 4 3 
995 6 5 5 5 5 5 3 5 6 5 5 5 6 6 5 3 4 1 6 2 2 2 1 2 4 5 3 4 5 4 3 
995 6 5 5 5 5 5 3 5 6 5 5 5 6 6 5 3 4 1 6 2 2 2 1 2 4 5 3 4 5 4 3 
995 6 5 5 5 5 5 3 5 6 5 5 5 6 6 5 3 4 1 6 2 2 2 1 2 4 5 3 4 5 4 3 
-120 6 5 5 5 5 5 3 5 6 5 5 5 6 6 5 3 4 1 6 2 2 2 1 2 4 2 6 5 6 4 6 2 4 5 2 2 
-120 6 5 5 5 5 5 3 5 6 5 5 5 6 6 5 3 4 1 6 2 2 2 1 2 4 2 6 5 6 4 6 1 5 4 1 
-180 6 5 5 5 5 5 3 5 6 5 5 5 6 6 5 3 4 1 6 2 2 2 1 2 4 2 6 5 6 4 6 2 6 1 2 
-195 6 5 5 5 5 5 3 5 6 5 5 5 6 6 5 3 4 1 6 2 2 2 1 2 4 2 6 5 6 4 6 5 4 6 
-195 6 5 5 5 5 5 3 5 6 5 5 5 6 6 5 3 4 1 6 2 2 2 1 2 4 2 6 5 6 4 6 2 2 6 
-220 6 5 5 5 5 5 3 5 6 5 5 5 6 6 5 3 4 1 6 2 2 2 1 2 4 2 6 5 6 4 6 4 1 3 
-220 6 5 5 5 5 5 3 5 6 5 5 5 6 6 5 3 4 1 6 2 2 2 1 2 4 2 6 5 6 4 6 4 6 5 
-220 6 5 5 5 5 5 3 5 6 5 5 5 6 6 5 3 4 1 6 2 2 2 1 2 4 2 6 5 3 1 3 4 6 6 5 
-220 6 5 5 5 5 5 3 5 6 5 5 5 6 6 5 3 4 1 6 2 2 2 1 2 4 2 6 5 6 4 6 2 1 1 2 
-220 6 5 5 5 5 5 3 5 6 5 5 5 6 6 5 3 4 1 6 2 2 2 1 2 4 5 3 4 5 4 4 6 6 
-220 6 5 5 5 5 5 3 5 6 5 5 5 6 6 5 3 4 1 6 2 2 2 1 2 4 2 6 5 6 4 6 2 3 4 2 3 
