230 5 6 5 5 5 5 5 2 6 2 2 1 2 5 6 6 5 6 6 2 5 4 6 
230 5 6 5 5 5 5 5 2 6 2 2 1 2 5 6 6 5 6 6 2 5 4 6 
230 5 6 5 5 5 5 5 2 6 2 2 1 2 5 6 6 5 6 6 2 5 4 
230 5 6 5 5 5 5 5 2 6 2 2 1 2 5 6 6 5 6 6 2 5 4 6 1 
230 5 6 5 5 5 5 5 2 6 2 2 1 2 5 6 6 5 6 6 2 5 4 6 1 
230 5 6 5 5 5 5 5 2 6 2 2 1 2 5 6 6 5 6 6 2 5 4 
230 5 6 5 5 5 5 5 2 6 2 2 1 2 5 6 6 5 6 6 2 5 4 6 1 
230 5 6 5 5 5 5 5 2 6 2 2 1 2 5 6 6 5 6 6 2 5 4 6 
230 5 6 5 5 5 5 5 2 6 2 2 1 2 5 6 6 5 6 6 2 5 4 6 1 
230 5 6 5 5 5 5 5 2 6 2 2 1 2 5 6 6 5 6 6 2 5 4 
230 5 6 5 5 5 5 5 2 6 2 2 1 2 5 6 6 5 6 6 2 5 4 6 1 
230 5 6 5 5 5 5 5 2 6 2 2 1 2 5 6 6 5 6 6 2 5 4 6 1 
230 5 6 5 5 5 5 5 2 6 2 2 1 2 5 6 6 5 6 6 2 5 4 
230 5 6 5 5 5 5 5 2 6 2 2 1 2 5 6 6 5 6 6 2 5 4 6 
-75 5 6 5 5 5 5 5 2 6 2 2 1 2 5 6 6 5 6 6 2 5 4 6 1 5 
-95 5 6 5 5 5 5 5 2 6 2 2 1 2 5 6 6 5 6 6 2 5 4 6 1 
-95 5 6 5 5 5 5 5 2 6 2 2 1 2 5 6 6 5 6 6 2 5 4 6 1 
-95 5 6 5 5 5 5 5 2 6 2 2 1 2 5 6 6 5 6 6 2 5 4 
-95 5 6 5 5 5 5 5 2 6 2 2 1 2 5 6 6 4 6 3 3 5 
-95 5 6 5 5 5 5 5 2 6 2 2 1 2 5 6 6 4 3 5 3 
-95 5 6 5 5 5 5 5 2 6 2 2 1 2 5 6 6 4 4 6 2 1 4 1 
-95 5 6 5 5 5 5 5 2 6 2 2 1 2 5 6 6 1 6 5 4 3 6 3 
-95 5 6 5 5 5 5 5 2 6 2 2 1 2 5 6 6 4 4 4 6 2 5 3 
-95 5 6 5 5 5 5 5 2 6 2 2 1 2 5 6 6 4 3 6 4 4 5 5 
-95 5 6 5 5 5 5 5 2 6 2 2 1 2 5 6 6 4 6 4 2 2 1 
-95 5 6 5 5 5 5 5 2 6 2 2 1 2 5 6 6 4 3 2 3 5 5 
-95 5 6 5 5 5 5 5 2 6 2 2 1 2 5 6 6 4 3 4 6 6 3 
-100 5 6 5 5 5 5 5 2 6 2 2 1 2 5 6 6 5 6 6 2 5 4 6 1 4 5 
-100 5 6 5 5 5 5 5 2 6 2 2 1 2 5 6 6 5 6 6 2 5 4 6 5 
-110 5 6 5 5 5 5 5 2 5 4 2 3 1 6 5 5 1 
-110 5 6 5 5 5 5 5 2 6 2 2 1 2 5 3 5 4 1 6 6 
-120 5 6 5 5 5 5 5 2 5 6 6 4 2 2 1 4 
-120 5 6 5 5 5 5 5 2 5 4 6 3 5 6 2 
-155 5 6 5 5 5 5 5 2 6 2 2 1 2 5 1 4 3 4 2 1 3 
-155 5 6 5 5 5 5 5 2 6 2 2 1 2 5 6 6 5 6 6 2 5 4 
-155 5 6 5 5 5 5 5 2 5 4 6 5 1 5 6 3 4 
-185 5 6 5 5 5 5 5 2 6 2 2 1 2 5 6 6 5 1 2 2 2 2 
-185 5 6 5 5 5 5 5 2 5 2 3 2 2 2 5 6 5 
-185 5 6 5 5 5 5 5 2 6 2 2 1 2 5 6 6 5 6 6 2 5 4 6 
-185 5 6 5 5 5 5 5 2 6 2 2 1 2 5 1 6 2 2 4 1 
-185 5 6 5 5 5 5 5 2 6 2 2 1 2 5 6 6 5 1 5 5 1 
-185 5 6 5 5 5 5 5 2 6 2 2 1 2 5 6 6 5 1 2 1 1 6 
-185 5 6 5 5 5 5 5 2 6 2 2 1 2 5 6 6 5 6 6 2 5 4 6 
-200 5 6 5 5 5 5 5 2 5 4 6 6 6 3 4 2 5 
-225 5 6 5 5 5 5 5 2 6 2 2 1 2 5 6 6 5 6 6 2 5 4 6 1 
-225 5 6 5 5 5 5 5 2 6 2 2 1 2 5 6 4 2 5 4 3 2 4 5 
-225 5 6 5 5 5 5 5 2 5 6 6 6 1 6 4 1 5 3 
-225 5 6 5 5 5 5 5 2 6 2 2 1 2 5 6 6 5 6 6 2 5 4 6 
