710 5 6 5 5 5 5 4 3 2 1 6 1 4 2 5 5 6 3 6 2 2 1 6 
710 5 6 5 5 5 5 4 3 2 1 6 1 4 2 5 5 6 3 6 2 1 2 6 
685 5 6 5 5 5 5 4 3 2 1 6 1 4 2 5 5 6 3 6 1 2 1 6 
675 5 6 5 5 5 5 4 3 2 1 6 1 4 2 5 5 6 3 6 2 2 2 3 
670 5 6 5 5 5 5 4 3 2 1 6 1 4 2 5 5 6 3 6 2 1 1 5 
670 5 6 5 5 5 5 4 3 2 1 6 1 4 2 5 5 6 3 6 2 1 1 5 
670 5 6 5 5 5 5 4 3 2 1 6 1 4 2 5 5 6 3 6 1 1 2 2 4 
670 5 6 5 5 5 5 4 3 2 1 6 1 4 2 5 5 6 3 6 2 2 5 
660 5 6 5 5 5 5 4 3 2 1 6 1 4 2 5 5 6 3 6 2 1 6 
660 5 6 5 5 5 5 4 3 2 1 6 1 4 2 5 5 6 3 6 2 1 6 
660 5 6 5 5 5 5 4 3 2 1 6 1 4 2 5 5 6 3 6 2 1 6 
660 5 6 5 5 5 5 4 3 2 1 6 1 4 2 5 5 6 3 6 2 1 6 
650 5 6 5 5 5 5 4 3 2 1 6 1 4 2 5 5 6 3 6 2 1 2 3 
650 5 6 5 5 5 5 4 3 2 1 6 1 4 2 5 5 6 3 6 2 1 2 3 
650 5 6 5 5 5 5 4 3 2 1 6 1 4 2 5 5 6 3 6 2 2 1 3 
650 5 6 5 5 5 5 4 3 2 1 6 1 4 2 5 5 6 3 6 2 1 2 3 
650 5 6 5 5 5 5 4 3 2 1 6 1 4 2 5 5 6 3 6 2 1 2 3 
650 5 6 5 5 5 5 4 3 2 1 6 1 4 2 5 5 6 3 6 2 1 2 3 
645 5 6 5 5 5 5 4 3 2 1 6 1 4 2 5 5 6 3 6 2 1 5 
645 5 6 5 5 5 5 4 3 2 1 6 1 4 2 5 5 6 3 6 2 1 5 
645 5 6 5 5 5 5 4 3 2 1 6 1 4 2 5 5 6 3 6 2 1 5 
645 5 6 5 5 5 5 4 3 2 1 6 1 4 2 5 5 6 3 6 2 1 1 4 
645 5 6 5 5 5 5 4 3 2 1 6 1 4 2 5 5 6 3 6 2 1 5 
645 5 6 5 5 5 5 4 3 2 1 6 1 4 2 5 5 6 3 6 2 2 4 
645 5 6 5 5 5 5 4 3 2 1 6 1 4 2 5 5 6 3 6 2 1 5 
645 5 6 5 5 5 5 4 3 2 1 6 1 4 2 5 5 6 3 6 2 1 5 
635 5 6 5 5 5 5 4 3 2 1 6 1 4 2 5 5 6 3 6 2 6 
630 5 6 5 5 5 5 4 3 2 1 6 1 4 2 5 5 6 5 6 6 
630 5 6 5 5 5 5 4 3 2 1 6 1 4 2 5 5 6 5 6 6 
630 5 6 5 5 5 5 4 3 2 1 6 1 4 2 5 5 6 5 6 6 
630 5 6 5 5 5 5 4 3 2 1 6 1 4 2 5 5 6 5 6 6 
620 5 6 5 5 5 5 4 3 2 1 6 1 4 2 5 5 6 3 6 2 5 
620 5 6 5 5 5 5 4 3 2 1 6 1 4 2 5 5 6 3 6 2 1 4 
620 5 6 5 5 5 5 4 3 2 1 6 1 4 2 5 5 6 3 6 2 5 
620 5 6 5 5 5 5 4 3 2 1 6 1 4 2 5 5 6 3 6 2 1 4 
620 5 6 5 5 5 5 4 3 2 1 6 1 4 2 5 5 6 3 6 2 1 4 
620 5 6 5 5 5 5 4 3 2 1 6 1 4 2 5 5 6 3 6 2 1 4 
620 5 6 5 5 5 5 4 3 2 1 6 1 4 2 5 5 6 3 6 2 5 
620 5 6 5 5 5 5 4 3 2 1 6 1 4 2 5 5 6 3 6 2 5 
620 5 6 5 5 5 5 4 3 2 1 6 1 4 2 5 5 6 3 6 2 1 4 
615 5 6 5 5 5 5 4 3 2 1 6 1 4 2 5 5 6 5 6 5 
615 5 6 5 5 5 5 4 3 2 1 6 1 4 2 5 5 6 5 6 5 
615 5 6 5 5 5 5 4 3 2 1 6 1 4 2 5 5 6 5 6 5 
615 5 6 5 5 5 5 4 3 2 1 6 1 4 2 5 5 6 5 6 2 
615 5 6 5 5 5 5 4 3 2 1 6 1 4 2 5 5 6 5 6 5 
610 5 6 5 5 5 5 4 3 2 1 6 1 4 2 5 5 6 3 6 1 6 
605 5 6 5 5 5 5 4 3 2 1 6 1 4 2 5 5 6 5 4 2 1 3 
600 5 6 5 5 5 5 4 3 2 1 6 1 4 2 5 5 6 3 6 2 1 3 
600 5 6 5 5 5 5 4 3 2 1 6 1 4 2 5 5 6 3 6 2 1 3 
600 5 6 5 5 5 5 4 3 2 1 6 1 4 2 5 5 6 3 6 1 2 3 
600 5 6 5 5 5 5 4 3 2 1 6 1 4 2 5 5 6 3 6 2 1 3 
600 5 6 5 5 5 5 4 3 2 1 6 1 4 2 5 5 6 3 6 2 1 3 
595 5 6 5 5 5 5 4 3 2 1 6 1 4 2 5 5 6 3 6 1 5 
595 5 6 5 5 5 5 4 3 2 1 6 1 4 2 5 5 6 3 6 2 4 
595 5 6 5 5 5 5 4 3 2 1 6 1 4 2 5 5 6 3 6 2 4 
595 5 6 5 5 5 5 4 3 2 1 6 1 4 2 5 5 6 3 6 2 4 
595 5 6 5 5 5 5 4 3 2 1 6 1 4 2 5 5 6 3 6 2 4 
595 5 6 5 5 5 5 4 3 2 1 6 1 4 2 5 5 6 3 6 2 4 
595 5 6 5 5 5 5 4 3 2 1 6 1 4 2 5 5 6 3 6 2 4 
590 5 6 5 5 5 5 4 3 2 1 6 1 4 2 5 5 6 5 6 1 
590 5 6 5 5 5 5 4 3 2 1 6 1 4 2 5 5 6 5 6 1 
590 5 6 5 5 5 5 4 3 2 1 6 1 4 2 5 5 6 5 6 1 
590 5 6 5 5 5 5 4 3 2 1 6 1 4 2 5 5 6 5 6 4 
590 5 6 5 5 5 5 4 3 2 1 6 1 4 2 5 5 6 5 6 4 
590 5 6 5 5 5 5 4 3 2 1 6 1 4 2 5 5 6 5 6 4 
590 5 6 5 5 5 5 4 3 2 1 6 1 4 2 5 5 6 5 6 4 
590 5 6 5 5 5 5 4 3 2 1 6 1 4 2 5 5 6 5 6 4 
585 5 6 5 5 5 5 4 3 2 1 6 1 4 2 5 5 6 3 6 6 
585 5 6 5 5 5 5 4 3 2 1 6 1 4 2 5 5 6 3 6 6 
585 5 6 5 5 5 5 4 3 2 1 6 1 4 2 5 5 6 3 6 6 
580 5 6 5 5 5 5 4 3 2 1 6 1 4 2 5 5 6 5 4 1 1 3 
580 5 6 5 5 5 5 4 3 2 1 6 1 4 2 5 5 6 5 4 1 1 3 
575 5 6 5 5 5 5 4 3 2 1 6 1 4 2 5 5 6 3 6 2 3 
575 5 6 5 5 5 5 4 3 2 1 6 1 4 2 5 5 6 3 6 2 3 
575 5 6 5 5 5 5 4 3 2 1 6 1 4 2 5 5 6 4 5 5 
570 5 6 5 5 5 5 4 3 2 1 6 1 4 2 5 5 6 3 6 5 
570 5 6 5 5 5 5 4 3 2 1 6 1 4 2 5 5 6 5 6 3 
570 5 6 5 5 5 5 4 3 2 1 6 1 4 2 5 5 6 3 6 1 4 
570 5 6 5 5 5 5 4 3 2 1 6 1 4 2 5 5 6 5 6 3 
570 5 6 5 5 5 5 4 3 2 1 6 1 4 2 5 5 6 5 6 3 
570 5 6 5 5 5 5 4 3 2 1 6 1 4 2 5 5 6 3 6 5 
570 5 6 5 5 5 5 4 3 2 1 6 1 4 2 5 5 6 5 6 3 
570 5 6 5 5 5 5 4 3 2 1 6 1 4 2 5 5 6 5 6 3 
550 5 6 5 5 5 5 4 3 2 1 6 1 4 2 5 5 6 5 5 
550 5 6 5 5 5 5 4 3 2 1 6 1 4 2 5 5 6 5 2 
550 5 6 5 5 5 5 4 3 2 1 6 1 4 2 5 5 6 5 2 
550 5 6 5 5 5 5 4 3 2 1 6 1 4 2 5 5 6 5 5 
550 5 6 5 5 5 5 4 3 2 1 6 1 4 2 5 5 6 5 2 
550 5 6 5 5 5 5 4 3 2 1 6 1 4 2 5 5 6 5 2 
550 5 6 5 5 5 5 4 3 2 1 6 1 4 2 5 5 6 5 5 
550 5 6 5 5 5 5 4 3 2 1 6 1 4 2 5 5 6 5 5 
550 5 6 5 5 5 5 4 3 2 1 6 1 4 2 5 5 6 3 6 1 3 
550 5 6 5 5 5 5 4 3 2 1 6 1 4 2 5 5 6 5 2 
550 5 6 5 5 5 5 4 3 2 1 6 1 4 2 5 5 6 5 2 
550 5 6 5 5 5 5 4 3 2 1 6 1 4 2 5 5 6 5 5 
545 5 6 5 5 5 5 4 3 2 1 6 1 4 2 5 5 6 3 6 4 
545 5 6 5 5 5 5 4 3 2 1 6 1 4 2 5 5 6 3 6 4 
545 5 6 5 5 5 5 4 3 2 1 6 1 4 2 5 5 6 3 6 4 
545 5 6 5 5 5 5 4 3 2 1 6 1 4 2 5 5 6 3 6 4 
540 5 6 5 5 5 5 4 3 2 1 6 1 4 2 5 5 6 4 6 
530 5 6 5 5 5 5 4 3 2 1 6 1 4 2 5 5 6 3 1 5 
525 5 6 5 5 5 5 4 3 2 1 6 1 4 2 5 5 6 5 1 
525 5 6 5 5 5 5 4 3 2 1 6 1 4 2 5 5 6 5 1 
525 5 6 5 5 5 5 4 3 2 1 6 1 4 2 5 5 6 5 1 
525 5 6 5 5 5 5 4 3 2 1 6 1 4 2 5 5 6 3 6 3 
525 5 6 5 5 5 5 4 3 2 1 6 1 4 2 5 5 6 3 6 3 
525 5 6 5 5 5 5 4 3 2 1 6 1 4 2 5 5 6 3 6 3 
525 5 6 5 5 5 5 4 3 2 1 6 1 4 2 5 5 6 3 6 3 
525 5 6 5 5 5 5 4 3 2 1 6 1 4 2 5 5 5 6 1 
525 5 6 5 5 5 5 4 3 2 1 6 1 4 2 5 5 6 3 6 3 
525 5 6 5 5 5 5 4 3 2 1 6 1 4 2 5 5 6 5 1 
515 5 6 5 5 5 5 4 3 2 1 6 1 4 2 5 5 6 6 
515 5 6 5 5 5 5 4 3 2 1 6 1 4 2 5 5 6 6 
515 5 6 5 5 5 5 4 3 2 1 6 1 4 2 5 5 6 6 
505 5 6 5 5 5 5 4 3 2 1 6 1 4 2 5 5 6 5 3 
505 5 6 5 5 5 5 4 3 2 1 6 1 4 2 5 5 6 3 5 
505 5 6 5 5 5 5 4 3 2 1 6 1 4 2 5 5 6 5 3 
505 5 6 5 5 5 5 4 3 2 1 6 1 4 2 5 5 6 5 3 
505 5 6 5 5 5 5 4 3 2 1 6 1 4 2 5 5 6 5 3 
500 5 6 5 5 5 5 4 3 2 1 6 1 4 2 5 5 6 2 
500 5 6 5 5 5 5 4 3 2 1 6 1 4 2 5 5 6 2 
475 5 6 5 5 5 5 4 3 2 1 6 1 4 2 5 5 6 1 
475 5 6 5 5 5 5 4 3 2 1 6 1 4 2 5 5 6 1 
475 5 6 5 5 5 5 4 3 2 1 6 1 4 2 5 5 6 1 
465 5 6 5 5 5 5 4 3 2 1 6 1 4 2 5 5 5 3 1 
435 5 6 5 5 5 5 4 3 2 1 6 1 4 2 5 5 2 
435 5 6 5 5 5 5 4 3 2 1 6 1 4 2 5 5 2 
410 5 6 5 5 5 5 4 3 2 1 6 1 4 2 5 5 1 
