140 4 2 5 5 5 5 5 5 6 
140 4 2 5 5 5 5 5 5 6 
140 4 2 5 5 5 5 5 2 6 
140 4 2 5 5 5 5 5 5 6 
140 4 2 5 5 5 5 5 2 6 
125 4 2 5 5 5 5 5 2 5 
125 4 2 5 5 5 5 5 5 2 
125 4 2 5 5 5 5 5 5 2 
125 4 2 5 5 5 5 5 5 5 
115 4 2 5 5 5 5 4 2 6 
115 4 2 5 5 5 5 5 1 6 
115 4 2 5 5 5 5 4 6 5 
105 4 2 5 5 5 5 6 6 
100 4 2 5 5 5 5 5 4 5 
100 4 2 5 5 5 5 5 2 4 
100 4 2 5 5 5 5 5 5 4 
100 4 2 5 5 5 5 5 5 1 
100 4 2 5 5 5 5 5 1 5 
100 4 2 5 5 5 5 5 4 5 
100 4 2 5 5 5 5 5 2 1 
90 4 2 5 5 5 5 4 6 4 
90 4 2 5 5 5 5 5 6 
90 4 2 5 5 5 5 5 6 
90 4 2 5 5 5 5 6 2 
90 4 2 5 5 5 5 5 6 
80 4 2 5 5 5 5 5 5 3 
80 4 2 5 5 5 5 5 3 2 6 
80 4 2 5 5 5 5 5 5 3 
80 4 2 5 5 5 5 5 2 3 
55 4 2 5 5 5 5 5 1 3 
55 4 2 5 5 5 5 5 1 3 
45 4 2 5 5 5 5 6 3 
45 4 2 5 5 5 5 6 3 
25 4 2 5 5 5 5 2 
25 4 2 5 5 5 5 2 
15 4 2 5 5 5 6 1 
10 4 2 5 5 5 5 4 3 3 
5 4 2 5 5 5 4 3 2 
0 4 2 5 5 5 5 1 
0 4 2 5 5 5 5 1 
0 4 2 5 5 5 5 1 
0 4 2 5 5 5 5 1 
0 4 2 5 5 5 5 1 
-20 4 2 5 5 5 5 3 
-20 4 2 5 5 5 5 3 
-25 4 2 5 5 5 2 
-50 4 2 5 5 5 1 
-50 4 2 5 5 5 1 
