-25 5 4 5 5 5 5 3 
-135 1 4 5 5 5 5 3 5 1 2 6 5 6 5 6 6 5 
-160 2 4 5 5 5 5 3 5 1 3 1 1 6 4 1 5 2 3 
-160 5 6 4 5 5 5 5 3 
-160 5 6 4 5 5 5 5 3 5 1 2 
-160 5 6 4 5 5 5 5 
-160 5 6 4 5 5 5 5 3 5 
-160 5 6 4 5 5 5 5 3 5 1 4 
-160 5 6 4 5 5 5 5 3 
-160 5 6 4 5 5 5 5 3 5 5 
-160 5 6 4 5 5 5 5 3 
-160 5 6 4 5 5 5 5 3 5 1 
-165 1 4 5 5 5 5 3 5 1 2 6 5 6 5 6 2 
-170 1 2 4 5 5 5 5 4 1 3 3 5 
-175 1 4 5 5 5 5 3 5 1 2 6 5 6 5 6 2 4 5 
-190 6 6 4 5 5 5 5 3 5 2 6 
-200 1 4 5 5 5 5 3 5 1 2 6 5 6 5 6 
-200 1 4 5 5 5 5 3 5 1 2 6 5 6 5 6 
-200 1 4 5 5 5 5 3 5 1 2 6 5 6 5 6 2 
-200 1 4 5 5 5 5 3 5 1 2 6 5 6 5 
-200 1 4 5 5 5 5 3 5 1 2 6 5 6 5 
-200 1 4 5 5 5 5 3 5 1 2 6 5 6 5 6 2 
-200 1 4 5 5 5 5 3 5 1 2 6 5 6 5 
-200 1 4 5 5 5 5 3 5 1 2 6 5 6 5 6 2 
-200 1 4 5 5 5 5 3 5 1 2 6 5 6 5 6 2 
-200 1 4 5 5 5 5 3 5 1 2 6 5 6 5 6 2 
-200 1 4 5 5 5 5 3 5 1 2 6 5 6 5 6 2 
-200 1 4 5 5 5 5 3 5 1 2 6 5 6 5 6 
-200 1 4 5 5 5 5 3 5 1 2 6 5 6 5 6 
-200 1 4 5 5 5 5 3 5 1 2 6 5 6 5 
-200 1 4 5 5 5 5 3 5 1 2 6 5 6 5 6 
-200 5 5 4 5 5 5 3 
-200 4 2 4 5 5 5 5 3 5 
-200 1 4 5 5 5 5 3 5 1 2 6 5 6 5 6 2 
-200 1 4 5 5 5 5 3 5 1 2 6 5 6 5 2 
-200 1 4 5 5 5 5 3 5 1 2 6 5 6 5 
-200 1 4 5 5 5 5 3 5 1 2 6 5 6 5 5 
-205 5 6 4 5 5 5 5 3 5 3 1 5 
-205 1 4 5 5 3 
-205 5 4 5 5 5 5 3 5 1 1 6 1 2 2 1 
-205 5 4 5 5 5 5 3 6 6 1 1 1 5 
-215 1 6 4 5 5 5 5 3 5 1 3 6 6 
-230 5 6 4 5 5 5 5 3 5 1 1 2 
-245 1 4 5 5 5 5 3 5 1 2 6 5 6 5 6 3 3 5 
-255 1 4 5 5 5 5 3 5 1 2 6 5 6 5 6 4 6 
-500 6 4 5 5 5 5 3 5 1 4 4 4 
-515 6 5 4 5 5 5 5 3 5 5 
-555 1 4 5 5 5 5 3 5 1 2 6 5 6 5 
