900 4 1 6 5 5 5 5 5 6 1 6 5 6 5 6 5 4 2 1 2 2 2 2 2 2 
880 4 1 6 5 5 5 5 5 6 1 6 5 6 5 6 5 4 2 1 2 2 2 2 5 3 1 
880 4 1 6 5 5 5 5 5 6 1 6 5 6 5 6 5 4 2 1 2 2 2 2 5 3 4 3 
875 4 1 6 5 5 5 5 5 6 1 6 5 6 5 6 5 4 2 1 2 2 2 2 5 4 
875 4 1 6 5 5 5 5 5 6 1 6 5 6 5 6 5 4 2 1 2 2 2 2 2 4 
865 4 1 6 5 5 5 5 5 6 1 6 5 6 5 6 5 4 2 1 2 2 2 2 6 
865 4 1 6 5 5 5 5 5 6 1 6 5 6 5 6 5 4 2 1 2 2 2 2 6 
860 4 1 6 5 5 5 5 5 6 1 6 5 6 5 6 5 4 2 1 2 2 2 2 6 6 
860 4 1 6 5 5 5 5 5 6 1 6 5 6 5 6 5 4 2 1 2 2 2 2 6 4 4 
860 4 1 6 5 5 5 5 5 6 1 6 5 6 5 6 5 4 2 1 2 2 2 2 6 4 6 
860 4 1 6 5 5 5 5 5 6 1 6 5 6 5 6 5 4 2 1 2 2 2 2 6 4 5 
860 4 1 6 5 5 5 5 5 6 1 6 5 6 5 6 5 4 2 1 2 2 2 2 6 4 6 
860 4 1 6 5 5 5 5 5 6 1 6 5 6 5 6 5 4 2 1 2 2 2 2 6 4 
860 4 1 6 5 5 5 5 5 6 1 6 5 6 5 6 5 4 2 1 2 2 2 2 6 4 4 
860 4 1 6 5 5 5 5 5 6 1 6 5 6 5 6 5 4 2 1 2 2 2 2 6 4 6 
860 4 1 6 5 5 5 5 5 6 1 6 5 6 5 6 5 4 2 1 2 2 2 2 6 5 
860 4 1 6 5 5 5 5 5 6 1 6 5 6 5 6 5 4 2 1 2 2 2 2 6 4 
860 4 1 6 5 5 5 5 5 6 1 6 5 6 5 6 5 4 2 1 2 2 2 2 6 5 
860 4 1 6 5 5 5 5 5 6 1 6 5 6 5 6 5 4 2 1 2 2 2 2 6 6 
860 4 1 6 5 5 5 5 5 6 1 6 5 6 5 6 5 4 2 1 2 2 2 2 6 3 
860 4 1 6 5 5 5 5 5 6 1 6 5 6 5 6 5 4 2 1 2 2 2 2 6 6 
860 4 1 6 5 5 5 5 5 6 1 6 5 6 5 6 5 4 2 1 2 2 2 2 6 4 5 
860 4 1 6 5 5 5 5 5 6 1 6 5 6 5 6 5 4 2 1 2 2 2 2 6 4 6 
860 4 1 6 5 5 5 5 5 6 1 6 5 6 5 6 5 4 2 1 2 2 2 2 6 4 2 
860 4 1 6 5 5 5 5 5 6 1 6 5 6 5 6 5 4 2 1 2 2 2 2 6 4 4 
860 4 1 6 5 5 5 5 5 6 1 6 5 6 5 6 5 4 2 1 2 2 2 2 6 3 
860 4 1 6 5 5 5 5 5 6 1 6 5 6 5 6 5 4 2 1 2 2 2 2 6 5 
860 4 1 6 5 5 5 5 5 6 1 6 5 6 5 6 5 4 2 1 2 2 2 2 6 4 
860 4 1 6 5 5 5 5 5 6 1 6 5 6 5 6 5 4 2 1 2 2 2 2 6 4 3 
850 4 1 6 5 5 6 4 4 6 2 2 6 6 4 4 6 6 5 2 2 2 1 1 1 6 3 3 
825 4 1 6 5 5 5 5 5 6 1 6 5 6 5 6 5 4 2 1 2 2 2 2 4 
825 4 1 6 5 5 5 5 5 6 1 6 5 6 5 6 5 4 2 1 2 2 2 2 1 
825 4 1 6 5 5 5 5 5 6 1 6 5 6 5 6 5 4 2 1 2 2 2 2 4 
825 4 1 6 5 5 5 5 5 6 1 6 5 6 5 6 5 4 2 1 2 2 2 2 4 
815 4 1 6 5 5 5 5 5 6 1 6 5 6 5 6 5 4 2 1 2 2 2 6 
815 4 1 6 5 5 5 5 5 6 1 6 5 6 5 6 5 4 2 1 2 2 1 1 6 
815 4 1 6 5 5 5 5 5 6 1 6 5 6 5 6 5 4 2 1 2 1 1 2 6 
790 4 1 6 5 5 5 5 5 6 1 6 5 6 5 6 5 4 2 1 2 2 1 6 
775 4 1 6 5 5 5 5 5 6 1 6 5 6 5 6 5 4 2 1 2 2 1 5 
755 4 1 6 5 5 5 5 5 6 1 6 5 6 5 6 5 4 2 1 2 2 2 3 
750 4 1 6 5 5 5 5 5 6 1 6 5 6 5 6 5 4 2 1 2 2 5 
715 4 1 6 5 5 5 5 5 6 1 6 5 6 5 6 5 4 2 1 2 6 
715 4 1 6 5 5 5 5 5 6 1 6 5 6 5 6 5 4 2 1 2 6 
715 4 1 6 5 5 5 5 5 6 1 6 5 6 5 6 5 4 2 1 2 6 
715 4 1 6 5 5 5 5 5 6 1 6 5 6 5 6 5 4 2 1 2 6 
705 4 1 6 5 5 5 5 5 6 1 6 5 6 5 6 5 4 2 1 2 2 3 
675 4 1 6 5 5 5 5 5 6 1 6 5 6 5 6 5 4 2 1 2 4 
675 4 1 6 5 5 5 5 5 6 1 6 5 6 5 6 5 4 2 1 2 4 
675 4 1 6 5 5 5 5 5 6 1 6 5 6 5 6 5 4 2 1 2 4 
675 4 1 6 5 5 5 5 5 6 1 6 5 6 5 6 5 2 2 2 4 
665 4 1 6 5 5 5 5 5 6 1 6 5 6 5 6 5 4 2 1 6 
655 4 1 6 5 5 5 5 5 6 1 6 5 6 5 6 5 4 2 1 2 3 
650 4 1 6 5 5 5 5 5 6 1 6 5 6 5 6 5 4 2 1 5 
650 4 1 6 5 5 5 5 5 6 1 6 5 6 5 6 5 4 2 1 1 4 
650 4 1 6 5 5 5 5 5 6 1 6 5 6 5 6 5 4 2 1 5 
650 4 1 6 5 5 5 5 5 6 1 6 5 6 5 6 5 4 2 1 5 
640 4 1 6 5 5 5 5 5 6 1 6 5 6 5 6 5 4 2 6 
640 4 1 6 5 5 5 5 5 6 1 6 5 6 5 6 5 4 2 6 
625 4 1 6 5 5 5 5 5 6 1 6 5 6 5 6 5 4 2 1 4 
625 4 1 6 5 5 5 5 5 6 1 6 5 6 5 6 5 4 2 1 4 
625 4 1 6 5 5 5 5 5 6 1 6 5 6 5 6 5 4 2 1 4 
600 4 1 6 5 5 5 5 5 6 1 6 5 6 5 6 5 4 2 4 
600 4 1 6 5 5 5 5 5 6 1 6 5 6 5 6 5 4 2 4 
575 4 1 6 5 5 5 5 5 6 1 6 5 6 5 6 5 4 1 4 
