1000049 2 1 5 5 5 5 5 5 2 6 4 1 3 2 5 3 5 4 5 4 5 2 
1000004 2 1 5 5 5 5 5 5 2 6 4 1 3 2 5 3 5 4 6 3 5 1 3 
610 2 1 5 5 5 5 5 5 2 6 4 1 3 2 5 3 5 4 3 5 6 6 
600 2 1 5 5 5 5 5 5 2 6 4 1 3 2 5 3 1 5 5 4 5 5 
595 2 1 5 5 5 5 5 5 2 6 4 1 3 2 5 3 5 4 5 3 6 5 
595 2 1 5 5 5 5 5 5 2 6 4 1 3 2 5 3 5 6 6 6 
570 2 1 5 5 5 5 5 5 2 6 4 1 3 2 5 3 5 4 6 3 6 1 3 6 6 2 2 5 2 1 3 2 2 3 1 6 4 
565 2 1 5 5 5 5 5 5 2 6 4 3 2 1 5 3 5 4 6 4 2 
565 2 1 5 5 5 5 5 5 2 6 4 1 3 2 5 3 5 4 5 1 6 
565 2 1 5 5 5 5 5 5 2 6 4 1 3 2 5 4 4 6 4 3 1 2 
555 2 1 5 5 5 5 5 5 2 6 4 1 3 2 5 3 5 4 6 6 
555 2 1 5 5 5 5 5 5 2 6 4 1 3 2 5 3 5 4 6 6 
550 2 1 5 5 5 5 5 5 2 6 4 1 3 2 5 3 3 6 4 3 4 5 4 
550 2 1 5 5 5 5 5 5 2 6 4 1 3 2 5 3 5 4 5 1 2 
550 2 1 5 5 5 5 5 5 2 6 4 1 3 2 5 3 5 4 5 3 3 6 
540 2 1 5 5 5 5 5 5 2 6 4 1 3 2 5 3 5 4 5 6 
540 2 1 5 5 5 5 5 5 2 6 4 1 3 2 5 3 5 4 6 5 
540 2 1 5 5 5 5 5 5 2 6 4 1 3 2 5 3 5 4 6 5 
540 2 1 5 5 5 5 5 5 2 6 4 1 3 2 5 3 5 4 5 3 3 5 3 
540 2 1 5 5 5 5 5 5 2 6 4 1 3 2 5 3 5 4 6 3 3 6 6 3 
535 2 1 5 5 5 5 5 5 2 6 4 1 3 2 5 3 6 5 6 3 
535 2 1 5 5 5 5 5 5 2 6 4 1 3 2 5 3 5 4 3 4 4 3 5 1 
530 2 1 5 5 5 5 5 5 2 6 4 1 3 2 5 3 5 4 5 3 5 
530 2 1 5 5 5 5 5 5 2 6 4 1 3 2 5 3 5 4 3 5 4 1 
530 2 1 5 5 5 5 5 5 2 6 4 1 3 2 5 3 5 4 3 5 5 
525 2 1 5 5 5 5 5 5 2 6 4 1 3 2 5 3 5 4 5 5 
525 2 1 5 5 5 5 5 5 2 6 4 1 3 2 5 3 5 4 5 5 
525 2 1 5 5 5 5 5 5 2 6 4 1 3 2 3 5 3 3 5 6 3 6 6 1 4 6 3 4 1 
525 2 1 5 5 5 5 5 5 2 6 4 1 3 2 5 3 5 4 5 2 
520 2 1 5 5 5 5 5 5 2 6 4 1 3 2 5 3 5 4 3 6 4 
520 2 1 5 5 5 5 5 5 2 6 4 1 3 2 5 3 6 3 4 5 1 
515 2 1 5 5 5 5 5 5 2 6 4 1 3 2 5 3 5 4 6 4 
515 2 1 5 5 5 5 5 5 2 6 4 1 3 2 5 3 5 4 6 4 
515 2 1 5 5 5 5 5 5 2 6 4 1 3 2 5 3 5 4 6 1 
515 2 1 5 5 5 5 5 5 2 6 4 1 3 2 5 3 5 6 4 4 
515 2 1 5 5 5 5 5 5 2 6 4 1 3 2 5 3 5 4 3 5 3 4 3 
510 2 1 5 5 5 5 5 5 2 6 4 1 3 2 5 3 6 3 6 4 
455 2 1 5 5 5 5 5 5 2 6 4 1 3 2 5 3 5 4 3 1 
450 2 1 5 5 5 5 5 5 2 6 4 1 3 2 5 3 5 5 4 
450 2 1 5 5 5 5 5 5 2 6 4 1 3 2 5 3 5 5 4 
450 2 1 5 5 5 5 5 5 2 6 4 1 3 2 5 3 5 5 4 1 
450 2 1 5 5 5 5 5 5 2 6 4 1 3 2 5 3 5 5 4 
450 2 1 5 5 5 5 5 5 2 6 4 1 3 2 5 3 5 5 4 
450 2 1 5 5 5 5 5 5 2 6 4 1 3 2 5 3 5 5 4 1 5 
450 2 1 5 5 5 5 5 5 2 6 4 1 3 2 5 3 5 5 4 1 
450 2 1 5 5 5 5 5 5 2 6 4 1 3 2 5 3 5 5 4 
450 2 1 5 5 5 5 5 5 2 6 4 1 3 2 5 3 5 5 4 
450 2 1 5 5 5 5 5 5 2 6 4 1 3 2 5 3 5 5 4 1 
450 2 1 5 5 5 5 5 5 2 6 4 1 3 2 5 3 5 5 4 1 
450 2 1 5 5 5 5 5 5 2 6 4 1 3 2 5 3 5 5 4 
450 2 1 5 5 5 5 5 5 2 6 4 1 3 2 5 3 5 5 4 1 5 
450 2 1 5 5 5 5 5 5 2 6 4 1 3 2 5 3 5 5 4 1 5 
450 2 1 5 5 5 5 5 5 2 6 4 1 3 2 5 3 5 5 4 
450 2 1 5 5 5 5 5 5 2 6 4 1 3 2 5 3 5 5 4 
450 2 1 5 5 5 5 5 5 2 6 4 1 3 2 5 3 5 5 4 1 5 
450 2 1 5 5 5 5 5 5 2 6 4 1 3 2 5 3 5 5 4 1 
450 2 1 5 5 5 5 5 5 2 6 4 1 3 2 5 3 5 5 4 
450 2 1 5 5 5 5 5 5 2 6 4 1 3 2 5 3 5 5 4 1 5 
450 2 1 5 5 5 5 5 5 2 6 4 1 3 2 5 3 5 5 4 1 5 
450 2 1 5 5 5 5 5 5 2 6 4 1 3 2 5 3 5 5 4 
450 2 1 5 5 5 5 5 5 2 6 4 1 3 2 5 3 5 5 4 1 
450 2 1 5 5 5 5 5 5 2 6 4 1 3 2 5 3 5 5 4 
450 2 1 5 5 5 5 5 5 2 6 4 1 3 2 5 3 5 5 4 1 
450 2 1 5 5 5 5 5 5 2 6 4 1 3 2 5 3 5 5 4 1 
450 2 1 5 5 5 5 5 5 2 6 4 1 3 2 5 3 5 5 4 1 5 
450 2 1 5 5 5 5 5 5 2 6 4 1 3 2 5 3 5 5 4 1 5 
450 2 1 5 5 5 5 5 5 2 6 4 1 3 2 5 3 5 5 4 1 
450 2 1 5 5 5 5 5 5 2 6 4 1 3 2 5 3 5 5 4 1 
450 2 1 5 5 5 5 5 5 2 6 4 1 3 2 5 3 5 5 4 
450 2 1 5 5 5 5 5 5 2 6 4 1 3 2 5 3 5 5 4 
450 2 1 5 5 5 5 5 5 2 6 4 1 3 2 5 3 5 5 4 1 
450 2 1 5 5 5 5 5 5 2 6 4 1 3 2 5 3 5 5 4 1 
450 2 1 5 5 5 5 5 5 2 6 4 1 3 2 5 3 5 5 4 
450 2 1 5 5 5 5 5 5 2 6 4 1 3 2 5 3 5 5 4 1 5 
450 2 1 5 5 5 5 5 5 2 6 4 1 3 2 5 3 5 5 4 1 
450 2 1 5 5 5 5 5 5 2 6 4 1 3 2 5 3 5 5 4 
450 2 1 5 5 5 5 5 5 2 6 4 1 3 2 5 3 5 5 4 
450 2 1 5 5 5 5 5 5 2 6 4 1 3 2 5 3 5 5 4 1 5 
450 2 1 5 5 5 5 5 5 2 6 4 1 3 2 5 3 5 5 4 1 5 
450 2 1 5 5 5 5 5 5 2 6 4 1 3 2 5 3 5 5 4 1 5 
450 2 1 5 5 5 5 5 5 2 6 4 1 3 2 5 3 5 5 4 1 
450 2 1 5 5 5 5 5 5 2 6 4 1 3 2 5 3 5 5 4 1 5 
450 2 1 5 5 5 5 5 5 2 6 4 1 3 2 5 3 5 5 4 1 
450 2 1 5 5 5 5 5 5 2 6 4 1 3 2 5 3 1 5 4 
450 2 1 5 5 5 5 5 5 2 6 4 1 3 2 5 3 4 4 5 
450 2 1 5 5 5 5 5 5 2 6 4 1 3 2 5 3 5 4 1 
450 2 1 5 5 5 5 5 5 2 6 4 1 3 2 5 3 5 5 4 4 6 
450 2 1 5 5 5 5 5 5 2 6 4 1 3 2 5 3 5 5 
450 2 1 5 5 5 5 5 5 2 6 4 1 3 2 5 3 5 4 4 5 
450 2 1 5 5 5 5 5 5 2 6 4 1 3 2 5 3 5 4 4 4 
450 2 1 5 5 5 5 5 5 2 6 4 1 3 2 5 3 5 5 
450 2 1 5 5 5 5 5 5 2 6 4 1 3 2 5 3 5 4 1 
450 2 1 5 5 5 5 5 5 2 6 4 1 3 2 5 3 5 4 4 
450 2 1 5 5 5 5 5 5 2 6 4 1 3 2 5 3 5 2 
450 2 1 5 5 5 5 5 5 2 6 4 1 3 2 5 3 5 4 1 
450 2 1 5 5 5 5 5 5 2 6 4 1 3 2 5 3 5 4 1 
450 2 1 5 5 5 5 5 5 2 6 4 1 3 2 5 3 5 4 1 
450 2 1 5 5 5 5 5 5 2 6 4 1 3 2 5 3 1 5 4 
450 2 1 5 5 5 5 5 5 2 6 4 1 3 2 5 3 5 5 
450 2 1 5 5 5 5 5 5 2 6 4 1 3 2 5 3 5 4 4 
450 2 1 5 5 5 5 5 5 2 6 4 1 3 2 5 3 5 5 4 3 5 
450 2 1 5 5 5 5 5 5 2 6 4 1 3 2 5 3 5 5 4 
450 2 1 5 5 5 5 5 5 2 6 4 1 3 2 5 3 5 5 4 1 5 
450 2 1 5 5 5 5 5 5 2 6 4 1 3 2 5 3 5 5 4 1 5 
450 2 1 5 5 5 5 5 5 2 6 4 1 3 2 5 3 5 5 4 
450 2 1 5 5 5 5 5 5 2 6 4 1 3 2 5 3 5 5 4 
450 2 1 5 5 5 5 5 5 2 6 4 1 3 2 5 3 5 5 4 1 
450 2 1 5 5 5 5 5 5 2 6 4 1 3 2 5 3 5 5 4 1 5 
450 2 1 5 5 5 5 5 5 2 6 4 1 3 2 5 3 5 5 4 1 5 
450 2 1 5 5 5 5 5 5 2 6 4 1 3 2 5 3 5 5 4 
450 2 1 5 5 5 5 5 5 2 6 4 1 3 2 5 3 5 5 4 1 
450 2 1 5 5 5 5 5 5 2 6 4 1 3 2 5 3 5 5 4 
450 2 1 5 5 5 5 5 5 2 6 4 1 3 2 5 3 5 5 4 1 
450 2 1 5 5 5 5 5 5 2 6 4 1 3 2 5 3 5 5 4 1 
450 2 1 5 5 5 5 5 5 2 6 4 1 3 2 5 3 5 5 4 1 
450 2 1 5 5 5 5 5 5 2 6 4 1 3 2 5 3 5 5 4 
450 2 1 5 5 5 5 5 5 2 6 4 1 3 2 5 3 5 5 4 
450 2 1 5 5 5 5 5 5 2 6 4 1 3 2 5 3 5 5 4 
450 2 1 5 5 5 5 5 5 2 6 4 1 3 2 5 3 5 5 4 1 5 
450 2 1 5 5 5 5 5 5 2 6 4 1 3 2 5 3 5 5 4 1 5 
450 2 1 5 5 5 5 5 5 2 6 4 1 3 2 5 3 5 5 4 1 5 
425 2 1 5 5 5 5 5 5 2 6 4 1 3 2 5 3 5 1 
405 2 1 5 5 5 5 5 5 2 6 4 1 3 2 5 3 5 3 
405 2 1 5 5 5 5 5 5 2 6 4 1 3 2 5 3 5 3 
405 2 1 5 5 5 5 5 5 2 6 4 1 3 2 5 3 5 3 
405 2 1 5 5 5 5 5 5 2 6 4 1 3 2 5 3 5 3 
395 2 1 5 5 5 5 5 5 2 6 4 1 3 2 5 4 1 
390 2 1 5 5 5 5 5 5 2 6 4 1 3 2 6 3 1 
