1525 6 5 5 5 6 4 3 4 6 2 2 3 6 5 5 5 5 4 3 4 6 2 2 2 2 1 3 5 6 2 6 4 6 5 6 5 4 6 6 6 
1370 6 5 5 5 6 4 3 4 6 2 2 3 6 5 5 5 5 4 3 4 6 2 2 2 2 1 3 5 6 2 6 4 6 5 6 5 2 1 2 4 5 
1320 6 5 5 5 6 4 3 4 6 2 2 3 6 5 5 5 5 4 3 4 6 2 2 2 2 1 3 5 6 2 6 4 6 5 6 6 
1320 6 5 5 5 6 4 3 4 6 2 2 3 6 5 5 5 5 4 3 4 6 2 2 2 2 1 3 5 6 2 6 4 6 5 6 6 
1295 6 5 5 5 6 4 3 4 6 2 2 3 6 5 5 5 5 4 3 4 6 2 2 2 2 1 3 5 6 2 6 4 6 5 4 3 5 4 
1280 6 5 5 5 6 4 3 4 6 2 2 3 6 5 5 5 5 4 3 4 6 2 2 2 2 1 3 5 6 2 6 4 6 5 6 1 
1240 6 5 5 5 6 4 3 4 6 2 2 3 6 5 5 5 5 4 3 4 6 2 2 2 2 1 3 5 6 2 6 4 6 5 2 
1240 6 5 5 5 6 4 3 4 6 2 2 3 6 5 5 5 5 4 3 4 6 2 2 2 2 1 3 5 6 2 6 4 6 5 4 1 
1100 6 5 5 5 6 4 3 4 6 2 2 3 6 5 5 5 5 4 3 4 6 2 2 2 2 1 6 6 6 4 6 
1090 6 5 5 5 6 4 3 4 6 2 2 3 6 5 5 5 5 4 3 4 6 2 2 2 2 1 3 4 6 6 6 5 
990 6 5 5 5 6 4 3 4 6 2 2 3 6 5 5 5 5 4 3 4 6 2 2 2 2 1 6 6 5 5 2 6 
865 6 5 5 5 6 4 3 4 6 2 2 3 6 5 5 5 5 4 3 4 6 2 2 2 2 1 3 5 6 2 6 4 6 5 6 5 1 
865 6 5 5 5 6 4 3 4 6 2 2 3 6 5 5 5 5 4 3 4 6 2 2 2 2 1 3 5 6 2 6 4 6 5 6 4 
865 6 5 5 5 6 4 3 4 6 2 2 3 6 5 5 5 5 4 3 4 6 2 2 2 2 1 3 5 6 2 6 4 6 5 6 6 
865 6 5 5 5 6 4 3 4 6 2 2 3 6 5 5 5 5 4 3 4 6 2 2 2 2 1 3 5 6 2 6 4 6 5 5 
865 6 5 5 5 6 4 3 4 6 2 2 3 6 5 5 5 5 4 3 4 6 2 2 2 2 1 3 5 6 2 6 4 6 5 6 5 1 
865 6 5 5 5 6 4 3 4 6 2 2 3 6 5 5 5 5 4 3 4 6 2 2 2 2 1 3 5 6 2 6 4 6 5 6 5 5 
865 6 5 5 5 6 4 3 4 6 2 2 3 6 5 5 5 5 4 3 4 6 2 2 2 2 1 3 5 6 2 6 4 6 5 3 
865 6 5 5 5 6 4 3 4 6 2 2 3 6 5 5 5 5 4 3 4 6 2 2 2 2 1 3 5 6 2 6 4 6 5 4 
865 6 5 5 5 6 4 3 4 6 2 2 3 6 5 5 5 5 4 3 4 6 2 2 2 2 1 3 5 6 2 6 4 6 5 6 5 4 
865 6 5 5 5 6 4 3 4 6 2 2 3 6 5 5 5 5 4 3 4 6 2 2 2 2 1 3 5 6 2 6 4 6 5 6 3 
865 6 5 5 5 6 4 3 4 6 2 2 3 6 5 5 5 5 4 3 4 6 2 2 2 2 1 3 5 6 2 6 4 6 5 6 5 5 
865 6 5 5 5 6 4 3 4 6 2 2 3 6 5 5 5 5 4 3 4 6 2 2 2 2 1 3 5 6 2 6 4 6 5 6 5 4 
865 6 5 5 5 6 4 3 4 6 2 2 3 6 5 5 5 5 4 3 4 6 2 2 2 2 1 3 5 6 2 6 4 6 5 6 5 6 
865 6 5 5 5 6 4 3 4 6 2 2 3 6 5 5 5 5 4 3 4 6 2 2 2 2 1 3 5 6 2 6 4 6 5 6 3 
865 6 5 5 5 6 4 3 4 6 2 2 3 6 5 5 5 5 4 3 4 6 2 2 2 2 1 3 5 6 2 6 4 6 5 6 5 2 
865 6 5 5 5 6 4 3 4 6 2 2 3 6 5 5 5 5 4 3 4 6 2 2 2 2 1 3 5 6 2 6 4 6 5 6 1 
865 6 5 5 5 6 4 3 4 6 2 2 3 6 5 5 5 5 4 3 4 6 2 2 2 2 1 3 5 6 2 6 4 6 5 6 5 2 
865 6 5 5 5 6 4 3 4 6 2 2 3 6 5 5 5 5 4 3 4 6 2 2 2 2 1 3 5 6 2 6 4 6 5 6 5 4 
865 6 5 5 5 6 4 3 4 6 2 2 3 6 5 5 5 5 4 3 4 6 2 2 2 2 1 3 5 6 2 6 4 6 5 5 
865 6 5 5 5 6 4 3 4 6 2 2 3 6 5 5 5 5 4 3 4 6 2 2 2 2 1 3 5 6 2 6 4 6 5 1 
865 6 5 5 5 6 4 3 4 6 2 2 3 6 5 5 5 5 4 3 4 6 2 2 2 2 1 3 5 6 2 6 4 6 5 4 
865 6 5 5 5 6 4 3 4 6 2 2 3 6 5 5 5 5 4 3 4 6 2 2 2 2 1 3 5 6 2 6 4 6 5 5 
865 6 5 5 5 6 4 3 4 6 2 2 3 6 5 5 5 5 4 3 4 6 2 2 2 2 1 3 5 6 2 6 4 6 5 6 3 
865 6 5 5 5 6 4 3 4 6 2 2 3 6 5 5 5 5 4 3 4 6 2 2 2 2 1 3 5 6 2 6 4 6 5 3 
865 6 5 5 5 6 4 3 4 6 2 2 3 6 5 5 5 5 4 3 4 6 2 2 2 2 1 3 5 6 2 6 4 6 5 6 2 
865 6 5 5 5 6 4 3 4 6 2 2 3 6 5 5 5 5 4 3 4 6 2 2 2 2 1 3 5 6 2 6 4 6 5 6 4 
865 6 5 5 5 6 4 3 4 6 2 2 3 6 5 5 5 5 4 3 4 6 2 2 2 2 1 3 5 6 2 6 4 6 5 1 
865 6 5 5 5 6 4 3 4 6 2 2 3 6 5 5 5 5 4 3 4 6 2 2 2 2 1 3 5 6 2 6 4 6 5 6 5 1 
865 6 5 5 5 6 4 3 4 6 2 2 3 6 5 5 5 5 4 3 4 6 2 2 2 2 1 3 5 6 2 6 4 6 5 6 5 
865 6 5 5 5 6 4 3 4 6 2 2 3 6 5 5 5 5 4 3 4 6 2 2 2 2 1 3 5 6 2 6 4 6 5 6 4 
865 6 5 5 5 6 4 3 4 6 2 2 3 6 5 5 5 5 4 3 4 6 2 2 2 2 1 3 5 6 2 6 4 6 5 5 
865 6 5 5 5 6 4 3 4 6 2 2 3 6 5 5 5 5 4 3 4 6 2 2 2 2 1 3 5 6 2 6 4 6 5 6 5 4 
865 6 5 5 5 6 4 3 4 6 2 2 3 6 5 5 5 5 4 3 4 6 2 2 2 2 1 3 5 6 2 6 4 6 5 6 
865 6 5 5 5 6 4 3 4 6 2 2 3 6 5 5 5 5 4 3 4 6 2 2 2 2 1 3 5 6 2 6 4 6 5 6 
865 6 5 5 5 6 4 3 4 6 2 2 3 6 5 5 5 5 4 3 4 6 2 2 2 2 1 3 5 6 2 6 4 6 5 6 3 
865 6 5 5 5 6 4 3 4 6 2 2 3 6 5 5 5 5 4 3 4 6 2 2 2 2 1 3 5 6 2 6 4 6 5 6 2 
865 6 5 5 5 6 4 3 4 6 2 2 3 6 5 5 5 5 4 3 4 6 2 2 2 2 1 3 5 6 2 6 4 6 5 6 2 
865 6 5 5 5 6 4 3 4 6 2 2 3 6 5 5 5 5 4 3 4 6 2 2 2 2 1 3 5 6 2 6 4 6 5 6 2 
865 6 5 5 5 6 4 3 4 6 2 2 3 6 5 5 5 5 4 3 4 6 2 2 2 2 1 3 5 6 2 6 4 6 5 5 
865 6 5 5 5 6 4 3 4 6 2 2 3 6 5 5 5 5 4 3 4 6 2 2 2 2 1 3 5 6 2 6 4 6 5 6 2 
865 6 5 5 5 6 4 3 4 6 2 2 3 6 5 5 5 5 4 3 4 6 2 2 2 2 1 3 5 6 2 6 4 6 5 6 4 
865 6 5 5 5 6 4 3 4 6 2 2 3 6 5 5 5 5 4 3 4 6 2 2 2 2 1 3 5 6 2 6 4 6 5 6 3 
865 6 5 5 5 6 4 3 4 6 2 2 3 6 5 5 5 5 4 3 4 6 2 2 2 2 1 3 5 6 2 6 4 6 5 6 4 
865 6 5 5 5 6 4 3 4 6 2 2 3 6 5 5 5 5 4 3 4 6 2 2 2 2 1 3 5 6 2 6 4 6 5 6 5 3 
865 6 5 5 5 6 4 3 4 6 2 2 3 6 5 5 5 5 4 3 4 6 2 2 2 2 1 3 5 6 2 6 4 6 5 2 
865 6 5 5 5 6 4 3 4 6 2 2 3 6 5 5 5 5 4 3 4 6 2 2 2 2 1 3 5 6 2 6 4 6 5 6 5 6 
865 6 5 5 5 6 4 3 4 6 2 2 3 6 5 5 5 5 4 3 4 6 2 2 2 2 1 3 5 6 2 6 4 6 5 6 4 
865 6 5 5 5 6 4 3 4 6 2 2 3 6 5 5 5 5 4 3 4 6 2 2 2 2 1 3 5 6 2 6 4 6 5 6 3 
865 6 5 5 5 6 4 3 4 6 2 2 3 6 5 5 5 5 4 3 4 6 2 2 2 2 1 3 5 6 2 6 4 6 5 4 
865 6 5 5 5 6 4 3 4 6 2 2 3 6 5 5 5 5 4 3 4 6 2 2 2 2 1 3 5 6 2 6 4 6 5 6 2 
865 6 5 5 5 6 4 3 4 6 2 2 3 6 5 5 5 5 4 3 4 6 2 2 2 2 1 3 5 6 2 6 4 6 5 6 5 3 
865 6 5 5 5 6 4 3 4 6 2 2 3 6 5 5 5 5 4 3 4 6 2 2 2 2 1 3 5 6 2 6 4 6 5 5 
865 6 5 5 5 6 4 3 4 6 2 2 3 6 5 5 5 5 4 3 4 6 2 2 2 2 1 3 5 6 2 6 4 6 5 2 
865 6 5 5 5 6 4 3 4 6 2 2 3 6 5 5 5 5 4 3 4 6 2 2 2 2 1 3 5 6 2 6 4 6 5 6 3 
865 6 5 5 5 6 4 3 4 6 2 2 3 6 5 5 5 5 4 3 4 6 2 2 2 2 1 3 5 6 2 6 4 4 
865 6 5 5 5 6 4 3 4 6 2 2 3 6 5 5 5 5 4 3 4 6 2 2 2 2 1 3 5 6 2 6 4 1 
865 6 5 5 5 6 4 3 4 6 2 2 3 6 5 5 5 5 4 3 4 6 2 2 2 2 1 3 5 6 6 1 5 
865 6 5 5 5 6 4 3 4 6 2 2 3 6 5 5 5 5 4 3 4 6 2 2 2 2 1 3 5 6 2 6 4 1 
865 6 5 5 5 6 4 3 4 6 2 2 3 6 5 5 5 5 4 3 4 6 2 2 2 2 1 3 5 6 2 6 1 1 
865 6 5 5 5 6 4 3 4 6 2 2 3 6 5 5 5 5 4 3 4 6 2 2 2 2 1 3 5 6 2 6 2 
865 6 5 5 5 6 4 3 4 6 2 2 3 6 5 5 5 5 4 3 4 6 2 2 2 2 1 3 5 6 2 6 4 1 
865 6 5 5 5 6 4 3 4 6 2 2 3 6 5 5 5 5 4 3 4 6 2 2 2 2 1 3 5 6 2 6 4 
865 6 5 5 5 6 4 3 4 6 2 2 3 6 5 5 5 5 4 3 4 6 2 2 2 2 1 3 5 6 2 6 4 6 
865 6 5 5 5 6 4 3 4 6 2 2 3 6 5 5 5 5 4 3 4 6 2 2 2 2 1 3 5 6 2 6 1 
865 6 5 5 5 6 4 3 4 6 2 2 3 6 5 5 5 5 4 3 4 6 2 2 2 2 1 3 5 6 2 6 4 4 
865 6 5 5 5 6 4 3 4 6 2 2 3 6 5 5 5 5 4 3 4 6 2 2 2 2 1 3 5 6 2 6 4 3 
865 6 5 5 5 6 4 3 4 6 2 2 3 6 5 5 5 5 4 3 4 6 2 2 2 2 1 3 5 6 2 6 4 1 
865 6 5 5 5 6 4 3 4 6 2 2 3 6 5 5 5 5 4 3 4 6 2 2 2 2 1 3 5 6 2 1 4 4 4 2 
865 6 5 5 5 6 4 3 4 6 2 2 3 6 5 5 5 5 4 3 4 6 2 2 2 2 1 3 5 6 6 3 4 5 3 4 6 3 3 3 3 
865 6 5 5 5 6 4 3 4 6 2 2 3 6 5 5 5 5 4 3 4 6 2 2 2 2 1 3 5 6 2 6 4 6 6 
865 6 5 5 5 6 4 3 4 6 2 2 3 6 5 5 5 5 4 3 4 6 2 2 2 2 1 3 5 6 2 6 4 6 2 
865 6 5 5 5 6 4 3 4 6 2 2 3 6 5 5 5 5 4 3 4 6 2 2 2 2 1 3 5 6 2 6 4 6 5 
865 6 5 5 5 6 4 3 4 6 2 2 3 6 5 5 5 5 4 3 4 6 2 2 2 2 1 3 5 6 6 4 3 4 5 
865 6 5 5 5 6 4 3 4 6 2 2 3 6 5 5 5 5 4 3 4 6 2 2 2 2 1 3 5 6 2 6 4 1 
865 6 5 5 5 6 4 3 4 6 2 2 3 6 5 5 5 5 4 3 4 6 2 2 2 2 1 3 5 6 2 6 4 6 4 3 6 
865 6 5 5 5 6 4 3 4 6 2 2 3 6 5 5 5 5 4 3 4 6 2 2 2 2 1 3 5 6 2 6 4 4 5 3 
865 6 5 5 5 6 4 3 4 6 2 2 3 6 5 5 5 5 4 3 4 6 2 2 2 2 1 3 5 6 2 6 4 4 6 4 4 
865 6 5 5 5 6 4 3 4 6 2 2 3 6 5 5 5 5 4 3 4 6 2 2 2 2 1 3 5 6 2 6 1 6 4 
865 6 5 5 5 6 4 3 4 6 2 2 3 6 5 5 5 5 4 3 4 6 2 2 2 2 1 3 5 6 2 6 4 6 3 6 
865 6 5 5 5 6 4 3 4 6 2 2 3 6 5 5 5 5 4 3 4 6 2 2 2 2 1 3 5 6 2 6 4 4 5 1 1 
865 6 5 5 5 6 4 3 4 6 2 2 3 6 5 5 5 5 4 3 4 6 2 2 2 2 1 3 5 6 2 6 4 4 3 2 2 6 
865 6 5 5 5 6 4 3 4 6 2 2 3 6 5 5 5 5 4 3 4 6 2 2 2 2 1 3 5 6 2 6 4 4 6 3 2 
865 6 5 5 5 6 4 3 4 6 2 2 3 6 5 5 5 5 4 3 4 6 2 2 2 2 1 3 5 6 2 6 4 4 6 3 
865 6 5 5 5 6 4 3 4 6 2 2 3 6 5 5 5 5 4 3 4 6 2 2 2 2 1 3 5 6 2 6 1 4 6 1 
865 6 5 5 5 6 4 3 4 6 2 2 3 6 5 5 5 5 4 3 4 6 2 2 2 2 1 3 5 6 2 6 4 6 5 6 6 
865 6 5 5 5 6 4 3 4 6 2 2 3 6 5 5 5 5 4 3 4 6 2 2 2 2 1 3 5 6 2 6 4 6 5 6 3 
865 6 5 5 5 6 4 3 4 6 2 2 3 6 5 5 5 5 4 3 4 6 2 2 2 2 1 3 5 6 2 6 4 6 5 6 
865 6 5 5 5 6 4 3 4 6 2 2 3 6 5 5 5 5 4 3 4 6 2 2 2 2 1 3 5 6 5 4 
865 6 5 5 5 6 4 3 4 6 2 2 3 6 5 5 5 5 4 3 4 6 2 2 2 2 1 3 5 6 1 4 1 3 3 
865 6 5 5 5 6 4 3 4 6 2 2 3 6 5 5 5 5 4 3 4 6 2 2 2 2 1 3 5 6 4 
865 6 5 5 5 6 4 3 4 6 2 2 3 6 5 5 5 5 4 3 4 6 2 2 2 2 1 3 5 6 6 
865 6 5 5 5 6 4 3 4 6 2 2 3 6 5 5 5 5 4 3 4 6 2 2 2 2 1 3 5 6 2 6 4 1 
865 6 5 5 5 6 4 3 4 6 2 2 3 6 5 5 5 5 4 3 4 6 2 2 2 2 1 3 5 6 2 6 4 1 
865 6 5 5 5 6 4 3 4 6 2 2 3 6 5 5 5 5 4 3 4 6 2 2 2 2 1 3 5 6 6 1 4 1 
865 6 5 5 5 6 4 3 4 6 2 2 3 6 5 5 5 5 4 3 4 6 2 2 2 2 1 3 5 6 2 6 
865 6 5 5 5 6 4 3 4 6 2 2 3 6 5 5 5 5 4 3 4 6 2 2 2 2 1 3 5 6 2 4 1 
865 6 5 5 5 6 4 3 4 6 2 2 3 6 5 5 5 5 4 3 4 6 2 2 2 2 1 3 5 6 5 4 3 6 
865 6 5 5 5 6 4 3 4 6 2 2 3 6 5 5 5 5 4 3 4 6 2 2 2 2 1 3 5 6 2 6 4 4 
865 6 5 5 5 6 4 3 4 6 2 2 3 6 5 5 5 5 4 3 4 6 2 2 2 2 1 3 5 6 2 6 
865 6 5 5 5 6 4 3 4 6 2 2 3 6 5 5 5 5 4 3 4 6 2 2 2 2 1 3 5 6 5 
865 6 5 5 5 6 4 3 4 6 2 2 3 6 5 5 5 5 4 3 4 6 2 2 2 2 1 3 5 6 2 
865 6 5 5 5 6 4 3 4 6 2 2 3 6 5 5 5 5 4 3 4 6 2 2 2 2 1 3 5 6 2 6 4 4 
865 6 5 5 5 6 4 3 4 6 2 2 3 6 5 5 5 5 4 3 4 6 2 2 2 2 1 3 5 6 2 6 4 1 
865 6 5 5 5 6 4 3 4 6 2 2 3 6 5 5 5 5 4 3 4 6 2 2 2 2 1 3 5 6 2 2 
865 6 5 5 5 6 4 3 4 6 2 2 3 6 5 5 5 5 4 3 4 6 2 2 2 2 1 3 5 6 2 6 1 
865 6 5 5 5 6 4 3 4 6 2 2 3 6 5 5 5 5 4 3 4 6 2 2 2 2 1 3 5 6 2 1 
865 6 5 5 5 6 4 3 4 6 2 2 3 6 5 5 5 5 4 3 4 6 2 2 2 2 1 3 5 6 2 6 4 6 4 
865 6 5 5 5 6 4 3 4 6 2 2 3 6 5 5 5 5 4 3 4 6 2 2 2 2 1 3 5 6 5 4 1 3 
865 6 5 5 5 6 4 3 4 6 2 2 3 6 5 5 5 5 4 3 4 6 2 2 2 2 1 3 5 6 2 6 4 1 
865 6 5 5 5 6 4 3 4 6 2 2 3 6 5 5 5 5 4 3 4 6 2 2 2 2 1 3 5 6 2 6 2 
865 6 5 5 5 6 4 3 4 6 2 2 3 6 5 5 5 5 4 3 4 6 2 2 2 2 1 3 5 6 2 1 
865 6 5 5 5 6 4 3 4 6 2 2 3 6 5 5 5 5 4 3 4 6 2 2 2 2 1 3 5 6 5 1 
865 6 5 5 5 6 4 3 4 6 2 2 3 6 5 5 5 5 4 3 4 6 2 2 2 2 1 3 5 6 5 
865 6 5 5 5 6 4 3 4 6 2 2 3 6 5 5 5 5 4 3 4 6 2 2 2 2 1 3 5 6 2 6 1 
865 6 5 5 5 6 4 3 4 6 2 2 3 6 5 5 5 5 4 3 4 6 2 2 2 2 1 3 5 6 2 6 4 1 
865 6 5 5 5 6 4 3 4 6 2 2 3 6 5 5 5 5 4 3 4 6 2 2 2 2 1 3 5 6 2 6 4 4 5 
865 6 5 5 5 6 4 3 4 6 2 2 3 6 5 5 5 5 4 3 4 6 2 2 2 2 1 3 5 6 2 6 
