100 5 4 5 5 5 5 5 4 4 4 
95 5 4 5 5 5 5 3 1 6 4 
90 5 4 5 5 5 5 6 5 
85 5 4 5 5 5 5 3 3 2 2 
80 5 4 5 5 5 5 4 4 2 3 
70 5 4 5 5 5 5 3 6 4 
65 5 4 5 5 5 5 6 4 
65 5 4 5 5 5 5 6 4 
25 5 4 5 5 5 5 2 
20 5 4 5 5 5 5 2 4 
15 5 4 5 5 5 3 4 4 3 3 1 2 
0 5 4 5 5 5 5 1 
-25 5 4 5 5 5 2 
-50 5 4 5 5 5 4 
-50 5 4 5 5 5 4 
-50 5 4 5 5 5 1 
-50 5 4 5 5 5 1 
-55 5 4 5 5 5 4 3 
-60 5 4 5 5 6 
-60 5 4 5 5 6 
-65 5 4 5 5 5 3 3 
-80 5 4 5 5 2 1 
-100 5 6 4 5 5 2 1 1 6 3 
-100 5 4 5 5 1 
-100 5 6 4 5 5 5 6 3 
-105 5 4 5 5 4 3 
-105 5 4 5 5 4 2 
-165 6 6 4 5 5 5 5 3 3 2 
-165 5 6 4 5 3 
-175 5 4 5 5 3 4 
-180 5 1 4 5 5 5 5 3 5 1 4 3 
-180 1 1 4 5 5 5 5 3 5 1 2 4 
-180 4 1 4 5 5 5 5 3 5 1 2 6 5 6 
-185 5 6 4 5 5 5 5 3 4 1 
-205 1 4 5 5 5 5 3 5 1 2 6 3 
-205 1 4 5 5 5 5 3 5 1 2 6 5 4 
-205 5 5 4 5 
-210 1 4 5 5 5 5 3 5 1 2 6 5 6 5 6 6 
-210 1 4 5 5 5 5 3 5 1 2 6 5 2 5 
-210 1 4 5 5 5 5 3 5 1 6 3 
-210 5 6 4 5 5 5 5 6 
-210 1 4 5 5 5 5 3 5 1 1 6 
-210 5 4 5 5 5 2 5 6 
-235 5 6 4 5 5 2 1 5 3 
-540 5 6 4 5 5 6 
-580 2 4 5 5 5 5 3 5 1 3 1 1 6 6 
-585 1 2 4 5 5 5 5 4 1 
-610 5 6 4 5 5 5 
