-65 6 4 5 5 5 5 3 5 1 4 6 
-115 4 5 5 5 5 3 5 1 4 2 1 3 
-120 4 5 5 5 5 3 5 1 4 2 5 5 2 
-140 2 4 5 5 5 5 3 6 6 
-145 4 5 5 5 5 3 6 6 4 
-150 2 4 5 5 5 5 3 5 1 1 
-150 2 4 5 5 5 5 3 5 1 4 6 
-155 4 5 5 5 5 3 5 1 1 3 1 
-160 4 5 5 5 5 3 2 1 
-160 4 5 5 5 5 3 5 1 3 1 4 3 6 6 
-160 4 5 5 5 5 3 5 1 2 6 3 
-170 5 4 5 5 5 5 3 5 1 4 
-170 4 5 5 5 5 3 5 1 4 2 2 2 
-170 4 5 5 5 5 3 5 
-180 6 4 5 5 5 5 3 5 2 
-180 4 5 5 5 5 3 4 
-180 6 4 5 5 5 5 3 5 1 5 3 
-185 4 5 5 5 5 3 5 1 1 6 2 
-195 4 5 5 5 5 3 5 1 2 2 1 
-195 5 4 5 5 5 5 6 
-195 5 4 5 5 5 5 
-200 4 5 5 5 5 3 2 
-200 4 5 5 5 5 3 5 1 3 
-200 4 5 5 5 5 3 5 1 4 2 2 1 6 
-210 4 5 5 5 5 6 6 4 
-215 4 5 5 5 5 3 5 3 
-220 4 5 5 5 5 
-220 4 5 5 5 5 2 4 
-220 4 5 5 5 5 3 6 2 
-220 4 5 5 5 5 3 5 1 
-220 4 5 5 5 5 3 5 1 4 2 2 4 4 3 
-220 4 5 5 5 5 
-220 4 5 5 5 5 3 5 1 4 2 2 
-220 4 5 5 5 5 3 5 2 2 
-220 4 5 5 5 
-220 4 5 5 5 5 3 5 1 
-220 4 5 5 5 5 3 5 2 4 
-220 4 5 5 5 5 3 5 1 4 2 2 4 
-220 4 5 5 5 5 3 3 
-220 4 5 5 5 5 3 5 1 4 2 2 4 4 5 
-220 4 5 5 5 5 3 5 1 4 2 2 4 4 
-225 4 5 5 5 5 3 5 1 4 2 1 5 2 
-245 4 5 5 5 5 3 1 1 
-250 4 5 5 5 5 3 5 4 1 
-250 4 5 5 5 5 3 1 
-250 4 5 5 5 5 3 5 1 4 2 2 4 5 
-250 4 5 5 5 5 3 1 
-270 4 5 5 5 5 3 5 1 2 
