820 5 6 5 5 5 5 4 3 2 1 6 1 4 2 5 5 6 3 6 2 2 1 2 1 2 5 
810 5 6 5 5 5 5 4 3 2 1 6 1 4 2 5 5 6 3 6 2 2 1 2 2 6 
810 5 6 5 5 5 5 4 3 2 1 6 1 4 2 5 5 6 3 6 2 2 1 1 1 2 6 
810 5 6 5 5 5 5 4 3 2 1 6 1 4 2 5 5 6 3 6 2 2 2 2 1 6 
795 5 6 5 5 5 5 4 3 2 1 6 1 4 2 5 5 6 3 6 2 2 2 1 2 5 
795 5 6 5 5 5 5 4 3 2 1 6 1 4 2 5 5 6 3 6 2 2 1 2 2 2 
795 5 6 5 5 5 5 4 3 2 1 6 1 4 2 5 5 6 3 6 2 2 1 1 2 2 1 
795 5 6 5 5 5 5 4 3 2 1 6 1 4 2 5 5 6 3 6 2 2 2 1 1 1 2 
785 5 6 5 5 5 5 4 3 2 1 6 1 4 2 5 5 6 3 6 2 2 1 2 1 6 
770 5 6 5 5 5 5 4 3 2 1 6 1 4 2 5 5 6 3 6 2 2 1 1 2 5 
770 5 6 5 5 5 5 4 3 2 1 6 1 4 2 5 5 6 3 6 2 2 1 2 2 4 
770 5 6 5 5 5 5 4 3 2 1 6 1 4 2 5 5 6 3 6 2 2 1 2 1 5 
770 5 6 5 5 5 5 4 3 2 1 6 1 4 2 5 5 6 3 6 2 2 1 2 1 5 
770 5 6 5 5 5 5 4 3 2 1 6 1 4 2 5 5 6 3 6 2 2 1 2 1 1 1 1 
770 5 6 5 5 5 5 4 3 2 1 6 1 4 2 5 5 6 3 6 2 2 1 2 2 4 
770 5 6 5 5 5 5 4 3 2 1 6 1 4 2 5 5 6 3 6 2 2 1 2 2 4 
770 5 6 5 5 5 5 4 3 2 1 6 1 4 2 5 5 6 3 6 2 2 1 1 1 2 1 5 
760 5 6 5 5 5 5 4 3 2 1 6 1 4 2 5 5 6 3 6 2 2 1 2 6 
760 5 6 5 5 5 5 4 3 2 1 6 1 4 2 5 5 6 3 6 2 2 1 2 6 
760 5 6 5 5 5 5 4 3 2 1 6 1 4 2 5 5 6 3 6 2 2 1 2 6 
745 5 6 5 5 5 5 4 3 2 1 6 1 4 2 5 5 6 3 6 2 2 1 2 5 
745 5 6 5 5 5 5 4 3 2 1 6 1 4 2 5 5 6 3 6 2 2 1 2 5 
745 5 6 5 5 5 5 4 3 2 1 6 1 4 2 5 5 6 3 6 2 2 1 2 5 
745 5 6 5 5 5 5 4 3 2 1 6 1 4 2 5 5 6 3 6 2 2 1 2 5 
745 5 6 5 5 5 5 4 3 2 1 6 1 4 2 5 5 6 3 6 2 2 1 2 1 4 
745 5 6 5 5 5 5 4 3 2 1 6 1 4 2 5 5 6 3 6 2 2 1 2 5 
745 5 6 5 5 5 5 4 3 2 1 6 1 4 2 5 5 6 3 6 2 2 1 2 5 
735 5 6 5 5 5 5 4 3 2 1 6 1 4 2 5 5 6 3 6 2 2 2 6 
735 5 6 5 5 5 5 4 3 2 1 6 1 4 2 5 5 6 3 6 2 2 1 1 6 
735 5 6 5 5 5 5 4 3 2 1 6 1 4 2 5 5 6 3 6 2 2 1 1 6 
735 5 6 5 5 5 5 4 3 2 1 6 1 4 2 5 5 6 3 6 2 2 2 6 
720 5 6 5 5 5 5 4 3 2 1 6 1 4 2 5 5 6 3 6 2 1 2 1 1 4 
720 5 6 5 5 5 5 4 3 2 1 6 1 4 2 5 5 6 3 6 2 2 1 2 4 
720 5 6 5 5 5 5 4 3 2 1 6 1 4 2 5 5 6 3 6 2 2 2 5 
720 5 6 5 5 5 5 4 3 2 1 6 1 4 2 5 5 6 3 6 2 2 1 2 4 
710 5 6 5 5 5 5 4 3 2 1 6 1 4 2 5 5 6 3 6 2 2 1 6 
710 5 6 5 5 5 5 4 3 2 1 6 1 4 2 5 5 6 3 6 2 2 1 6 
710 5 6 5 5 5 5 4 3 2 1 6 1 4 2 5 5 6 3 6 2 2 1 6 
710 5 6 5 5 5 5 4 3 2 1 6 1 4 2 5 5 6 3 6 2 2 1 6 
710 5 6 5 5 5 5 4 3 2 1 6 1 4 2 5 5 6 3 6 2 2 1 6 
710 5 6 5 5 5 5 4 3 2 1 6 1 4 2 5 5 6 3 6 2 1 1 1 6 
700 5 6 5 5 5 5 4 3 2 1 6 1 4 2 5 5 6 3 6 2 2 1 2 3 
700 5 6 5 5 5 5 4 3 2 1 6 1 4 2 5 5 6 3 6 2 2 1 2 3 
700 5 6 5 5 5 5 4 3 2 1 6 1 4 2 5 5 6 3 6 2 2 1 2 3 
700 5 6 5 5 5 5 4 3 2 1 6 1 4 2 5 5 6 3 6 2 2 2 1 3 
700 5 6 5 5 5 5 4 3 2 1 6 1 4 2 5 5 6 3 6 2 2 1 2 3 
700 5 6 5 5 5 5 4 3 2 1 6 1 4 2 5 5 6 3 6 2 2 1 2 3 
695 5 6 5 5 5 5 4 3 2 1 6 1 4 2 5 5 6 3 6 2 2 1 5 
695 5 6 5 5 5 5 4 3 2 1 6 1 4 2 5 5 6 3 6 2 2 1 5 
695 5 6 5 5 5 5 4 3 2 1 6 1 4 2 5 5 6 3 6 2 2 1 5 
695 5 6 5 5 5 5 4 3 2 1 6 1 4 2 5 5 6 3 6 2 2 1 5 
695 5 6 5 5 5 5 4 3 2 1 6 1 4 2 5 5 6 3 6 2 2 1 5 
695 5 6 5 5 5 5 4 3 2 1 6 1 4 2 5 5 6 3 6 2 2 1 1 4 
695 5 6 5 5 5 5 4 3 2 1 6 1 4 2 5 5 6 3 6 2 1 2 1 4 
695 5 6 5 5 5 5 4 3 2 1 6 1 4 2 5 5 6 3 6 1 1 2 2 4 
695 5 6 5 5 5 5 4 3 2 1 6 1 4 2 5 5 6 3 6 2 2 1 5 
685 5 6 5 5 5 5 4 3 2 1 6 1 4 2 5 5 6 3 6 2 2 6 
685 5 6 5 5 5 5 4 3 2 1 6 1 4 2 5 5 6 3 6 2 2 6 
685 5 6 5 5 5 5 4 3 2 1 6 1 4 2 5 5 6 3 6 2 2 6 
675 5 6 5 5 5 5 4 3 2 1 6 1 4 2 5 5 6 3 6 2 2 2 3 
675 5 6 5 5 5 5 4 3 2 1 6 1 4 2 5 5 6 3 6 2 2 1 1 3 
675 5 6 5 5 5 5 4 3 2 1 6 1 4 2 5 5 6 3 6 2 2 1 1 3 
675 5 6 5 5 5 5 4 3 2 1 6 1 4 2 5 5 6 3 6 2 2 2 3 
670 5 6 5 5 5 5 4 3 2 1 6 1 4 2 5 5 6 3 6 2 2 1 4 
670 5 6 5 5 5 5 4 3 2 1 6 1 4 2 5 5 6 3 6 2 2 5 
670 5 6 5 5 5 5 4 3 2 1 6 1 4 2 5 5 6 3 6 2 2 5 
670 5 6 5 5 5 5 4 3 2 1 6 1 4 2 5 5 6 3 6 2 2 5 
670 5 6 5 5 5 5 4 3 2 1 6 1 4 2 5 5 6 3 6 2 1 2 4 
670 5 6 5 5 5 5 4 3 2 1 6 1 4 2 5 5 6 3 6 2 2 5 
670 5 6 5 5 5 5 4 3 2 1 6 1 4 2 5 5 6 3 6 2 2 1 4 
670 5 6 5 5 5 5 4 3 2 1 6 1 4 2 5 5 6 3 6 2 2 1 4 
670 5 6 5 5 5 5 4 3 2 1 6 1 4 2 5 5 6 3 6 2 2 1 4 
670 5 6 5 5 5 5 4 3 2 1 6 1 4 2 5 5 6 3 6 2 2 1 4 
670 5 6 5 5 5 5 4 3 2 1 6 1 4 2 5 5 6 3 6 2 1 2 4 
670 5 6 5 5 5 5 4 3 2 1 6 1 4 2 5 5 6 3 6 2 2 5 
670 5 6 5 5 5 5 4 3 2 1 6 1 4 2 5 5 6 3 6 2 2 5 
660 5 6 5 5 5 5 4 3 2 1 6 1 4 2 5 5 6 3 6 1 2 6 
660 5 6 5 5 5 5 4 3 2 1 6 1 4 2 5 5 6 3 6 1 2 6 
650 5 6 5 5 5 5 4 3 2 1 6 1 4 2 5 5 6 3 6 2 2 1 3 
650 5 6 5 5 5 5 4 3 2 1 6 1 4 2 5 5 6 3 6 2 2 1 3 
650 5 6 5 5 5 5 4 3 2 1 6 1 4 2 5 5 6 3 6 2 2 1 3 
650 5 6 5 5 5 5 4 3 2 1 6 1 4 2 5 5 6 3 6 2 2 1 3 
650 5 6 5 5 5 5 4 3 2 1 6 1 4 2 5 5 6 3 6 2 2 1 3 
650 5 6 5 5 5 5 4 3 2 1 6 1 4 2 5 5 6 3 6 2 2 1 3 
650 5 6 5 5 5 5 4 3 2 1 6 1 4 2 5 5 6 3 6 2 2 1 3 
650 5 6 5 5 5 5 4 3 2 1 6 1 4 2 5 5 6 3 6 2 2 1 3 
650 5 6 5 5 5 5 4 3 2 1 6 1 4 2 5 5 6 3 6 2 2 1 3 
650 5 6 5 5 5 5 4 3 2 1 6 1 4 2 5 5 6 3 6 2 2 1 3 
650 5 6 5 5 5 5 4 3 2 1 6 1 4 2 5 5 6 3 6 2 2 1 3 
650 5 6 5 5 5 5 4 3 2 1 6 1 4 2 5 5 6 3 6 2 2 1 3 
645 5 6 5 5 5 5 4 3 2 1 6 1 4 2 5 5 6 3 6 2 2 4 
645 5 6 5 5 5 5 4 3 2 1 6 1 4 2 5 5 6 3 6 2 2 4 
645 5 6 5 5 5 5 4 3 2 1 6 1 4 2 5 5 6 3 6 2 2 4 
645 5 6 5 5 5 5 4 3 2 1 6 1 4 2 5 5 6 3 6 2 2 4 
645 5 6 5 5 5 5 4 3 2 1 6 1 4 2 5 5 6 3 6 2 2 4 
645 5 6 5 5 5 5 4 3 2 1 6 1 4 2 5 5 6 3 6 2 2 4 
645 5 6 5 5 5 5 4 3 2 1 6 1 4 2 5 5 6 3 6 2 1 5 
645 5 6 5 5 5 5 4 3 2 1 6 1 4 2 5 5 6 3 6 1 2 1 4 
645 5 6 5 5 5 5 4 3 2 1 6 1 4 2 5 5 6 3 6 2 2 4 
645 5 6 5 5 5 5 4 3 2 1 6 1 4 2 5 5 6 3 6 2 2 4 
635 5 6 5 5 5 5 4 3 2 1 6 1 4 2 5 5 6 3 6 2 6 
635 5 6 5 5 5 5 4 3 2 1 6 1 4 2 5 5 6 3 6 2 6 
635 5 6 5 5 5 5 4 3 2 1 6 1 4 2 5 5 6 3 6 2 6 
635 5 6 5 5 5 5 4 3 2 1 6 1 4 2 5 5 6 3 6 2 6 
635 5 6 5 5 5 5 4 3 2 1 6 1 4 2 5 5 6 3 6 2 6 
625 5 6 5 5 5 5 4 3 2 1 6 1 4 2 5 5 6 3 6 2 2 3 
625 5 6 5 5 5 5 4 3 2 1 6 1 4 2 5 5 6 3 6 2 2 3 
625 5 6 5 5 5 5 4 3 2 1 6 1 4 2 5 5 6 3 6 2 2 3 
625 5 6 5 5 5 5 4 3 2 1 6 1 4 2 5 5 6 3 6 2 2 3 
620 5 6 5 5 5 5 4 3 2 1 6 1 4 2 5 5 6 3 6 2 5 
620 5 6 5 5 5 5 4 3 2 1 6 1 4 2 5 5 6 3 6 2 5 
620 5 6 5 5 5 5 4 3 2 1 6 1 4 2 5 5 6 3 6 2 5 
620 5 6 5 5 5 5 4 3 2 1 6 1 4 2 5 5 6 3 6 2 1 4 
610 5 6 5 5 5 5 4 3 2 1 6 1 4 2 5 5 6 3 6 1 6 
610 5 6 5 5 5 5 4 3 2 1 6 1 4 2 5 5 6 3 6 1 6 
595 5 6 5 5 5 5 4 3 2 1 6 1 4 2 5 5 6 3 6 2 4 
595 5 6 5 5 5 5 4 3 2 1 6 1 4 2 5 5 6 3 6 2 4 
585 5 6 5 5 5 5 4 3 2 1 6 1 4 2 5 5 6 3 6 6 
585 5 6 5 5 5 5 4 3 2 1 6 1 4 2 5 5 6 3 6 6 
575 5 6 5 5 5 5 4 3 2 1 6 1 4 2 5 5 6 3 6 2 3 
575 5 6 5 5 5 5 4 3 2 1 6 1 4 2 5 5 6 3 6 2 3 
575 5 6 5 5 5 5 4 3 2 1 6 1 4 2 5 5 6 3 6 2 3 
570 5 6 5 5 5 5 4 3 2 1 6 1 4 2 5 5 6 3 6 5 
570 5 6 5 5 5 5 4 3 2 1 6 1 4 2 5 5 6 3 6 1 4 
570 5 6 5 5 5 5 4 3 2 1 6 1 4 2 5 5 6 3 6 5 
545 5 6 5 5 5 5 4 3 2 1 6 1 4 2 5 5 6 3 6 4 
525 5 6 5 5 5 5 4 3 2 1 6 1 4 2 5 5 6 5 4 3 2 1 1 
525 5 6 5 5 5 5 4 3 2 1 6 1 4 2 5 5 6 3 6 3 
