140 4 2 5 5 5 5 5 2 6 
140 4 2 5 5 5 5 5 2 6 
140 4 2 5 5 5 5 5 5 6 
140 4 2 5 5 5 5 5 5 6 
140 4 2 5 5 5 5 5 2 6 
140 4 2 5 5 5 5 5 2 6 
140 4 2 5 5 5 5 5 2 6 
125 4 2 5 5 5 5 5 2 5 
125 4 2 5 5 5 5 5 2 5 
125 4 2 5 5 5 5 5 2 5 
125 4 2 5 5 5 5 5 2 5 
125 4 2 5 5 5 5 5 2 2 
125 4 2 5 5 5 5 5 2 5 
125 4 2 5 5 5 5 5 5 2 
125 4 2 5 5 5 5 5 5 2 
125 4 2 5 5 5 5 5 5 5 
125 4 2 5 5 5 5 5 5 5 
115 4 2 5 5 5 5 5 1 6 
115 4 2 5 5 5 5 4 6 2 
100 4 2 5 5 5 5 5 2 4 
100 4 2 5 5 5 5 5 2 1 
100 4 2 5 5 5 5 5 5 1 
100 4 2 5 5 5 5 5 4 2 
100 4 2 5 5 5 5 5 2 1 
100 4 2 5 5 5 5 5 2 4 
100 4 2 5 5 5 5 5 1 2 
95 4 2 5 5 5 5 5 3 6 
90 4 2 5 5 5 5 5 6 
90 4 2 5 5 5 5 6 2 
90 4 2 5 5 5 5 5 6 
90 4 2 5 5 5 5 5 6 
90 4 2 5 5 5 5 5 6 
80 4 2 5 5 5 5 5 2 3 
80 4 2 5 5 5 5 5 2 3 
80 4 2 5 5 5 5 5 2 3 
80 4 2 5 5 5 5 5 2 3 
75 4 2 5 5 5 5 5 4 1 1 
75 4 2 5 5 5 5 4 5 4 
75 4 2 5 5 5 5 4 4 5 2 
75 4 2 5 5 5 5 5 1 4 
75 4 2 5 5 5 5 5 4 1 5 
75 4 2 5 5 5 5 4 5 4 
55 4 2 5 5 5 5 5 1 3 
25 4 2 5 5 5 5 4 1 
25 4 2 5 5 5 5 2 
0 4 2 5 5 5 5 1 
0 4 2 5 5 5 5 1 
-20 4 2 5 5 5 5 3 
