945 5 6 5 5 5 5 4 3 2 1 6 1 4 2 5 5 6 3 6 2 2 1 2 1 2 4 2 5 5 
915 5 6 5 5 5 5 4 3 2 1 6 1 4 2 5 5 6 3 6 2 2 1 2 1 2 3 6 4 5 
915 5 6 5 5 5 5 4 3 2 1 6 1 4 2 5 5 6 3 6 2 2 1 2 1 2 4 3 6 2 
910 5 6 5 5 5 5 4 3 2 1 6 1 4 2 5 5 6 3 6 2 2 1 2 1 2 4 2 6 
910 5 6 5 5 5 5 4 3 2 1 6 1 4 2 5 5 6 3 6 2 2 1 2 1 2 4 2 6 
900 5 6 5 5 5 5 4 3 2 1 6 1 4 2 5 5 6 3 6 2 2 1 2 1 2 6 6 
900 5 6 5 5 5 5 4 3 2 1 6 1 4 2 5 5 6 3 6 2 2 1 2 1 2 4 2 3 2 
900 5 6 5 5 5 5 4 3 2 1 6 1 4 2 5 5 6 3 6 2 2 1 2 1 2 6 6 
895 5 6 5 5 5 5 4 3 2 1 6 1 4 2 5 5 6 3 6 2 2 1 2 1 2 4 5 2 
895 5 6 5 5 5 5 4 3 2 1 6 1 4 2 5 5 6 3 6 2 2 1 2 1 2 4 2 2 
895 5 6 5 5 5 5 4 3 2 1 6 1 4 2 5 5 6 3 6 2 2 1 2 1 2 1 2 2 
885 5 6 5 5 5 5 4 3 2 1 6 1 4 2 5 5 6 3 6 2 2 1 2 1 2 6 2 
875 5 6 5 5 5 5 4 3 2 1 6 1 4 2 5 5 6 3 6 2 2 1 2 1 2 4 5 3 4 5 
870 5 6 5 5 5 5 4 3 2 1 6 1 4 2 5 5 6 3 6 2 2 1 2 1 2 1 2 4 
870 5 6 5 5 5 5 4 3 2 1 6 1 4 2 5 5 6 3 6 2 2 1 2 1 2 4 2 1 
870 5 6 5 5 5 5 4 3 2 1 6 1 4 2 5 5 6 3 6 2 2 1 2 1 2 4 2 1 
860 5 6 5 5 5 5 4 3 2 1 6 1 4 2 5 5 6 3 6 2 2 1 2 1 2 4 6 
855 5 6 5 5 5 5 4 3 2 1 6 1 4 2 5 5 6 3 6 2 2 1 2 1 2 4 2 3 3 
825 5 6 5 5 5 5 4 3 2 1 6 1 4 2 5 5 6 3 6 2 2 1 2 1 2 3 1 1 
825 5 6 5 5 5 5 4 3 2 1 6 1 4 2 5 5 6 3 6 2 2 1 2 1 2 3 4 1 
825 5 6 5 5 5 5 4 3 2 1 6 1 4 2 5 5 6 3 6 2 2 1 2 1 2 3 4 4 
820 5 6 5 5 5 5 4 3 2 1 6 1 4 2 5 5 6 3 6 2 2 1 2 1 2 2 
820 5 6 5 5 5 5 4 3 2 1 6 1 4 2 5 5 6 3 6 2 2 1 2 1 2 2 
820 5 6 5 5 5 5 4 3 2 1 6 1 4 2 5 5 6 3 6 2 2 1 2 1 2 4 4 
820 5 6 5 5 5 5 4 3 2 1 6 1 4 2 5 5 6 3 6 2 2 1 2 1 2 4 1 
820 5 6 5 5 5 5 4 3 2 1 6 1 4 2 5 5 6 3 6 2 2 1 2 1 2 2 
820 5 6 5 5 5 5 4 3 2 1 6 1 4 2 5 5 6 3 6 2 2 1 2 1 2 4 4 
820 5 6 5 5 5 5 4 3 2 1 6 1 4 2 5 5 6 3 6 2 2 1 2 1 2 5 
820 5 6 5 5 5 5 4 3 2 1 6 1 4 2 5 5 6 3 6 2 2 1 2 1 2 4 4 
820 5 6 5 5 5 5 4 3 2 1 6 1 4 2 5 5 6 3 6 2 2 1 2 1 2 1 4 
820 5 6 5 5 5 5 4 3 2 1 6 1 4 2 5 5 6 3 6 2 2 1 2 1 2 2 
820 5 6 5 5 5 5 4 3 2 1 6 1 4 2 5 5 6 3 6 2 2 1 2 1 2 2 
795 5 6 5 5 5 5 4 3 2 1 6 1 4 2 5 5 6 3 6 2 2 1 2 2 5 
785 5 6 5 5 5 5 4 3 2 1 6 1 4 2 5 5 6 3 6 2 2 1 2 1 6 
785 5 6 5 5 5 5 4 3 2 1 6 1 4 2 5 5 6 3 6 2 2 1 2 1 6 
785 5 6 5 5 5 5 4 3 2 1 6 1 4 2 5 5 6 3 6 2 2 1 2 1 6 
785 5 6 5 5 5 5 4 3 2 1 6 1 4 2 5 5 6 3 6 2 2 1 2 1 6 
780 5 6 5 5 5 5 4 3 2 1 6 1 4 2 5 5 6 3 6 2 2 1 2 1 2 3 3 
780 5 6 5 5 5 5 4 3 2 1 6 1 4 2 5 5 6 3 6 2 2 1 2 1 2 3 3 
770 5 6 5 5 5 5 4 3 2 1 6 1 4 2 5 5 6 3 6 2 2 1 2 1 5 
770 5 6 5 5 5 5 4 3 2 1 6 1 4 2 5 5 6 3 6 2 2 1 2 1 5 
770 5 6 5 5 5 5 4 3 2 1 6 1 4 2 5 5 6 3 6 2 2 1 2 1 5 
760 5 6 5 5 5 5 4 3 2 1 6 1 4 2 5 5 6 3 6 2 2 1 2 6 
760 5 6 5 5 5 5 4 3 2 1 6 1 4 2 5 5 6 3 6 2 2 1 2 6 
725 5 6 5 5 5 5 4 3 2 1 6 1 4 2 5 5 6 3 6 2 2 1 2 1 3 
720 5 6 5 5 5 5 4 3 2 1 6 1 4 2 5 5 6 3 6 2 2 1 2 4 
700 5 6 5 5 5 5 4 3 2 1 6 1 4 2 5 5 6 3 6 2 2 1 2 3 
-115 5 6 5 5 5 5 4 3 2 1 6 1 4 2 5 5 6 3 6 2 2 1 2 1 2 4 2 4 6 
-140 5 6 5 5 5 5 4 3 2 1 6 1 4 2 5 5 6 3 6 2 2 1 2 1 2 4 2 1 2 
-155 5 6 5 5 5 5 4 3 2 1 6 1 4 2 5 5 6 3 6 2 2 1 2 1 2 4 2 5 3 
-155 5 6 5 5 5 5 4 3 2 1 6 1 4 2 5 5 6 3 6 2 2 1 2 1 2 4 2 5 
-160 5 6 5 5 5 5 4 3 2 1 6 1 4 2 5 5 6 3 6 2 2 1 2 1 2 4 3 2 
-160 5 6 5 5 5 5 4 3 2 1 6 1 4 2 5 5 6 3 6 2 2 1 2 1 2 4 2 5 1 5 
-160 5 6 5 5 5 5 4 3 2 1 6 1 4 2 5 5 6 3 6 2 2 1 2 1 2 4 4 2 
-160 5 6 5 5 5 5 4 3 2 1 6 1 4 2 5 5 6 3 6 2 2 1 2 1 2 4 2 5 4 3 
-160 5 6 5 5 5 5 4 3 2 1 6 1 4 2 5 5 6 3 6 2 2 1 2 1 2 4 2 5 4 5 
-180 5 6 5 5 5 5 4 3 2 1 6 1 4 2 5 5 6 3 6 2 2 1 2 1 2 4 2 5 3 4 
-180 5 6 5 5 5 5 4 3 2 1 6 1 4 2 5 5 6 3 6 2 2 1 2 1 2 4 2 5 3 3 
-230 5 6 5 5 5 5 4 3 2 1 6 1 4 2 5 5 6 3 6 2 2 1 2 1 2 4 2 2 
-245 5 6 5 5 5 5 4 3 2 1 6 1 4 2 5 5 6 3 6 2 2 1 2 1 2 
-245 5 6 5 5 5 5 4 3 2 1 6 1 4 2 5 5 6 3 6 2 2 1 2 1 2 
-245 5 6 5 5 5 5 4 3 2 1 6 1 4 2 5 5 6 3 6 2 2 1 2 1 
-245 5 6 5 5 5 5 4 3 2 1 6 1 4 2 5 5 6 3 6 2 2 1 2 1 
-245 5 6 5 5 5 5 4 3 2 1 6 1 4 2 5 5 6 3 6 2 2 1 2 1 
-245 5 6 5 5 5 5 4 3 2 1 6 1 4 2 5 5 6 3 6 2 2 1 2 1 2 
-245 5 6 5 5 5 5 4 3 2 1 6 1 4 2 5 5 6 3 6 2 2 1 2 1 
-245 5 6 5 5 5 5 4 3 2 1 6 1 4 2 5 5 6 3 6 2 2 1 2 1 2 6 
-245 5 6 5 5 5 5 4 3 2 1 6 1 4 2 5 5 6 3 6 2 2 1 2 1 
-245 5 6 5 5 5 5 4 3 2 1 6 1 4 2 5 5 6 3 6 2 2 1 2 1 2 6 
-245 5 6 5 5 5 5 4 3 2 1 6 1 4 2 5 5 6 3 6 2 2 1 2 1 
-245 5 6 5 5 5 5 4 3 2 1 6 1 4 2 5 5 6 3 6 2 2 1 2 1 2 
-245 5 6 5 5 5 5 4 3 2 1 6 1 4 2 5 5 6 3 6 2 2 1 2 1 2 6 
-245 5 6 5 5 5 5 4 3 2 1 6 1 4 2 5 5 6 3 6 2 2 1 2 1 2 6 
-245 5 6 5 5 5 5 4 3 2 1 6 1 4 2 5 5 6 3 6 2 2 1 2 1 
-245 5 6 5 5 5 5 4 3 2 1 6 1 4 2 5 5 6 3 6 2 2 1 2 1 2 
-245 5 6 5 5 5 5 4 3 2 1 6 1 4 2 5 5 6 3 6 2 2 1 2 1 
-245 5 6 5 5 5 5 4 3 2 1 6 1 4 2 5 5 6 3 6 2 2 1 2 1 
-245 5 6 5 5 5 5 4 3 2 1 6 1 4 2 5 5 6 3 6 2 2 1 2 1 2 6 
-245 5 6 5 5 5 5 4 3 2 1 6 1 4 2 5 5 6 3 6 2 2 1 2 1 2 6 
-245 5 6 5 5 5 5 4 3 2 1 6 1 4 2 5 5 6 3 6 2 2 1 2 1 2 6 
-245 5 6 5 5 5 5 4 3 2 1 6 1 4 2 5 5 6 3 6 2 2 1 2 1 2 
-245 5 6 5 5 5 5 4 3 2 1 6 1 4 2 5 5 6 3 6 2 2 1 2 1 2 
-245 5 6 5 5 5 5 4 3 2 1 6 1 4 2 5 5 6 3 6 2 2 1 2 1 2 6 
-245 5 6 5 5 5 5 4 3 2 1 6 1 4 2 5 5 6 3 6 2 2 1 2 1 2 6 
-245 5 6 5 5 5 5 4 3 2 1 6 1 4 2 5 5 6 3 6 2 2 1 2 1 2 
-245 5 6 5 5 5 5 4 3 2 1 6 1 4 2 5 5 6 3 6 2 2 1 2 1 2 6 
-245 5 6 5 5 5 5 4 3 2 1 6 1 4 2 5 5 6 3 6 2 2 1 2 1 2 
-245 5 6 5 5 5 5 4 3 2 1 6 1 4 2 5 5 6 3 6 2 2 1 2 1 2 
-245 5 6 5 5 5 5 4 3 2 1 6 1 4 2 5 5 6 3 6 2 2 1 2 1 2 
-245 5 6 5 5 5 5 4 3 2 1 6 1 4 2 5 5 6 3 6 2 2 1 2 1 2 
-245 5 6 5 5 5 5 4 3 2 1 6 1 4 2 5 5 6 3 6 2 2 1 2 1 2 
-245 5 6 5 5 5 5 4 3 2 1 6 1 4 2 5 5 6 3 6 2 2 1 2 1 2 
-245 5 6 5 5 5 5 4 3 2 1 6 1 4 2 5 5 6 3 6 2 2 1 2 1 2 6 
-245 5 6 5 5 5 5 4 3 2 1 6 1 4 2 5 5 6 3 6 2 2 1 2 1 2 4 2 
-245 5 6 5 5 5 5 4 3 2 1 6 1 4 2 5 5 6 3 6 2 2 1 2 1 2 4 2 5 3 5 6 
-245 5 6 5 5 5 5 4 3 2 1 6 1 4 2 5 5 6 3 6 2 2 1 2 1 2 4 2 5 
-245 5 6 5 5 5 5 4 3 2 1 6 1 4 2 5 5 6 3 6 2 2 1 2 1 2 4 2 5 3 5 6 
-245 5 6 5 5 5 5 4 3 2 1 6 1 4 2 5 5 6 3 6 2 2 1 2 1 
-245 5 6 5 5 5 5 4 3 2 1 6 1 4 2 5 5 6 3 6 2 2 1 2 1 2 6 
-245 5 6 5 5 5 5 4 3 2 1 6 1 4 2 5 5 6 3 6 2 2 1 2 1 2 6 
-245 5 6 5 5 5 5 4 3 2 1 6 1 4 2 5 5 6 3 6 2 2 1 2 1 2 
-245 5 6 5 5 5 5 4 3 2 1 6 1 4 2 5 5 6 3 6 2 2 1 2 1 2 6 
-245 5 6 5 5 5 5 4 3 2 1 6 1 4 2 5 5 6 3 6 2 2 1 2 1 2 
-245 5 6 5 5 5 5 4 3 2 1 6 1 4 2 5 5 6 3 6 2 2 1 2 1 
-245 5 6 5 5 5 5 4 3 2 1 6 1 4 2 5 5 6 3 6 2 2 1 2 1 
-245 5 6 5 5 5 5 4 3 2 1 6 1 4 2 5 5 6 3 6 2 2 1 2 1 2 6 
-245 5 6 5 5 5 5 4 3 2 1 6 1 4 2 5 5 6 3 6 2 2 1 2 1 2 6 
-245 5 6 5 5 5 5 4 3 2 1 6 1 4 2 5 5 6 3 6 2 2 1 2 1 
-245 5 6 5 5 5 5 4 3 2 1 6 1 4 2 5 5 6 3 6 2 2 1 2 1 
-245 5 6 5 5 5 5 4 3 2 1 6 1 4 2 5 5 6 3 6 2 2 1 2 1 2 
-245 5 6 5 5 5 5 4 3 2 1 6 1 4 2 5 5 6 3 6 2 2 1 2 1 2 6 
-245 5 6 5 5 5 5 4 3 2 1 6 1 4 2 5 5 6 3 6 2 2 1 2 1 
-245 5 6 5 5 5 5 4 3 2 1 6 1 4 2 5 5 6 3 6 2 2 1 2 1 
-245 5 6 5 5 5 5 4 3 2 1 6 1 4 2 5 5 6 3 6 2 2 1 2 1 2 6 
-245 5 6 5 5 5 5 4 3 2 1 6 1 4 2 5 5 6 3 6 2 2 1 2 1 
-245 5 6 5 5 5 5 4 3 2 1 6 1 4 2 5 5 6 3 6 2 2 1 2 1 
-245 5 6 5 5 5 5 4 3 2 1 6 1 4 2 5 5 6 3 6 2 2 1 2 1 2 6 
-245 5 6 5 5 5 5 4 3 2 1 6 1 4 2 5 5 6 3 6 2 2 1 2 1 
-245 5 6 5 5 5 5 4 3 2 1 6 1 4 2 5 5 6 3 6 2 2 1 2 1 2 
-245 5 6 5 5 5 5 4 3 2 1 6 1 4 2 5 5 6 3 6 2 2 1 2 1 2 6 
-245 5 6 5 5 5 5 4 3 2 1 6 1 4 2 5 5 6 3 6 2 2 1 2 1 2 
-245 5 6 5 5 5 5 4 3 2 1 6 1 4 2 5 5 6 3 6 2 2 1 2 1 2 
-245 5 6 5 5 5 5 4 3 2 1 6 1 4 2 5 5 6 3 6 2 2 1 2 1 2 6 
-245 5 6 5 5 5 5 4 3 2 1 6 1 4 2 5 5 6 3 6 2 2 1 2 1 2 6 
-245 5 6 5 5 5 5 4 3 2 1 6 1 4 2 5 5 6 3 6 2 2 1 2 1 2 6 
-245 5 6 5 5 5 5 4 3 2 1 6 1 4 2 5 5 6 3 6 2 2 1 2 1 2 6 
-250 5 6 5 5 5 5 4 3 2 1 6 1 4 2 5 5 6 3 6 2 2 1 2 1 2 4 2 
-250 5 6 5 5 5 5 4 3 2 1 6 1 4 2 5 5 6 3 6 2 2 1 2 1 2 4 2 5 2 
