1145 4 1 6 5 5 5 5 5 6 1 6 5 6 5 6 5 4 2 1 2 2 2 2 3 2 5 1 4 4 6 4 1 5 5 
995 4 1 6 5 5 5 5 5 6 1 6 5 6 5 6 5 4 2 1 2 2 2 2 3 5 4 6 2 
950 4 1 6 5 5 5 5 5 6 1 6 5 6 5 6 5 4 2 1 2 2 2 2 2 5 2 
940 4 1 6 5 5 5 5 5 6 1 6 5 6 5 6 5 4 2 1 2 2 2 2 5 6 4 
940 4 1 6 5 5 5 5 5 6 1 6 5 6 5 6 5 4 2 1 2 2 2 2 2 6 1 
905 4 1 6 5 5 5 5 5 6 1 6 5 6 5 6 5 4 2 1 2 2 2 2 5 3 2 
900 4 1 6 5 5 5 5 5 6 1 6 5 6 5 6 5 4 2 1 2 2 2 2 2 2 
885 4 1 6 5 5 5 5 5 6 1 6 5 6 5 6 5 4 2 1 2 2 2 1 6 5 3 
880 4 1 6 5 5 5 5 5 6 1 6 5 6 5 6 5 4 2 1 2 2 2 2 3 4 2 
875 4 1 6 5 5 5 5 5 6 1 6 5 6 5 6 5 4 2 1 2 2 2 2 5 4 
875 4 1 6 5 5 5 5 5 6 1 6 5 6 5 6 5 4 2 1 2 2 2 2 2 1 
870 4 1 6 5 5 6 4 4 6 2 2 6 6 4 4 6 6 5 2 2 2 1 1 1 6 4 
860 4 1 6 5 5 5 5 5 6 1 6 5 6 5 6 5 4 2 1 2 2 2 2 6 3 2 
860 4 1 6 5 5 5 5 5 6 1 6 5 6 5 6 5 4 2 1 2 2 2 2 6 3 4 
860 4 1 6 5 5 5 5 5 6 1 6 5 6 5 6 5 4 2 1 2 2 2 2 6 3 4 6 5 
860 4 1 6 5 5 5 5 5 6 1 6 5 6 5 6 5 4 2 1 2 2 2 2 6 3 4 
860 4 1 6 5 5 5 5 5 6 1 6 5 6 5 6 5 4 2 1 2 2 2 2 6 3 4 6 4 
860 4 1 6 5 5 5 5 5 6 1 6 5 6 5 6 5 4 2 1 2 2 2 2 6 3 6 
860 4 1 6 5 5 5 5 5 6 1 6 5 6 5 6 5 4 2 1 2 2 2 2 6 3 4 6 2 
860 4 1 6 5 5 5 5 5 6 1 6 5 6 5 6 5 4 2 1 2 2 2 2 6 3 4 6 6 
860 4 1 6 5 5 5 5 5 6 1 6 5 6 5 6 5 4 2 1 2 2 2 2 6 3 4 6 3 
860 4 1 6 5 5 5 5 5 6 1 6 5 6 5 6 5 4 2 1 2 2 2 2 6 3 5 
860 4 1 6 5 5 5 5 5 6 1 6 5 6 5 6 5 4 2 1 2 2 2 2 6 3 4 6 5 
860 4 1 6 5 5 5 5 5 6 1 6 5 6 5 6 5 4 2 1 2 2 2 2 6 3 4 1 
860 4 1 6 5 5 5 5 5 6 1 6 5 6 5 6 5 4 2 1 2 2 2 2 6 3 4 6 2 
860 4 1 6 5 5 5 5 5 6 1 6 5 6 5 6 5 4 2 1 2 2 2 2 6 3 4 6 
860 4 1 6 5 5 5 5 5 6 1 6 5 6 5 6 5 4 2 1 2 2 2 2 6 3 5 
860 4 1 6 5 5 5 5 5 6 1 6 5 6 5 6 5 4 2 1 2 2 2 2 6 3 3 
860 4 1 6 5 5 5 5 5 6 1 6 5 6 5 6 5 4 2 1 2 2 2 2 6 3 4 
860 4 1 6 5 5 5 5 5 6 1 6 5 6 5 6 5 4 2 1 2 2 2 2 6 3 4 3 
860 4 1 6 5 5 5 5 5 6 1 6 5 6 5 6 5 4 2 1 2 2 2 2 6 3 3 
860 4 1 6 5 5 5 5 5 6 1 6 5 6 5 6 5 4 2 1 2 2 2 2 6 3 4 4 
860 4 1 6 5 5 5 5 5 6 1 6 5 6 5 6 5 4 2 1 2 2 2 2 6 3 4 6 1 
860 4 1 6 5 5 5 5 5 6 1 6 5 6 5 6 5 4 2 1 2 2 2 2 6 3 6 
860 4 1 6 5 5 5 5 5 6 1 6 5 6 5 6 5 4 2 1 2 2 2 2 6 3 6 
860 4 1 6 5 5 5 5 5 6 1 6 5 6 5 6 5 4 2 1 2 2 2 2 6 3 4 6 2 
860 4 1 6 5 5 5 5 5 6 1 6 5 6 5 6 5 4 2 1 2 2 2 2 6 3 5 
860 4 1 6 5 5 5 5 5 6 1 6 5 6 5 6 5 4 2 1 2 2 2 2 6 3 4 2 
860 4 1 6 5 5 5 5 5 6 1 6 5 6 5 6 5 4 2 1 2 2 2 2 6 3 1 
860 4 1 6 5 5 5 5 5 6 1 6 5 6 5 6 5 4 2 1 2 2 2 2 6 2 
860 4 1 6 5 5 5 5 5 6 1 6 5 6 5 6 5 4 2 1 2 2 2 2 3 1 4 3 
860 4 1 6 5 5 5 5 5 6 1 6 5 6 5 6 5 4 2 1 2 2 2 2 6 1 5 
860 4 1 6 5 5 5 5 5 6 1 6 5 6 5 6 5 4 2 1 2 2 2 2 6 5 
860 4 1 6 5 5 5 5 5 6 1 6 5 6 5 6 5 4 2 1 2 2 2 2 6 3 2 
860 4 1 6 5 5 5 5 5 6 1 6 5 6 5 6 5 4 2 1 2 2 2 2 6 3 1 5 
860 4 1 6 5 5 5 5 5 6 1 6 5 6 5 6 5 4 2 1 2 2 2 2 6 4 2 
860 4 1 6 5 5 5 5 5 6 1 6 5 6 5 6 5 4 2 1 2 2 2 2 6 2 
860 4 1 6 5 5 5 5 5 6 1 6 5 6 5 6 5 4 2 1 2 2 2 2 6 3 4 
860 4 1 6 5 5 5 5 5 6 1 6 5 6 5 6 5 4 2 1 2 2 2 2 6 4 3 
860 4 1 6 5 5 5 5 5 6 1 6 5 6 5 6 5 4 2 1 2 2 2 2 6 4 4 
860 4 1 6 5 5 5 5 5 6 1 6 5 6 5 6 5 4 2 1 2 2 2 2 6 1 
860 4 1 6 5 5 5 5 5 6 1 6 5 6 5 6 5 4 2 1 2 2 2 2 6 3 1 
860 4 1 6 5 5 5 5 5 6 1 6 5 6 5 6 5 4 2 1 2 2 2 2 6 3 4 6 6 
860 4 1 6 5 5 5 5 5 6 1 6 5 6 5 6 5 4 2 1 2 2 2 2 6 3 4 6 2 
860 4 1 6 5 5 5 5 5 6 1 6 5 6 5 6 5 4 2 1 2 2 2 2 6 3 3 
860 4 1 6 5 5 5 5 5 6 1 6 5 6 5 6 5 4 2 1 2 2 2 2 6 3 4 4 
860 4 1 6 5 5 5 5 5 6 1 6 5 6 5 6 5 4 2 1 2 2 2 2 6 3 4 6 
825 4 1 6 5 5 5 5 5 6 1 6 5 6 5 6 5 4 2 1 2 2 2 2 1 
825 4 1 6 5 5 5 5 5 6 1 6 5 6 5 6 5 4 2 1 2 2 2 1 5 
825 4 1 6 5 5 5 5 5 6 1 6 5 6 5 6 5 4 2 1 2 2 2 1 1 3 1 1 5 2 5 2 
815 4 1 6 5 5 5 5 5 6 1 6 5 6 5 6 5 4 2 1 2 2 2 6 
815 4 1 6 5 5 5 5 5 6 1 6 5 6 5 6 5 4 2 1 2 2 2 6 
800 4 1 6 5 5 5 5 5 6 1 6 5 6 5 6 5 4 2 1 2 2 2 5 
755 4 1 6 5 5 5 5 5 6 1 6 5 6 5 6 5 4 2 1 2 2 2 3 
