835 5 6 5 5 5 5 4 3 2 1 6 1 4 2 5 5 6 3 6 2 2 1 2 1 2 6 2 
820 5 6 5 5 5 5 4 3 2 1 6 1 4 2 5 5 6 3 6 2 2 1 2 1 2 2 
820 5 6 5 5 5 5 4 3 2 1 6 1 4 2 5 5 6 3 6 2 2 1 2 1 2 2 
795 5 6 5 5 5 5 4 3 2 1 6 1 4 2 5 5 6 3 6 2 2 1 2 1 2 4 2 5 3 5 6 1 
795 5 6 5 5 5 5 4 3 2 1 6 1 4 2 5 5 6 3 6 2 2 1 2 1 2 4 2 5 3 5 6 1 4 
795 5 6 5 5 5 5 4 3 2 1 6 1 4 2 5 5 6 3 6 2 2 1 2 1 2 4 2 5 3 5 6 
795 5 6 5 5 5 5 4 3 2 1 6 1 4 2 5 5 6 3 6 2 2 1 2 1 2 4 2 5 3 5 6 1 4 
795 5 6 5 5 5 5 4 3 2 1 6 1 4 2 5 5 6 3 6 2 2 1 2 1 2 4 2 5 3 5 6 
795 5 6 5 5 5 5 4 3 2 1 6 1 4 2 5 5 6 3 6 2 2 1 2 1 2 4 2 5 3 5 6 
795 5 6 5 5 5 5 4 3 2 1 6 1 4 2 5 5 6 3 6 2 2 1 2 1 2 4 2 5 3 5 6 1 
795 5 6 5 5 5 5 4 3 2 1 6 1 4 2 5 5 6 3 6 2 2 1 2 1 2 4 2 5 3 5 6 
795 5 6 5 5 5 5 4 3 2 1 6 1 4 2 5 5 6 3 6 2 2 1 2 1 2 4 2 5 3 5 6 1 4 
795 5 6 5 5 5 5 4 3 2 1 6 1 4 2 5 5 6 3 6 2 2 1 2 1 2 4 2 5 3 5 6 
795 5 6 5 5 5 5 4 3 2 1 6 1 4 2 5 5 6 3 6 2 2 1 2 1 2 4 2 5 3 5 6 
795 5 6 5 5 5 5 4 3 2 1 6 1 4 2 5 5 6 3 6 2 2 1 2 1 2 4 2 5 3 5 6 
795 5 6 5 5 5 5 4 3 2 1 6 1 4 2 5 5 6 3 6 2 2 1 2 1 2 4 2 5 3 5 6 1 4 
795 5 6 5 5 5 5 4 3 2 1 6 1 4 2 5 5 6 3 6 2 2 1 2 1 2 4 2 5 3 5 6 
795 5 6 5 5 5 5 4 3 2 1 6 1 4 2 5 5 6 3 6 2 2 1 2 1 2 4 2 5 3 5 6 
795 5 6 5 5 5 5 4 3 2 1 6 1 4 2 5 5 6 3 6 2 2 1 2 1 2 4 2 5 3 5 6 1 4 
795 5 6 5 5 5 5 4 3 2 1 6 1 4 2 5 5 6 3 6 2 2 1 2 1 2 4 2 5 3 5 6 
795 5 6 5 5 5 5 4 3 2 1 6 1 4 2 5 5 6 3 6 2 2 1 2 1 2 4 2 5 3 5 6 1 4 
795 5 6 5 5 5 5 4 3 2 1 6 1 4 2 5 5 6 3 6 2 2 1 2 1 2 4 2 5 3 5 6 1 4 
795 5 6 5 5 5 5 4 3 2 1 6 1 4 2 5 5 6 3 6 2 2 1 2 1 2 4 2 5 3 5 6 1 4 
795 5 6 5 5 5 5 4 3 2 1 6 1 4 2 5 5 6 3 6 2 2 1 2 1 2 4 2 5 3 5 6 1 4 
795 5 6 5 5 5 5 4 3 2 1 6 1 4 2 5 5 6 3 6 2 2 1 2 1 2 4 2 5 3 5 6 1 4 
795 5 6 5 5 5 5 4 3 2 1 6 1 4 2 5 5 6 3 6 2 2 1 2 1 2 4 2 5 3 5 6 
795 5 6 5 5 5 5 4 3 2 1 6 1 4 2 5 5 6 3 6 2 2 1 2 1 2 4 2 5 3 5 6 1 4 
795 5 6 5 5 5 5 4 3 2 1 6 1 4 2 5 5 6 3 6 2 2 1 2 1 2 4 2 5 3 5 6 1 4 
795 5 6 5 5 5 5 4 3 2 1 6 1 4 2 5 5 6 3 6 2 2 1 2 1 2 4 2 5 3 5 6 1 
795 5 6 5 5 5 5 4 3 2 1 6 1 4 2 5 5 6 3 6 2 2 1 2 1 2 4 2 5 3 5 6 1 4 
795 5 6 5 5 5 5 4 3 2 1 6 1 4 2 5 5 6 3 6 2 2 1 2 1 2 4 2 5 3 5 6 1 4 
795 5 6 5 5 5 5 4 3 2 1 6 1 4 2 5 5 6 3 6 2 2 1 2 1 2 4 2 5 3 5 6 1 
795 5 6 5 5 5 5 4 3 2 1 6 1 4 2 5 5 6 3 6 2 2 1 2 1 2 4 2 5 3 5 6 
795 5 6 5 5 5 5 4 3 2 1 6 1 4 2 5 5 6 3 6 2 2 1 2 1 2 4 2 5 3 5 6 
795 5 6 5 5 5 5 4 3 2 1 6 1 4 2 5 5 6 3 6 2 2 1 2 1 2 4 2 5 3 5 6 1 
795 5 6 5 5 5 5 4 3 2 1 6 1 4 2 5 5 6 3 6 2 2 1 2 1 2 4 2 5 3 5 6 1 
795 5 6 5 5 5 5 4 3 2 1 6 1 4 2 5 5 6 3 6 2 2 1 2 1 2 4 2 5 3 5 6 1 4 
795 5 6 5 5 5 5 4 3 2 1 6 1 4 2 5 5 6 3 6 2 2 1 2 1 2 4 2 5 3 5 6 1 4 
795 5 6 5 5 5 5 4 3 2 1 6 1 4 2 5 5 6 3 6 2 2 1 2 1 2 4 2 5 3 5 6 
795 5 6 5 5 5 5 4 3 2 1 6 1 4 2 5 5 6 3 6 2 2 1 2 1 2 4 2 5 3 5 6 1 4 
795 5 6 5 5 5 5 4 3 2 1 6 1 4 2 5 5 6 3 6 2 2 1 2 1 2 4 2 5 3 5 6 1 
795 5 6 5 5 5 5 4 3 2 1 6 1 4 2 5 5 6 3 6 2 2 1 2 1 2 4 2 5 3 5 6 1 4 
795 5 6 5 5 5 5 4 3 2 1 6 1 4 2 5 5 6 3 6 2 2 1 2 1 2 4 2 5 3 5 6 1 4 
795 5 6 5 5 5 5 4 3 2 1 6 1 4 2 5 5 6 3 6 2 2 1 2 1 2 4 2 5 3 5 6 1 4 
795 5 6 5 5 5 5 4 3 2 1 6 1 4 2 5 5 6 3 6 2 2 1 2 1 2 4 2 5 3 5 6 1 4 
795 5 6 5 5 5 5 4 3 2 1 6 1 4 2 5 5 6 3 6 2 2 1 2 1 2 4 2 5 3 5 6 1 4 
795 5 6 5 5 5 5 4 3 2 1 6 1 4 2 5 5 6 3 6 2 2 1 2 1 2 4 2 5 3 5 6 1 
795 5 6 5 5 5 5 4 3 2 1 6 1 4 2 5 5 6 3 6 2 2 1 2 1 2 4 2 5 3 5 6 1 
795 5 6 5 5 5 5 4 3 2 1 6 1 4 2 5 5 6 3 6 2 2 1 2 1 2 4 2 5 3 5 6 1 
795 5 6 5 5 5 5 4 3 2 1 6 1 4 2 5 5 6 3 6 2 2 1 2 1 2 4 2 5 3 5 6 1 
795 5 6 5 5 5 5 4 3 2 1 6 1 4 2 5 5 6 3 6 2 2 1 2 1 2 4 2 5 3 5 6 1 4 
795 5 6 5 5 5 5 4 3 2 1 6 1 4 2 5 5 6 3 6 2 2 1 2 1 2 4 2 5 3 5 6 1 4 
795 5 6 5 5 5 5 4 3 2 1 6 1 4 2 5 5 6 3 6 2 2 1 2 1 2 4 2 5 3 5 6 1 
795 5 6 5 5 5 5 4 3 2 1 6 1 4 2 5 5 6 3 6 2 2 1 2 1 2 4 2 5 3 5 6 1 
795 5 6 5 5 5 5 4 3 2 1 6 1 4 2 5 5 6 3 6 2 2 1 2 1 2 4 2 5 3 5 6 1 
795 5 6 5 5 5 5 4 3 2 1 6 1 4 2 5 5 6 3 6 2 2 1 2 1 2 4 2 5 3 5 6 1 4 
795 5 6 5 5 5 5 4 3 2 1 6 1 4 2 5 5 6 3 6 2 2 1 2 1 2 4 2 5 3 5 6 1 4 
795 5 6 5 5 5 5 4 3 2 1 6 1 4 2 5 5 6 3 6 2 2 1 2 1 2 4 2 5 3 5 6 1 4 
795 5 6 5 5 5 5 4 3 2 1 6 1 4 2 5 5 6 3 6 2 2 1 2 1 2 4 2 5 3 5 6 1 4 
795 5 6 5 5 5 5 4 3 2 1 6 1 4 2 5 5 6 3 6 2 2 1 2 1 2 4 2 5 3 5 6 
795 5 6 5 5 5 5 4 3 2 1 6 1 4 2 5 5 6 3 6 2 2 1 2 1 2 4 2 5 3 5 6 1 
795 5 6 5 5 5 5 4 3 2 1 6 1 4 2 5 5 6 3 6 2 2 1 2 1 2 4 2 5 3 5 6 
795 5 6 5 5 5 5 4 3 2 1 6 1 4 2 5 5 6 3 6 2 2 1 2 1 2 4 2 5 3 5 6 
795 5 6 5 5 5 5 4 3 2 1 6 1 4 2 5 5 6 3 6 2 2 1 2 1 2 4 2 5 3 5 6 1 
795 5 6 5 5 5 5 4 3 2 1 6 1 4 2 5 5 6 3 6 2 2 1 2 1 2 4 2 5 3 5 6 
795 5 6 5 5 5 5 4 3 2 1 6 1 4 2 5 5 6 3 6 2 2 1 2 1 2 4 2 
795 5 6 5 5 5 5 4 3 2 1 6 1 4 2 5 5 6 3 6 2 2 1 2 1 1 2 
795 5 6 5 5 5 5 4 3 2 1 6 1 4 2 5 5 6 3 6 2 2 1 2 1 2 4 2 
795 5 6 5 5 5 5 4 3 2 1 6 1 4 2 5 5 6 3 6 2 2 1 2 1 2 4 2 
795 5 6 5 5 5 5 4 3 2 1 6 1 4 2 5 5 6 3 6 2 2 1 2 1 2 4 2 5 
795 5 6 5 5 5 5 4 3 2 1 6 1 4 2 5 5 6 3 6 2 2 1 2 1 2 4 
795 5 6 5 5 5 5 4 3 2 1 6 1 4 2 5 5 6 3 6 2 2 1 2 1 2 4 2 
795 5 6 5 5 5 5 4 3 2 1 6 1 4 2 5 5 6 3 6 2 2 1 2 1 2 4 2 5 
795 5 6 5 5 5 5 4 3 2 1 6 1 4 2 5 5 6 3 6 2 2 1 2 1 2 4 2 
795 5 6 5 5 5 5 4 3 2 1 6 1 4 2 5 5 6 3 6 2 2 1 2 1 2 4 2 5 
795 5 6 5 5 5 5 4 3 2 1 6 1 4 2 5 5 6 3 6 2 2 1 2 1 2 4 2 5 3 5 
795 5 6 5 5 5 5 4 3 2 1 6 1 4 2 5 5 6 3 6 2 2 1 2 1 2 4 2 5 
795 5 6 5 5 5 5 4 3 2 1 6 1 4 2 5 5 6 3 6 2 2 1 2 1 2 4 2 
795 5 6 5 5 5 5 4 3 2 1 6 1 4 2 5 5 6 3 6 2 2 1 2 1 2 4 2 5 
795 5 6 5 5 5 5 4 3 2 1 6 1 4 2 5 5 6 3 6 2 2 1 2 1 2 4 2 4 4 
795 5 6 5 5 5 5 4 3 2 1 6 1 4 2 5 5 6 3 6 2 2 1 2 1 2 4 2 5 
795 5 6 5 5 5 5 4 3 2 1 6 1 4 2 5 5 6 3 6 2 2 1 2 1 2 4 2 5 3 
795 5 6 5 5 5 5 4 3 2 1 6 1 4 2 5 5 6 3 6 2 2 1 2 1 2 4 2 5 
795 5 6 5 5 5 5 4 3 2 1 6 1 4 2 5 5 6 3 6 2 2 1 2 1 2 4 2 5 
795 5 6 5 5 5 5 4 3 2 1 6 1 4 2 5 5 6 3 6 2 2 1 2 1 2 4 2 5 
795 5 6 5 5 5 5 4 3 2 1 6 1 4 2 5 5 6 3 6 2 2 1 2 1 2 4 2 5 
795 5 6 5 5 5 5 4 3 2 1 6 1 4 2 5 5 6 3 6 2 2 1 2 1 2 4 2 5 4 
795 5 6 5 5 5 5 4 3 2 1 6 1 4 2 5 5 6 3 6 2 2 1 2 1 2 4 2 5 3 
795 5 6 5 5 5 5 4 3 2 1 6 1 4 2 5 5 6 3 6 2 2 1 2 1 2 4 2 
795 5 6 5 5 5 5 4 3 2 1 6 1 4 2 5 5 6 3 6 2 2 1 2 1 2 4 2 5 3 
795 5 6 5 5 5 5 4 3 2 1 6 1 4 2 5 5 6 3 6 2 2 1 2 1 2 4 2 5 4 
795 5 6 5 5 5 5 4 3 2 1 6 1 4 2 5 5 6 3 6 2 2 1 2 1 2 4 2 4 6 3 4 
795 5 6 5 5 5 5 4 3 2 1 6 1 4 2 5 5 6 3 6 2 2 1 2 1 2 4 2 5 3 5 
795 5 6 5 5 5 5 4 3 2 1 6 1 4 2 5 5 6 3 6 2 2 1 2 1 2 4 2 5 3 4 4 
795 5 6 5 5 5 5 4 3 2 1 6 1 4 2 5 5 6 3 6 2 2 1 2 1 2 4 2 5 3 4 4 6 
795 5 6 5 5 5 5 4 3 2 1 6 1 4 2 5 5 6 3 6 2 2 1 2 1 2 4 2 5 3 5 6 1 4 
795 5 6 5 5 5 5 4 3 2 1 6 1 4 2 5 5 6 3 6 2 2 1 2 1 2 4 2 5 3 5 6 1 4 
795 5 6 5 5 5 5 4 3 2 1 6 1 4 2 5 5 6 3 6 2 2 1 2 1 2 4 2 5 3 5 6 1 4 
795 5 6 5 5 5 5 4 3 2 1 6 1 4 2 5 5 6 3 6 2 2 1 2 1 2 1 
795 5 6 5 5 5 5 4 3 2 1 6 1 4 2 5 5 6 3 6 2 2 1 2 1 2 4 2 5 3 
795 5 6 5 5 5 5 4 3 2 1 6 1 4 2 5 5 6 3 6 2 2 1 2 1 2 4 2 5 
795 5 6 5 5 5 5 4 3 2 1 6 1 4 2 5 5 6 3 6 2 2 1 2 1 2 1 
795 5 6 5 5 5 5 4 3 2 1 6 1 4 2 5 5 6 3 6 2 2 1 2 1 2 1 
795 5 6 5 5 5 5 4 3 2 1 6 1 4 2 5 5 6 3 6 2 2 1 2 1 2 4 
795 5 6 5 5 5 5 4 3 2 1 6 1 4 2 5 5 6 3 6 2 2 1 2 1 2 4 
795 5 6 5 5 5 5 4 3 2 1 6 1 4 2 5 5 6 3 6 2 2 1 2 1 2 4 
795 5 6 5 5 5 5 4 3 2 1 6 1 4 2 5 5 6 3 6 2 2 1 2 1 2 4 
795 5 6 5 5 5 5 4 3 2 1 6 1 4 2 5 5 6 3 6 2 2 1 2 1 2 4 
795 5 6 5 5 5 5 4 3 2 1 6 1 4 2 5 5 6 3 6 2 2 1 2 1 2 4 2 5 
795 5 6 5 5 5 5 4 3 2 1 6 1 4 2 5 5 6 3 6 2 2 1 2 1 2 4 2 
795 5 6 5 5 5 5 4 3 2 1 6 1 4 2 5 5 6 3 6 2 2 1 2 1 2 4 2 
795 5 6 5 5 5 5 4 3 2 1 6 1 4 2 5 5 6 3 6 2 2 1 2 1 2 4 2 5 
795 5 6 5 5 5 5 4 3 2 1 6 1 4 2 5 5 6 3 6 2 2 1 2 1 2 4 2 5 
795 5 6 5 5 5 5 4 3 2 1 6 1 4 2 5 5 6 3 6 2 2 1 2 1 2 4 2 5 
795 5 6 5 5 5 5 4 3 2 1 6 1 4 2 5 5 6 3 6 2 2 1 2 1 2 4 
795 5 6 5 5 5 5 4 3 2 1 6 1 4 2 5 5 6 3 6 2 2 1 2 1 2 4 
795 5 6 5 5 5 5 4 3 2 1 6 1 4 2 5 5 6 3 6 2 2 1 2 1 2 4 2 
795 5 6 5 5 5 5 4 3 2 1 6 1 4 2 5 5 6 3 6 2 2 1 2 1 2 4 6 
795 5 6 5 5 5 5 4 3 2 1 6 1 4 2 5 5 6 3 6 2 2 1 2 1 2 4 2 5 
795 5 6 5 5 5 5 4 3 2 1 6 1 4 2 5 5 6 3 6 2 2 1 2 1 2 4 2 5 
795 5 6 5 5 5 5 4 3 2 1 6 1 4 2 5 5 6 3 6 2 2 1 2 1 2 4 2 5 3 
795 5 6 5 5 5 5 4 3 2 1 6 1 4 2 5 5 6 3 6 2 2 1 2 1 2 4 2 5 3 
795 5 6 5 5 5 5 4 3 2 1 6 1 4 2 5 5 6 3 6 2 2 1 2 1 2 4 2 5 
795 5 6 5 5 5 5 4 3 2 1 6 1 4 2 5 5 6 3 6 2 2 1 2 1 2 4 2 5 
795 5 6 5 5 5 5 4 3 2 1 6 1 4 2 5 5 6 3 6 2 2 1 2 1 2 4 2 5 
795 5 6 5 5 5 5 4 3 2 1 6 1 4 2 5 5 6 3 6 2 2 1 2 1 2 4 2 5 3 
795 5 6 5 5 5 5 4 3 2 1 6 1 4 2 5 5 6 3 6 2 2 1 2 1 2 4 2 5 3 
775 5 6 5 5 5 5 4 3 2 1 6 1 4 2 5 5 6 3 6 2 2 1 2 1 2 3 5 
