760 6 5 5 5 5 5 3 5 6 5 5 5 6 6 5 3 4 1 6 2 2 2 1 3 
680 6 5 5 5 5 5 3 5 6 5 2 5 6 4 5 6 5 3 3 3 1 2 2 6 
680 6 5 5 5 5 5 3 5 6 5 5 5 6 6 6 2 2 2 5 
640 6 5 5 5 5 5 3 5 6 5 5 5 6 6 3 5 2 1 3 1 6 
640 6 5 5 5 5 5 3 5 6 5 5 5 6 6 3 4 4 3 6 5 5 
630 6 5 5 5 5 5 3 5 6 5 5 5 6 6 3 6 1 3 4 6 4 
610 6 5 5 5 5 5 3 5 6 5 5 5 6 5 6 6 2 1 3 
610 6 5 5 5 5 5 3 5 6 5 5 5 6 6 6 6 6 
560 6 5 5 5 5 5 3 5 6 5 5 5 6 6 6 1 5 3 
490 6 5 5 5 5 5 3 5 6 5 5 5 6 6 4 2 
490 6 5 5 5 5 5 3 5 6 5 5 5 6 1 6 2 
490 6 5 5 5 5 5 3 5 6 5 5 5 6 6 4 2 
470 6 5 5 5 5 5 3 5 6 5 5 5 6 6 3 2 
470 6 5 5 5 5 5 3 5 6 5 5 5 6 1 3 6 1 
465 6 5 5 5 5 5 3 5 6 5 5 5 6 6 2 
465 6 5 5 5 5 5 3 5 6 5 5 5 6 6 2 
465 6 5 5 5 5 5 3 5 6 5 5 5 6 6 2 
460 6 5 5 5 5 5 3 5 6 5 1 6 6 4 3 6 1 
450 6 5 5 5 5 5 3 5 6 5 5 5 6 1 4 2 
445 6 5 5 5 5 5 3 5 6 5 5 5 6 6 3 1 
440 6 5 5 5 5 5 3 5 6 5 5 5 6 6 1 
440 6 5 5 5 5 5 3 5 6 5 5 5 6 6 1 
425 6 5 5 5 5 5 3 5 6 5 5 5 6 3 6 3 
425 6 5 5 5 5 5 3 5 6 5 5 5 6 1 2 
405 6 5 5 5 5 5 3 5 6 5 5 5 3 6 5 
405 6 5 5 5 5 5 3 5 6 5 5 5 6 4 3 4 
400 6 5 5 5 5 5 3 5 6 5 5 5 6 4 1 
400 6 5 5 5 5 5 3 5 6 5 5 5 6 2 
395 6 5 5 5 5 5 3 5 6 2 1 6 3 6 5 
385 6 5 5 5 5 5 3 5 6 3 6 6 5 6 
385 6 5 5 5 5 5 3 5 6 6 6 6 3 5 
335 6 5 5 5 5 5 3 5 6 5 5 5 5 
335 6 5 5 5 5 5 3 5 6 5 5 5 5 
335 6 5 5 5 5 5 3 5 6 5 5 5 5 
325 6 5 5 5 5 5 3 5 6 5 1 6 5 
315 6 5 5 5 5 5 3 5 6 1 2 3 4 4 5 
315 6 5 5 5 5 5 3 5 6 5 5 5 3 1 
315 6 5 5 5 5 5 3 5 6 5 5 5 3 4 
310 6 5 5 5 5 5 3 5 6 5 5 5 1 
310 6 5 5 5 5 5 3 5 6 5 5 5 1 
310 6 5 5 5 5 5 3 5 6 5 5 5 1 
305 6 5 5 5 5 5 3 5 6 5 5 3 6 
300 6 5 5 5 5 5 3 5 6 5 5 6 
300 6 5 5 5 5 5 3 5 6 5 5 6 
290 6 5 5 5 5 5 3 5 6 5 1 3 4 2 
285 6 5 5 5 5 5 3 5 6 5 5 2 
285 6 5 5 5 5 5 3 5 6 5 2 2 
285 6 5 5 5 5 5 3 5 6 5 1 4 2 
275 6 5 5 5 5 5 3 5 6 1 6 2 
265 6 5 5 5 5 5 3 5 6 2 5 3 1 
265 6 5 5 5 5 5 3 5 6 2 1 3 2 
260 6 5 5 5 5 5 3 5 6 5 2 4 
260 6 5 5 5 5 5 3 5 6 5 1 2 
260 6 5 5 5 5 5 3 5 6 5 5 1 
260 6 5 5 5 5 5 3 5 6 5 2 1 
260 6 5 5 5 5 5 3 5 6 5 4 2 
260 6 5 5 5 5 5 3 5 6 5 1 2 
260 6 5 5 5 5 5 3 5 6 5 1 2 
260 6 5 5 5 5 5 3 5 6 5 2 1 
255 6 5 5 5 5 5 3 5 6 3 2 6 
250 6 5 5 5 5 5 3 5 6 5 6 
250 6 5 5 5 5 5 3 5 6 3 3 1 3 5 1 
250 6 5 5 5 5 5 3 5 6 3 3 5 3 2 
250 6 5 5 5 5 5 3 5 6 5 6 
