140 4 2 5 5 5 5 5 2 6 
140 4 2 5 5 5 5 5 5 6 
125 4 2 5 5 5 5 5 2 2 
125 4 2 5 5 5 5 5 2 5 
125 4 2 5 5 5 5 5 5 2 
125 4 2 5 5 5 5 5 2 5 
125 4 2 5 5 5 5 5 5 5 
125 4 2 5 5 5 5 5 5 5 
125 4 2 5 5 5 5 5 2 5 
125 4 2 5 5 5 5 5 2 5 
115 4 2 5 5 5 5 5 1 6 
115 4 2 5 5 5 5 4 5 6 
115 4 2 5 5 5 5 5 4 6 
115 4 2 5 5 5 5 4 6 2 
100 4 2 5 5 5 5 5 2 4 
100 4 2 5 5 5 5 5 2 4 
100 4 2 5 5 5 5 5 2 4 
100 4 2 5 5 5 5 5 2 4 
100 4 2 5 5 5 5 5 2 1 
100 4 2 5 5 5 5 5 2 1 
100 4 2 5 5 5 5 5 2 1 
100 4 2 5 5 5 5 5 5 1 
100 4 2 5 5 5 5 5 5 4 
100 4 2 5 5 5 5 5 5 1 
100 4 2 5 5 5 5 4 5 5 
95 4 2 5 5 5 5 5 3 6 
95 4 2 5 5 5 5 5 3 6 
95 4 2 5 5 5 5 5 3 6 
90 4 2 5 5 5 5 5 6 
90 4 2 5 5 5 5 5 6 
80 4 2 5 5 5 5 5 3 5 4 
75 4 2 5 5 5 5 5 1 4 
75 4 2 5 5 5 5 5 4 4 1 
75 4 2 5 5 5 5 4 4 5 3 
75 4 2 5 5 5 5 5 4 1 2 
75 4 2 5 5 5 5 5 1 4 
55 4 2 5 5 5 5 5 3 1 4 
55 4 2 5 5 5 5 5 3 4 5 
55 4 2 5 5 5 5 5 4 3 4 
55 4 2 5 5 5 5 5 1 3 
50 4 2 5 5 5 5 3 3 6 5 
35 4 2 5 5 5 5 5 3 3 2 
25 4 2 5 5 5 5 2 
25 4 2 5 5 5 5 4 1 
25 4 2 5 5 5 5 2 
0 4 2 5 5 5 5 1 
0 4 2 5 5 5 5 1 
0 4 2 5 5 5 5 1 
