960 5 6 5 5 5 5 4 3 2 1 6 1 4 2 5 5 6 3 6 2 2 1 2 1 2 4 2 5 6 
950 5 6 5 5 5 5 4 3 2 1 6 1 4 2 5 5 6 3 6 2 2 1 2 1 2 6 5 6 
945 5 6 5 5 5 5 4 3 2 1 6 1 4 2 5 5 6 3 6 2 2 1 2 1 2 4 2 5 5 
945 5 6 5 5 5 5 4 3 2 1 6 1 4 2 5 5 6 3 6 2 2 1 2 1 2 4 2 5 2 
940 5 6 5 5 5 5 4 3 2 1 6 1 4 2 5 5 6 3 6 2 2 1 2 1 2 4 2 3 4 6 
940 5 6 5 5 5 5 4 3 2 1 6 1 4 2 5 5 6 3 6 2 2 1 2 1 2 4 2 3 4 6 
940 5 6 5 5 5 5 4 3 2 1 6 1 4 2 5 5 6 3 6 2 2 1 2 1 2 4 2 3 4 6 
940 5 6 5 5 5 5 4 3 2 1 6 1 4 2 5 5 6 3 6 2 2 1 2 1 2 4 2 3 4 6 
940 5 6 5 5 5 5 4 3 2 1 6 1 4 2 5 5 6 3 6 2 2 1 2 1 2 4 2 3 4 6 
930 5 6 5 5 5 5 4 3 2 1 6 1 4 2 5 5 6 3 6 2 2 1 2 1 2 3 4 6 6 
925 5 6 5 5 5 5 4 3 2 1 6 1 4 2 5 5 6 3 6 2 2 1 2 1 2 4 2 3 4 5 
925 5 6 5 5 5 5 4 3 2 1 6 1 4 2 5 5 6 3 6 2 2 1 2 1 2 4 2 3 4 5 
925 5 6 5 5 5 5 4 3 2 1 6 1 4 2 5 5 6 3 6 2 2 1 2 1 2 4 2 3 4 2 
925 5 6 5 5 5 5 4 3 2 1 6 1 4 2 5 5 6 3 6 2 2 1 2 1 2 4 2 3 4 5 
925 5 6 5 5 5 5 4 3 2 1 6 1 4 2 5 5 6 3 6 2 2 1 2 1 2 4 2 3 4 2 
925 5 6 5 5 5 5 4 3 2 1 6 1 4 2 5 5 6 3 6 2 2 1 2 1 2 4 2 3 4 2 
925 5 6 5 5 5 5 4 3 2 1 6 1 4 2 5 5 6 3 6 2 2 1 2 1 2 4 2 3 4 5 
925 5 6 5 5 5 5 4 3 2 1 6 1 4 2 5 5 6 3 6 2 2 1 2 1 2 4 2 3 4 5 
925 5 6 5 5 5 5 4 3 2 1 6 1 4 2 5 5 6 3 6 2 2 1 2 1 2 4 2 3 4 5 
925 5 6 5 5 5 5 4 3 2 1 6 1 4 2 5 5 6 3 6 2 2 1 2 1 2 4 2 3 4 2 
920 5 6 5 5 5 5 4 3 2 1 6 1 4 2 5 5 6 3 6 2 2 1 2 1 2 4 2 5 4 
920 5 6 5 5 5 5 4 3 2 1 6 1 4 2 5 5 6 3 6 2 2 1 2 1 2 1 2 5 1 
915 5 6 5 5 5 5 4 3 2 1 6 1 4 2 5 5 6 3 6 2 2 1 2 1 2 4 2 3 6 
915 5 6 5 5 5 5 4 3 2 1 6 1 4 2 5 5 6 3 6 2 2 1 2 1 2 4 2 3 6 
915 5 6 5 5 5 5 4 3 2 1 6 1 4 2 5 5 6 3 6 2 2 1 2 1 2 4 2 3 6 
910 5 6 5 5 5 5 4 3 2 1 6 1 4 2 5 5 6 3 6 2 2 1 2 1 2 4 2 6 
900 5 6 5 5 5 5 4 3 2 1 6 1 4 2 5 5 6 3 6 2 2 1 2 1 2 4 2 3 4 4 
900 5 6 5 5 5 5 4 3 2 1 6 1 4 2 5 5 6 3 6 2 2 1 2 1 2 4 2 3 2 
900 5 6 5 5 5 5 4 3 2 1 6 1 4 2 5 5 6 3 6 2 2 1 2 1 2 4 2 3 4 1 6 
900 5 6 5 5 5 5 4 3 2 1 6 1 4 2 5 5 6 3 6 2 2 1 2 1 2 4 2 3 4 1 3 
900 5 6 5 5 5 5 4 3 2 1 6 1 4 2 5 5 6 3 6 2 2 1 2 1 2 4 2 3 4 1 3 
900 5 6 5 5 5 5 4 3 2 1 6 1 4 2 5 5 6 3 6 2 2 1 2 1 2 4 2 3 2 
900 5 6 5 5 5 5 4 3 2 1 6 1 4 2 5 5 6 3 6 2 2 1 2 1 2 4 2 3 2 
900 5 6 5 5 5 5 4 3 2 1 6 1 4 2 5 5 6 3 6 2 2 1 2 1 2 4 2 3 4 4 
900 5 6 5 5 5 5 4 3 2 1 6 1 4 2 5 5 6 3 6 2 2 1 2 1 2 4 2 3 2 
900 5 6 5 5 5 5 4 3 2 1 6 1 4 2 5 5 6 3 6 2 2 1 2 1 2 4 2 3 5 
900 5 6 5 5 5 5 4 3 2 1 6 1 4 2 5 5 6 3 6 2 2 1 2 1 2 4 2 3 5 
900 5 6 5 5 5 5 4 3 2 1 6 1 4 2 5 5 6 3 6 2 2 1 2 1 2 4 2 3 5 
900 5 6 5 5 5 5 4 3 2 1 6 1 4 2 5 5 6 3 6 2 2 1 2 1 1 2 2 3 5 
895 5 6 5 5 5 5 4 3 2 1 6 1 4 2 5 5 6 3 6 2 2 1 2 1 2 4 2 2 
895 5 6 5 5 5 5 4 3 2 1 6 1 4 2 5 5 6 3 6 2 2 1 2 1 2 4 2 2 
895 5 6 5 5 5 5 4 3 2 1 6 1 4 2 5 5 6 3 6 2 2 1 2 1 2 4 2 2 
890 5 6 5 5 5 5 4 3 2 1 6 1 4 2 5 5 6 3 6 2 2 1 2 1 2 6 3 5 
885 5 6 5 5 5 5 4 3 2 1 6 1 4 2 5 5 6 3 6 2 2 1 2 1 2 6 2 
880 5 6 5 5 5 5 4 3 2 1 6 1 4 2 5 5 6 3 6 2 2 1 2 1 2 4 2 3 4 3 
875 5 6 5 5 5 5 4 3 2 1 6 1 4 2 5 5 6 3 6 2 2 1 2 1 2 4 2 3 1 
875 5 6 5 5 5 5 4 3 2 1 6 1 4 2 5 5 6 3 6 2 2 1 2 1 2 4 2 3 1 
875 5 6 5 5 5 5 4 3 2 1 6 1 4 2 5 5 6 3 6 2 2 1 2 1 2 4 5 3 1 
875 5 6 5 5 5 5 4 3 2 1 6 1 4 2 5 5 6 3 6 2 2 1 2 1 2 4 2 3 1 
875 5 6 5 5 5 5 4 3 2 1 6 1 4 2 5 5 6 3 6 2 2 1 2 1 2 4 2 3 1 
870 5 6 5 5 5 5 4 3 2 1 6 1 4 2 5 5 6 3 6 2 2 1 2 1 2 4 2 4 
870 5 6 5 5 5 5 4 3 2 1 6 1 4 2 5 5 6 3 6 2 2 1 2 1 2 4 2 4 
870 5 6 5 5 5 5 4 3 2 1 6 1 4 2 5 5 6 3 6 2 2 1 2 1 2 4 2 4 
870 5 6 5 5 5 5 4 3 2 1 6 1 4 2 5 5 6 3 6 2 2 1 2 1 2 4 2 4 
870 5 6 5 5 5 5 4 3 2 1 6 1 4 2 5 5 6 3 6 2 2 1 2 1 2 4 2 1 
870 5 6 5 5 5 5 4 3 2 1 6 1 4 2 5 5 6 3 6 2 2 1 2 1 2 4 2 1 
870 5 6 5 5 5 5 4 3 2 1 6 1 4 2 5 5 6 3 6 2 2 1 2 1 2 4 2 4 
870 5 6 5 5 5 5 4 3 2 1 6 1 4 2 5 5 6 3 6 2 2 1 2 1 2 4 2 4 
870 5 6 5 5 5 5 4 3 2 1 6 1 4 2 5 5 6 3 6 2 2 1 2 1 2 4 2 4 
870 5 6 5 5 5 5 4 3 2 1 6 1 4 2 5 5 6 3 6 2 2 1 2 1 2 4 2 1 
870 5 6 5 5 5 5 4 3 2 1 6 1 4 2 5 5 6 3 6 2 2 1 2 1 2 4 2 4 
870 5 6 5 5 5 5 4 3 2 1 6 1 4 2 5 5 6 3 6 2 2 1 2 1 2 4 2 1 
870 5 6 5 5 5 5 4 3 2 1 6 1 4 2 5 5 6 3 6 2 2 1 2 2 2 2 1 
870 5 6 5 5 5 5 4 3 2 1 6 1 4 2 5 5 6 3 6 2 2 1 2 1 2 4 2 1 
860 5 6 5 5 5 5 4 3 2 1 6 1 4 2 5 5 6 3 6 2 2 1 2 1 1 2 6 
860 5 6 5 5 5 5 4 3 2 1 6 1 4 2 5 5 6 3 6 2 2 1 2 1 2 1 6 
860 5 6 5 5 5 5 4 3 2 1 6 1 4 2 5 5 6 3 6 2 2 1 2 1 2 6 1 
855 5 6 5 5 5 5 4 3 2 1 6 1 4 2 5 5 6 3 6 2 2 1 2 1 2 4 2 3 3 
855 5 6 5 5 5 5 4 3 2 1 6 1 4 2 5 5 6 3 6 2 2 1 2 1 2 4 2 3 3 
855 5 6 5 5 5 5 4 3 2 1 6 1 4 2 5 5 6 3 6 2 2 1 2 1 2 4 2 3 3 
855 5 6 5 5 5 5 4 3 2 1 6 1 4 2 5 5 6 3 6 2 2 1 2 1 2 4 2 3 3 
855 5 6 5 5 5 5 4 3 2 1 6 1 4 2 5 5 6 3 6 2 2 1 2 1 2 4 2 3 3 
855 5 6 5 5 5 5 4 3 2 1 6 1 4 2 5 5 6 3 6 2 2 1 2 1 2 4 2 3 3 
855 5 6 5 5 5 5 4 3 2 1 6 1 4 2 5 5 6 3 6 2 2 1 2 1 2 4 2 3 3 
855 5 6 5 5 5 5 4 3 2 1 6 1 4 2 5 5 6 3 6 2 2 1 2 1 2 4 2 3 3 
855 5 6 5 5 5 5 4 3 2 1 6 1 4 2 5 5 6 3 6 2 2 1 2 1 2 3 5 3 4 
855 5 6 5 5 5 5 4 3 2 1 6 1 4 2 5 5 6 3 6 2 2 1 2 1 2 4 2 3 3 
855 5 6 5 5 5 5 4 3 2 1 6 1 4 2 5 5 6 3 6 2 2 1 2 2 2 3 2 3 
845 5 6 5 5 5 5 4 3 2 1 6 1 4 2 5 5 6 3 6 2 2 1 2 1 2 6 3 3 
820 5 6 5 5 5 5 4 3 2 1 6 1 4 2 5 5 6 3 6 2 2 1 2 1 2 2 
820 5 6 5 5 5 5 4 3 2 1 6 1 4 2 5 5 6 3 6 2 2 1 2 1 1 1 2 
820 5 6 5 5 5 5 4 3 2 1 6 1 4 2 5 5 6 3 6 2 2 1 2 1 2 1 4 
820 5 6 5 5 5 5 4 3 2 1 6 1 4 2 5 5 6 3 6 2 2 1 2 1 1 2 1 
820 5 6 5 5 5 5 4 3 2 1 6 1 4 2 5 5 6 3 6 2 2 1 2 2 1 5 
795 5 6 5 5 5 5 4 3 2 1 6 1 4 2 5 5 6 3 6 2 2 1 2 2 5 
795 5 6 5 5 5 5 4 3 2 1 6 1 4 2 5 5 6 3 6 2 2 1 2 2 5 
795 5 6 5 5 5 5 4 3 2 1 6 1 4 2 5 5 6 3 6 2 2 2 2 1 5 
785 5 6 5 5 5 5 4 3 2 1 6 1 4 2 5 5 6 3 6 2 2 1 2 1 6 
785 5 6 5 5 5 5 4 3 2 1 6 1 4 2 5 5 6 3 6 2 2 1 2 1 6 
785 5 6 5 5 5 5 4 3 2 1 6 1 4 2 5 5 6 3 6 2 2 1 2 1 6 
780 5 6 5 5 5 5 4 3 2 1 6 1 4 2 5 5 6 3 6 2 2 1 2 1 2 3 3 
770 5 6 5 5 5 5 4 3 2 1 6 1 4 2 5 5 6 3 6 2 2 1 2 1 5 
770 5 6 5 5 5 5 4 3 2 1 6 1 4 2 5 5 6 3 6 2 2 1 2 1 5 
770 5 6 5 5 5 5 4 3 2 1 6 1 4 2 5 5 6 3 6 2 2 2 1 1 5 
770 5 6 5 5 5 5 4 3 2 1 6 1 4 2 5 5 6 3 6 2 2 1 2 1 5 
760 5 6 5 5 5 5 4 3 2 1 6 1 4 2 5 5 6 3 6 2 2 1 2 6 
760 5 6 5 5 5 5 4 3 2 1 6 1 4 2 5 5 6 3 6 2 2 1 2 6 
760 5 6 5 5 5 5 4 3 2 1 6 1 4 2 5 5 6 3 6 2 2 1 2 6 
760 5 6 5 5 5 5 4 3 2 1 6 1 4 2 5 5 6 3 6 2 2 1 2 6 
750 5 6 5 5 5 5 4 3 2 1 6 1 4 2 5 5 6 3 6 2 2 1 2 2 3 
745 5 6 5 5 5 5 4 3 2 1 6 1 4 2 5 5 6 3 6 2 2 1 2 5 
745 5 6 5 5 5 5 4 3 2 1 6 1 4 2 5 5 6 3 6 2 2 1 2 5 
745 5 6 5 5 5 5 4 3 2 1 6 1 4 2 5 5 6 3 6 2 2 1 2 1 4 
745 5 6 5 5 5 5 4 3 2 1 6 1 4 2 5 5 6 3 6 2 2 1 2 5 
745 5 6 5 5 5 5 4 3 2 1 6 1 4 2 5 5 6 3 6 2 2 1 2 1 4 
745 5 6 5 5 5 5 4 3 2 1 6 1 4 2 5 5 6 3 6 2 2 1 2 5 
745 5 6 5 5 5 5 4 3 2 1 6 1 4 2 5 5 6 3 6 2 2 1 2 5 
735 5 6 5 5 5 5 4 3 2 1 6 1 4 2 5 5 6 3 6 2 2 2 6 
725 5 6 5 5 5 5 4 3 2 1 6 1 4 2 5 5 6 3 6 2 2 1 2 1 3 
725 5 6 5 5 5 5 4 3 2 1 6 1 4 2 5 5 6 3 6 2 2 1 2 1 3 
725 5 6 5 5 5 5 4 3 2 1 6 1 4 2 5 5 6 3 6 2 2 1 2 1 3 
720 5 6 5 5 5 5 4 3 2 1 6 1 4 2 5 5 6 3 6 2 2 2 5 
710 5 6 5 5 5 5 4 3 2 1 6 1 4 2 5 5 6 3 6 2 2 1 6 
710 5 6 5 5 5 5 4 3 2 1 6 1 4 2 5 5 6 3 6 2 2 1 6 
710 5 6 5 5 5 5 4 3 2 1 6 1 4 2 5 5 6 3 6 2 2 1 6 
700 5 6 5 5 5 5 4 3 2 1 6 1 4 2 5 5 6 3 6 2 2 1 2 3 
700 5 6 5 5 5 5 4 3 2 1 6 1 4 2 5 5 6 3 6 2 2 1 2 3 
700 5 6 5 5 5 5 4 3 2 1 6 1 4 2 5 5 6 3 6 2 2 1 2 3 
700 5 6 5 5 5 5 4 3 2 1 6 1 4 2 5 5 6 3 6 2 2 1 2 3 
700 5 6 5 5 5 5 4 3 2 1 6 1 4 2 5 5 6 3 6 2 2 1 1 1 3 
695 5 6 5 5 5 5 4 3 2 1 6 1 4 2 5 5 6 3 6 2 2 1 5 
695 5 6 5 5 5 5 4 3 2 1 6 1 4 2 5 5 6 3 6 2 2 1 5 
695 5 6 5 5 5 5 4 3 2 1 6 1 4 2 5 5 6 3 6 2 2 1 1 4 
685 5 6 5 5 5 5 4 3 2 1 6 1 4 2 5 5 6 3 6 2 2 6 
675 5 6 5 5 5 5 4 3 2 1 6 1 4 2 5 5 6 3 6 2 2 2 3 
670 5 6 5 5 5 5 4 3 2 1 6 1 4 2 5 5 6 3 6 2 2 1 4 
670 5 6 5 5 5 5 4 3 2 1 6 1 4 2 5 5 6 3 6 2 2 5 
670 5 6 5 5 5 5 4 3 2 1 6 1 4 2 5 5 6 3 6 2 1 2 4 
