750 4 1 6 5 5 5 5 5 6 1 6 5 6 5 6 5 4 2 1 2 2 5 
675 4 1 6 5 5 5 5 5 6 1 6 5 6 5 6 5 4 4 2 1 5 
665 4 1 6 5 5 5 5 5 6 1 6 5 6 5 6 5 4 2 1 6 
650 4 1 6 5 5 5 5 5 6 1 6 5 6 5 6 5 4 2 1 5 
640 4 1 6 5 5 5 5 5 6 1 6 5 6 5 6 5 4 2 6 
640 4 1 6 5 5 5 5 5 6 1 6 5 6 5 6 5 1 2 6 
640 4 1 6 5 5 5 5 5 6 1 6 5 6 5 6 5 4 5 6 
625 4 1 6 5 5 5 5 5 6 1 6 5 6 5 6 5 4 2 5 
615 4 1 6 5 5 5 5 5 6 1 6 5 6 5 6 5 2 6 
605 4 1 6 5 5 5 5 5 6 1 6 5 6 5 6 5 4 4 2 3 
605 4 1 6 5 5 6 4 4 6 2 2 6 6 4 4 6 6 4 1 5 
600 4 1 6 5 5 5 5 5 6 1 6 5 6 5 6 5 5 1 4 
600 4 1 6 5 5 6 4 4 6 2 3 1 1 3 5 3 5 1 3 6 6 3 3 3 6 1 1 5 
600 4 1 6 5 5 5 5 5 6 1 6 5 6 5 6 5 4 2 4 
600 4 1 6 5 5 5 5 5 6 1 6 5 6 5 6 5 5 5 
600 4 1 6 5 5 5 5 5 6 1 6 5 6 5 6 5 4 2 4 
595 4 1 6 5 5 6 4 4 6 2 2 6 3 5 1 3 5 3 6 6 6 
595 4 1 6 5 5 6 4 4 6 2 2 6 3 5 5 5 5 2 4 5 3 
580 4 1 6 5 5 6 4 4 6 2 2 6 3 5 3 4 4 6 1 4 1 6 3 
570 4 1 6 5 5 6 4 4 6 2 2 6 6 1 5 6 5 2 3 
410 4 1 6 5 5 6 4 4 6 2 2 6 3 5 1 3 6 
400 4 1 6 5 5 6 4 4 6 2 2 6 6 4 2 
385 4 1 6 5 5 6 4 4 6 2 2 6 3 6 3 2 
380 4 1 6 5 5 5 5 5 6 1 6 5 6 5 6 5 5 
380 4 1 6 5 5 5 5 5 6 1 6 5 6 5 6 5 4 2 
380 4 1 6 5 5 5 5 5 6 1 6 5 6 5 6 5 4 2 5 
380 4 1 6 5 5 5 5 5 6 1 6 5 6 5 6 5 5 
380 4 1 6 5 5 5 5 5 6 1 6 5 6 5 6 5 5 
380 4 1 6 5 5 5 5 5 6 1 6 5 6 5 6 5 4 4 
380 4 1 6 5 5 5 5 5 6 1 6 5 6 5 6 5 4 3 
380 4 1 6 5 5 5 5 5 6 1 6 5 6 5 6 5 4 1 
380 4 1 6 5 5 5 5 5 6 1 6 5 6 5 6 5 5 
380 4 1 6 5 5 5 5 5 6 1 6 5 6 5 6 5 4 2 1 
380 4 1 6 5 5 5 5 5 6 1 6 5 6 5 6 5 3 
380 4 1 6 5 5 5 5 5 6 1 6 5 6 5 6 5 4 5 
380 4 1 6 5 5 5 5 5 6 1 6 5 6 5 6 5 4 2 5 
380 4 1 6 5 5 5 5 5 6 1 6 5 6 5 6 5 1 
380 4 1 6 5 5 6 4 4 6 2 2 6 3 6 4 4 
380 4 1 6 5 5 6 4 4 6 2 2 6 3 6 5 
380 4 1 6 5 5 6 4 4 6 2 2 6 3 6 2 
380 4 1 6 5 5 6 4 4 6 2 2 6 6 3 5 
380 4 1 6 5 5 5 5 5 6 1 6 5 6 5 6 5 4 
380 4 1 6 5 5 5 5 5 6 1 6 5 6 5 6 5 4 5 
380 4 1 6 5 5 5 5 5 6 1 6 5 6 5 6 5 4 2 4 
380 4 1 6 5 5 5 5 5 6 1 6 5 6 5 6 5 4 4 
380 4 1 6 5 5 5 5 5 6 1 6 5 6 5 6 5 4 2 4 
375 4 1 6 5 5 6 4 4 6 2 2 6 3 5 3 3 5 
340 4 1 6 5 5 6 4 4 6 2 2 6 3 6 3 3 
315 4 1 6 5 5 6 4 4 6 2 2 6 3 2 
315 4 1 6 5 5 6 4 4 6 2 2 6 3 2 
315 4 1 6 5 5 6 4 4 6 2 3 1 4 6 2 
310 4 1 6 5 5 6 4 4 6 2 2 6 2 
305 4 1 6 5 5 6 4 4 6 2 1 1 3 5 3 5 
300 4 1 6 5 5 6 4 4 6 2 3 1 4 5 1 1 
290 4 1 6 5 5 6 4 4 6 2 3 4 4 6 4 
290 4 1 6 5 5 6 4 4 6 2 2 6 3 4 
290 4 1 6 5 5 6 4 4 6 2 2 6 3 4 
285 4 1 6 5 5 6 4 4 6 2 2 6 1 
285 4 1 6 5 5 6 4 4 6 2 2 4 6 
285 4 1 6 5 5 6 4 4 6 2 2 6 4 
285 4 1 6 5 5 6 4 4 6 2 2 6 4 
280 4 1 6 5 5 6 4 4 6 2 3 1 1 5 3 1 
270 4 1 6 5 5 6 4 4 6 2 1 1 4 2 
270 4 1 6 5 5 6 4 4 6 2 2 6 3 3 
