125 6 5 5 5 3 4 6 2 6 
125 6 5 5 5 3 4 6 2 6 
125 6 5 5 5 3 4 6 2 6 
125 6 5 5 5 3 4 6 2 6 
125 6 5 5 5 3 4 6 4 4 6 
125 6 5 5 5 3 4 6 4 1 6 
110 6 5 5 5 3 4 6 5 5 
110 6 5 5 5 3 4 6 2 2 
110 6 5 5 5 3 4 4 5 1 6 
110 6 5 5 5 3 4 5 6 2 
100 6 5 5 5 3 6 6 2 
100 6 5 5 5 3 4 6 4 6 
100 6 5 5 5 3 4 6 4 6 
95 6 5 5 5 6 2 6 
85 6 5 5 5 3 4 6 2 1 
85 6 5 5 5 3 4 6 2 4 
85 6 5 5 5 3 4 6 2 4 
85 6 5 5 5 3 4 6 1 2 
85 6 5 5 5 3 4 6 2 4 
85 6 5 5 5 3 4 6 4 5 
85 6 5 5 5 3 4 6 2 1 
85 6 5 5 5 3 4 6 2 4 
85 6 5 5 5 3 4 6 5 1 
85 6 5 5 5 3 4 6 2 4 
85 6 5 5 5 3 5 5 6 
75 6 5 5 5 3 4 3 5 4 5 
75 6 5 5 5 3 4 6 6 
70 6 5 5 5 3 4 5 5 4 
70 6 5 5 5 3 4 5 1 2 
65 6 5 5 5 3 4 6 3 2 
65 6 5 5 5 3 4 6 2 3 
65 6 5 5 5 3 4 6 3 2 
65 6 5 5 5 3 4 6 2 3 
65 6 5 5 5 3 4 6 2 3 
65 6 5 5 5 3 4 6 2 3 
60 6 5 5 5 3 4 6 1 1 
40 6 5 5 5 3 4 6 3 4 
40 6 5 5 5 3 4 4 6 3 
40 6 5 5 5 3 4 6 3 4 
40 6 5 5 5 3 4 6 3 1 
5 6 5 5 5 3 4 3 4 3 1 5 
0 6 5 5 5 3 4 5 3 
-5 6 5 5 5 3 4 2 
-30 6 5 5 5 3 4 1 
-30 6 5 5 5 3 4 1 
-30 6 5 5 5 3 4 1 
-30 6 5 5 5 3 2 
-30 6 5 5 5 3 4 1 
