810 5 6 5 5 5 5 5 2 6 2 2 1 2 5 6 6 4 4 1 2 
730 5 6 5 5 5 5 5 2 5 2 4 4 6 2 5 5 1 5 3 3 
720 5 6 5 5 5 5 5 2 6 3 5 6 2 2 3 1 6 3 5 4 
710 5 6 5 5 5 5 5 2 6 2 5 2 6 5 4 4 6 3 2 1 6 
635 5 6 5 5 5 5 5 2 5 1 5 2 3 6 
620 5 6 5 5 5 5 5 2 6 5 4 3 2 3 6 3 3 1 2 
580 5 6 5 5 5 5 5 2 1 5 6 3 4 3 5 1 5 3 2 
430 5 6 5 5 5 4 4 4 3 2 2 6 6 6 2 5 1 3 
370 5 6 5 5 5 5 5 2 3 5 5 5 1 5 4 2 
355 5 6 5 5 5 4 4 4 1 5 5 2 3 1 5 5 1 2 4 4 
315 5 6 5 5 5 5 5 2 5 4 1 2 2 
280 5 6 5 5 5 5 5 2 3 5 3 3 5 1 1 1 
280 5 6 5 5 5 5 5 2 6 1 2 1 
275 5 6 5 5 5 5 5 2 3 6 6 1 
275 5 6 5 5 5 4 4 4 1 2 6 3 4 6 
125 5 6 5 5 5 4 3 6 6 
115 5 6 5 5 5 4 4 2 2 
110 5 6 5 5 5 4 2 3 6 
90 5 6 5 5 5 4 4 4 5 
90 5 6 5 5 5 4 4 4 2 5 
90 5 6 5 5 5 4 4 4 2 5 
90 5 6 5 5 5 4 4 4 2 5 
90 5 6 5 5 5 4 4 4 5 
90 5 6 5 5 5 4 4 4 2 5 
90 5 6 5 5 5 4 4 4 2 5 
90 5 6 5 5 5 4 4 4 2 5 6 
90 5 6 5 5 5 4 4 1 2 
90 5 6 5 5 5 4 3 3 4 6 
90 5 6 5 5 5 4 4 4 2 5 
-110 5 6 5 5 5 5 5 2 6 
-110 5 6 5 5 5 4 4 4 2 3 4 2 5 
-110 5 6 5 5 5 5 5 2 6 
-110 5 6 5 5 5 5 5 2 6 
-110 5 6 5 5 5 4 4 4 2 3 4 2 5 1 5 
-110 5 6 5 5 5 5 5 2 
-110 5 6 5 5 5 5 5 2 6 2 
-110 5 6 5 5 5 5 5 2 6 2 
-110 5 6 5 5 5 5 5 2 6 
-110 5 6 5 5 5 5 5 2 6 2 
-110 5 6 5 5 5 4 4 4 2 3 4 2 5 1 
-115 5 6 5 5 5 5 5 2 6 1 
-115 5 6 5 5 5 5 5 2 6 1 
-115 5 6 5 5 5 5 5 2 6 2 1 
-115 5 6 5 5 5 5 5 2 6 2 5 3 
-115 5 6 5 5 5 4 4 4 2 3 4 2 5 1 
-115 5 6 5 5 5 5 5 2 6 3 
-115 5 6 5 5 5 4 4 4 2 3 4 2 5 4 
-160 5 6 5 5 5 4 4 4 2 3 4 2 3 4 
