940 4 1 6 5 5 5 5 5 6 1 6 5 6 5 6 5 4 2 1 2 2 2 2 6 4 2 
815 4 1 6 5 5 5 5 5 6 1 6 5 6 5 6 5 4 2 1 2 2 2 6 
800 4 1 6 5 5 5 5 5 6 1 6 5 6 5 6 5 4 2 1 2 2 1 1 5 
775 4 1 6 5 5 5 5 5 6 1 6 5 6 5 6 5 4 2 1 2 2 2 4 
775 4 1 6 5 5 5 5 5 6 1 6 5 6 5 6 5 4 2 1 2 2 2 4 
775 4 1 6 5 5 5 5 5 6 1 6 5 6 5 6 5 4 2 1 2 2 2 4 
765 4 1 6 5 5 5 5 5 6 1 6 5 6 5 6 5 4 2 1 2 2 6 
765 4 1 6 5 5 5 5 5 6 1 6 5 6 5 6 5 4 2 1 2 2 6 
765 4 1 6 5 5 5 5 5 6 1 6 5 6 5 6 5 4 2 1 2 2 6 
750 4 1 6 5 5 5 5 5 6 1 6 5 6 5 6 5 4 2 1 2 2 5 
750 4 1 6 5 5 5 5 5 6 1 6 5 6 5 6 5 4 2 1 2 2 5 
750 4 1 6 5 5 5 5 5 6 1 6 5 6 5 6 5 4 2 1 2 2 5 
740 4 1 6 5 5 5 5 5 6 1 6 5 6 5 6 5 4 2 1 2 1 6 
730 4 1 6 5 5 6 4 4 6 2 2 6 6 4 4 6 6 5 2 2 1 5 
725 4 1 6 5 5 5 5 5 6 1 6 5 6 5 6 5 4 2 1 2 2 4 
725 4 1 6 5 5 5 5 5 6 1 6 5 6 5 6 5 4 2 1 2 1 5 
715 4 1 6 5 5 5 5 5 6 1 6 5 6 5 6 5 4 2 1 2 6 
715 4 1 6 5 5 5 5 5 6 1 6 5 6 5 6 5 4 2 1 2 6 
715 4 1 6 5 5 5 5 5 6 1 6 5 6 5 6 5 4 2 1 2 6 
715 4 1 6 5 5 5 5 5 6 1 6 5 6 5 6 5 4 2 1 2 6 
715 4 1 6 5 5 5 5 5 6 1 6 5 6 5 6 5 4 2 1 2 6 
705 4 1 6 5 5 5 5 5 6 1 6 5 6 5 6 5 4 2 1 2 2 3 
700 4 1 6 5 5 5 5 5 6 1 6 5 6 5 6 5 4 2 1 2 5 
675 4 1 6 5 5 5 5 5 6 1 6 5 6 5 6 5 4 2 1 2 4 
675 4 1 6 5 5 5 5 5 6 1 6 5 6 5 6 5 4 1 2 1 5 
675 4 1 6 5 5 5 5 5 6 1 6 5 6 5 6 5 4 2 1 2 4 
665 4 1 6 5 5 5 5 5 6 1 6 5 6 5 6 5 4 2 1 6 
665 4 1 6 5 5 5 5 5 6 1 6 5 6 5 6 5 4 2 1 6 
665 4 1 6 5 5 5 5 5 6 1 6 5 6 5 6 5 4 2 1 6 
655 4 1 6 5 5 5 5 5 6 1 6 5 6 5 6 5 4 2 1 1 1 3 
655 4 1 6 5 5 5 5 5 6 1 6 5 6 5 6 5 2 2 1 1 3 
655 4 1 6 5 5 5 5 5 6 1 6 5 6 5 6 5 4 2 1 2 3 
650 4 1 6 5 5 5 5 5 6 1 6 5 6 5 6 5 2 2 5 
640 4 1 6 5 5 5 5 5 6 1 6 5 6 5 6 5 4 6 5 
640 4 1 6 5 5 5 5 5 6 1 6 5 6 5 6 5 4 2 6 
630 4 1 6 5 5 5 5 5 6 1 6 5 6 5 6 2 6 6 
625 4 1 6 5 5 5 5 5 6 1 6 5 6 5 6 5 4 2 5 
625 4 1 6 5 5 5 5 5 6 1 6 5 6 5 6 5 4 2 1 4 
625 4 1 6 5 5 5 5 5 6 1 6 5 6 5 6 5 4 2 1 4 
625 4 1 6 5 5 5 5 5 6 1 6 5 6 5 6 5 4 2 1 4 
625 4 1 6 5 5 6 4 4 6 2 3 1 1 3 5 3 5 1 3 6 6 3 3 3 6 1 1 1 5 
625 4 1 6 5 5 5 5 5 6 1 6 5 6 5 6 5 4 2 1 4 
620 4 1 6 5 5 6 4 4 6 2 2 6 3 5 5 5 5 2 4 5 1 3 
610 4 1 6 5 5 6 4 4 6 2 2 6 3 5 1 3 5 3 6 1 3 6 5 
610 4 1 6 5 5 6 4 4 6 2 2 6 6 1 5 6 3 4 2 6 
600 4 1 6 5 5 5 5 5 6 1 6 5 6 5 6 5 4 4 5 
600 4 1 6 5 5 5 5 5 6 1 6 5 6 5 6 5 4 1 5 
600 4 1 6 5 5 5 5 5 6 1 6 5 6 5 6 5 1 1 5 
590 4 1 6 5 5 5 5 5 6 1 6 5 6 5 6 5 6 4 
585 4 1 6 5 5 5 5 5 6 1 6 5 6 5 6 5 4 3 3 5 
580 4 1 6 5 5 5 5 5 6 1 6 5 6 5 6 5 4 2 3 
580 4 1 6 5 5 5 5 5 6 1 6 5 6 5 6 5 5 1 3 
575 4 1 6 5 5 5 5 5 6 1 6 5 6 5 6 5 4 4 4 
575 4 1 6 5 5 5 5 5 6 1 6 5 6 5 6 5 5 4 
575 4 1 6 5 5 5 5 5 6 1 6 5 6 5 6 5 2 4 
570 4 1 6 5 5 6 4 4 6 2 2 6 3 5 3 4 4 6 1 4 3 1 5 3 
560 4 1 6 5 5 5 5 5 6 1 6 5 6 5 6 1 4 3 5 3 
405 4 1 6 5 5 6 4 4 6 2 2 6 3 6 4 2 
380 4 1 6 5 5 6 4 4 6 2 2 6 6 3 2 
380 4 1 6 5 5 6 4 4 6 2 2 6 3 6 5 
370 4 1 6 5 5 6 4 4 6 2 2 6 3 5 1 3 1 
315 4 1 6 5 5 6 4 4 6 2 2 6 3 2 
290 4 1 6 5 5 6 4 4 6 2 2 6 3 4 
285 4 1 6 5 5 6 4 4 6 2 2 6 4 
