1065 5 6 5 5 5 5 4 3 2 1 6 1 4 2 5 5 6 3 6 2 2 1 2 1 2 4 2 5 3 5 6 1 4 4 
1065 5 6 5 5 5 5 4 3 2 1 6 1 4 2 5 5 6 3 6 2 2 1 2 1 2 4 2 5 3 4 4 6 5 
1050 5 6 5 5 5 5 4 3 2 1 6 1 4 2 5 5 6 3 6 2 2 1 2 1 2 4 2 5 3 4 4 5 5 
1025 5 6 5 5 5 5 4 3 2 1 6 1 4 2 5 5 6 3 6 2 2 1 2 1 2 4 2 5 3 5 1 5 
1020 5 6 5 5 5 5 4 3 2 1 6 1 4 2 5 5 6 3 6 2 2 1 2 1 2 4 2 4 6 3 4 3 2 5 
1000 5 6 5 5 5 5 4 3 2 1 6 1 4 2 5 5 6 3 6 2 2 1 2 1 2 4 2 5 4 3 4 2 
1000 5 6 5 5 5 5 4 3 2 1 6 1 4 2 5 5 6 3 6 2 2 1 2 1 2 4 2 5 3 5 2 
985 5 6 5 5 5 5 4 3 2 1 6 1 4 2 5 5 6 3 6 2 2 1 2 1 2 4 2 5 4 6 
975 5 6 5 5 5 5 4 3 2 1 6 1 4 2 5 5 6 3 6 2 2 1 2 1 2 4 2 5 3 4 2 
970 5 6 5 5 5 5 4 3 2 1 6 1 4 2 5 5 6 3 6 2 2 1 2 1 2 4 2 5 4 2 
965 5 6 5 5 5 5 4 3 2 1 6 1 4 2 5 5 6 3 6 2 2 1 2 1 2 4 2 5 3 6 
965 5 6 5 5 5 5 4 3 2 1 6 1 4 2 5 5 6 3 6 2 2 1 2 1 2 4 2 5 3 6 
965 5 6 5 5 5 5 4 3 2 1 6 1 4 2 5 5 6 3 6 2 2 1 2 1 2 4 2 5 3 6 
965 5 6 5 5 5 5 4 3 2 1 6 1 4 2 5 5 6 3 6 2 2 1 2 1 2 4 2 5 3 6 
965 5 6 5 5 5 5 4 3 2 1 6 1 4 2 5 5 6 3 6 2 2 1 2 1 2 4 2 5 3 6 
965 5 6 5 5 5 5 4 3 2 1 6 1 4 2 5 5 6 3 6 2 2 1 2 1 2 4 2 5 3 6 
960 5 6 5 5 5 5 4 3 2 1 6 1 4 2 5 5 6 3 6 2 2 1 2 1 2 4 2 4 4 6 
960 5 6 5 5 5 5 4 3 2 1 6 1 4 2 5 5 6 3 6 2 2 1 2 1 2 4 2 5 6 
960 5 6 5 5 5 5 4 3 2 1 6 1 4 2 5 5 6 3 6 2 2 1 2 1 2 4 2 5 6 
960 5 6 5 5 5 5 4 3 2 1 6 1 4 2 5 5 6 3 6 2 2 1 2 1 2 4 2 5 6 
955 5 6 5 5 5 5 4 3 2 1 6 1 4 2 5 5 6 3 6 2 2 1 2 1 2 4 2 5 3 5 3 
950 5 6 5 5 5 5 4 3 2 1 6 1 4 2 5 5 6 3 6 2 2 1 2 1 2 4 2 5 3 2 
950 5 6 5 5 5 5 4 3 2 1 6 1 4 2 5 5 6 3 6 2 2 1 2 1 2 4 2 5 3 2 
950 5 6 5 5 5 5 4 3 2 1 6 1 4 2 5 5 6 3 6 2 2 1 2 1 2 4 2 5 3 2 
945 5 6 5 5 5 5 4 3 2 1 6 1 4 2 5 5 6 3 6 2 2 1 2 1 2 4 2 5 5 
945 5 6 5 5 5 5 4 3 2 1 6 1 4 2 5 5 6 3 6 2 2 1 2 1 2 4 2 5 2 
945 5 6 5 5 5 5 4 3 2 1 6 1 4 2 5 5 6 3 6 2 2 1 2 1 2 4 2 5 2 
945 5 6 5 5 5 5 4 3 2 1 6 1 4 2 5 5 6 3 6 2 2 1 2 1 2 4 2 5 5 
945 5 6 5 5 5 5 4 3 2 1 6 1 4 2 5 5 6 3 6 2 2 1 2 1 2 4 2 5 2 
945 5 6 5 5 5 5 4 3 2 1 6 1 4 2 5 5 6 3 6 2 2 1 2 1 2 4 2 5 2 
945 5 6 5 5 5 5 4 3 2 1 6 1 4 2 5 5 6 3 6 2 2 1 2 1 2 4 2 5 2 
945 5 6 5 5 5 5 4 3 2 1 6 1 4 2 5 5 6 3 6 2 2 1 2 1 1 2 2 5 5 
945 5 6 5 5 5 5 4 3 2 1 6 1 4 2 5 5 6 3 6 2 2 1 2 1 2 4 2 5 5 
945 5 6 5 5 5 5 4 3 2 1 6 1 4 2 5 5 6 3 6 2 2 1 2 1 2 4 2 5 2 
945 5 6 5 5 5 5 4 3 2 1 6 1 4 2 5 5 6 3 6 2 2 1 2 1 2 4 2 5 2 
945 5 6 5 5 5 5 4 3 2 1 6 1 4 2 5 5 6 3 6 2 2 1 2 1 2 4 2 5 2 
945 5 6 5 5 5 5 4 3 2 1 6 1 4 2 5 5 6 3 6 2 2 1 2 1 2 4 2 5 2 
935 5 6 5 5 5 5 4 3 2 1 6 1 4 2 5 5 6 3 6 2 2 1 2 1 2 4 6 4 2 
930 5 6 5 5 5 5 4 3 2 1 6 1 4 2 5 5 6 3 6 2 2 1 2 1 2 4 2 5 3 4 3 
930 5 6 5 5 5 5 4 3 2 1 6 1 4 2 5 5 6 3 6 2 2 1 2 1 2 4 2 5 4 3 3 
930 5 6 5 5 5 5 4 3 2 1 6 1 4 2 5 5 6 3 6 2 2 1 2 1 2 4 2 5 4 3 3 
925 5 6 5 5 5 5 4 3 2 1 6 1 4 2 5 5 6 3 6 2 2 1 2 1 2 4 2 5 3 1 
925 5 6 5 5 5 5 4 3 2 1 6 1 4 2 5 5 6 3 6 2 2 1 2 1 2 4 2 5 3 1 
925 5 6 5 5 5 5 4 3 2 1 6 1 4 2 5 5 6 3 6 2 2 1 2 1 2 4 2 5 3 1 
925 5 6 5 5 5 5 4 3 2 1 6 1 4 2 5 5 6 3 6 2 2 1 2 1 2 4 2 5 3 1 
925 5 6 5 5 5 5 4 3 2 1 6 1 4 2 5 5 6 3 6 2 2 1 2 1 2 4 2 5 3 1 
925 5 6 5 5 5 5 4 3 2 1 6 1 4 2 5 5 6 3 6 2 2 1 2 1 2 4 2 5 3 1 
920 5 6 5 5 5 5 4 3 2 1 6 1 4 2 5 5 6 3 6 2 2 1 2 1 2 4 2 5 1 
920 5 6 5 5 5 5 4 3 2 1 6 1 4 2 5 5 6 3 6 2 2 1 2 1 2 4 2 5 1 
920 5 6 5 5 5 5 4 3 2 1 6 1 4 2 5 5 6 3 6 2 2 1 2 1 2 4 2 5 1 
920 5 6 5 5 5 5 4 3 2 1 6 1 4 2 5 5 6 3 6 2 2 1 2 1 2 4 2 5 1 
920 5 6 5 5 5 5 4 3 2 1 6 1 4 2 5 5 6 3 6 2 2 1 2 1 2 4 2 5 1 
910 5 6 5 5 5 5 4 3 2 1 6 1 4 2 5 5 6 3 6 2 2 1 2 1 2 4 2 6 
910 5 6 5 5 5 5 4 3 2 1 6 1 4 2 5 5 6 3 6 2 2 1 2 1 2 4 2 6 
910 5 6 5 5 5 5 4 3 2 1 6 1 4 2 5 5 6 3 6 2 2 1 2 1 2 4 2 6 
910 5 6 5 5 5 5 4 3 2 1 6 1 4 2 5 5 6 3 6 2 2 1 2 1 2 4 2 6 
910 5 6 5 5 5 5 4 3 2 1 6 1 4 2 5 5 6 3 6 2 2 1 2 1 2 4 2 6 
910 5 6 5 5 5 5 4 3 2 1 6 1 4 2 5 5 6 3 6 2 2 1 2 1 2 1 6 5 
910 5 6 5 5 5 5 4 3 2 1 6 1 4 2 5 5 6 3 6 2 2 1 2 1 2 4 2 6 
905 5 6 5 5 5 5 4 3 2 1 6 1 4 2 5 5 6 3 6 2 2 1 2 1 2 4 2 5 3 3 
905 5 6 5 5 5 5 4 3 2 1 6 1 4 2 5 5 6 3 6 2 2 1 2 1 2 4 2 5 3 3 
895 5 6 5 5 5 5 4 3 2 1 6 1 4 2 5 5 6 3 6 2 2 1 2 1 2 4 2 2 
895 5 6 5 5 5 5 4 3 2 1 6 1 4 2 5 5 6 3 6 2 2 1 2 1 2 4 2 2 
895 5 6 5 5 5 5 4 3 2 1 6 1 4 2 5 5 6 3 6 2 2 1 2 1 2 4 2 2 
895 5 6 5 5 5 5 4 3 2 1 6 1 4 2 5 5 6 3 6 2 2 1 2 1 2 4 5 2 
895 5 6 5 5 5 5 4 3 2 1 6 1 4 2 5 5 6 3 6 2 2 1 2 1 2 4 2 2 
895 5 6 5 5 5 5 4 3 2 1 6 1 4 2 5 5 6 3 6 2 2 1 2 1 2 4 2 2 
895 5 6 5 5 5 5 4 3 2 1 6 1 4 2 5 5 6 3 6 2 2 1 2 1 2 4 5 2 
895 5 6 5 5 5 5 4 3 2 1 6 1 4 2 5 5 6 3 6 2 2 1 2 1 2 4 2 2 
895 5 6 5 5 5 5 4 3 2 1 6 1 4 2 5 5 6 3 6 2 2 1 2 1 2 4 5 2 
870 5 6 5 5 5 5 4 3 2 1 6 1 4 2 5 5 6 3 6 2 2 1 2 1 2 4 2 1 
870 5 6 5 5 5 5 4 3 2 1 6 1 4 2 5 5 6 3 6 2 2 1 2 1 2 4 2 1 
870 5 6 5 5 5 5 4 3 2 1 6 1 4 2 5 5 6 3 6 2 2 1 2 1 2 4 2 1 
870 5 6 5 5 5 5 4 3 2 1 6 1 4 2 5 5 6 3 6 2 2 1 2 1 2 4 2 1 
870 5 6 5 5 5 5 4 3 2 1 6 1 4 2 5 5 6 3 6 2 2 1 2 1 2 4 2 1 
870 5 6 5 5 5 5 4 3 2 1 6 1 4 2 5 5 6 3 6 2 2 1 2 1 2 4 2 1 
870 5 6 5 5 5 5 4 3 2 1 6 1 4 2 5 5 6 3 6 2 2 1 2 1 2 4 2 1 
870 5 6 5 5 5 5 4 3 2 1 6 1 4 2 5 5 6 3 6 2 2 1 2 1 2 4 2 1 
870 5 6 5 5 5 5 4 3 2 1 6 1 4 2 5 5 6 3 6 2 2 1 2 1 2 4 2 1 
850 5 6 5 5 5 5 4 3 2 1 6 1 4 2 5 5 6 3 6 2 2 1 2 1 2 4 2 3 
850 5 6 5 5 5 5 4 3 2 1 6 1 4 2 5 5 6 3 6 2 2 1 2 1 2 4 2 3 4 1 
850 5 6 5 5 5 5 4 3 2 1 6 1 4 2 5 5 6 3 6 2 2 1 2 1 2 4 2 3 4 
850 5 6 5 5 5 5 4 3 2 1 6 1 4 2 5 5 6 3 6 2 2 1 2 1 2 4 3 5 
850 5 6 5 5 5 5 4 3 2 1 6 1 4 2 5 5 6 3 6 2 2 1 2 1 2 4 2 3 
850 5 6 5 5 5 5 4 3 2 1 6 1 4 2 5 5 6 3 6 2 2 1 2 1 2 4 2 3 
850 5 6 5 5 5 5 4 3 2 1 6 1 4 2 5 5 6 3 6 2 2 1 2 1 2 4 2 3 
850 5 6 5 5 5 5 4 3 2 1 6 1 4 2 5 5 6 3 6 2 2 1 2 1 2 4 2 3 4 
820 5 6 5 5 5 5 4 3 2 1 6 1 4 2 5 5 6 3 6 2 2 1 2 1 2 4 1 
820 5 6 5 5 5 5 4 3 2 1 6 1 4 2 5 5 6 3 6 2 2 1 2 1 2 4 4 
820 5 6 5 5 5 5 4 3 2 1 6 1 4 2 5 5 6 3 6 2 2 1 2 1 2 4 4 
820 5 6 5 5 5 5 4 3 2 1 6 1 4 2 5 5 6 3 6 2 2 1 2 1 2 4 4 
805 5 6 5 5 5 5 4 3 2 1 6 1 4 2 5 5 6 3 6 2 2 1 2 1 2 3 4 3 
455 5 6 5 5 5 5 4 3 2 1 6 1 4 2 5 5 6 3 6 2 2 1 2 1 2 4 2 5 3 
455 5 6 5 5 5 5 4 3 2 1 6 1 4 2 5 5 6 3 6 2 2 1 2 1 2 4 2 
455 5 6 5 5 5 5 4 3 2 1 6 1 4 2 5 5 6 3 6 2 2 1 2 1 2 4 2 5 
455 5 6 5 5 5 5 4 3 2 1 6 1 4 2 5 5 6 3 6 2 2 1 2 1 2 4 2 
455 5 6 5 5 5 5 4 3 2 1 6 1 4 2 5 5 6 3 6 2 2 1 2 1 2 4 
455 5 6 5 5 5 5 4 3 2 1 6 1 4 2 5 5 6 3 6 2 2 1 2 1 2 4 2 5 
455 5 6 5 5 5 5 4 3 2 1 6 1 4 2 5 5 6 3 6 2 2 1 2 1 2 4 2 5 
455 5 6 5 5 5 5 4 3 2 1 6 1 4 2 5 5 6 3 6 2 2 1 2 1 2 4 
455 5 6 5 5 5 5 4 3 2 1 6 1 4 2 5 5 6 3 6 2 2 1 2 1 2 3 6 4 
455 5 6 5 5 5 5 4 3 2 1 6 1 4 2 5 5 6 3 6 2 2 1 2 1 2 4 2 5 
455 5 6 5 5 5 5 4 3 2 1 6 1 4 2 5 5 6 3 6 2 2 1 2 1 2 4 
455 5 6 5 5 5 5 4 3 2 1 6 1 4 2 5 5 6 3 6 2 2 1 2 1 2 4 2 
455 5 6 5 5 5 5 4 3 2 1 6 1 4 2 5 5 6 3 6 2 2 1 2 1 2 4 2 5 
455 5 6 5 5 5 5 4 3 2 1 6 1 4 2 5 5 6 3 6 2 2 1 2 1 2 4 2 5 
455 5 6 5 5 5 5 4 3 2 1 6 1 4 2 5 5 6 3 6 2 2 1 2 1 2 4 2 5 
455 5 6 5 5 5 5 4 3 2 1 6 1 4 2 5 5 6 3 6 2 2 1 2 1 2 4 2 
455 5 6 5 5 5 5 4 3 2 1 6 1 4 2 5 5 6 3 6 2 2 1 2 1 2 4 2 5 
455 5 6 5 5 5 5 4 3 2 1 6 1 4 2 5 5 6 3 6 2 2 1 2 1 2 4 2 
455 5 6 5 5 5 5 4 3 2 1 6 1 4 2 5 5 6 3 6 2 2 1 2 1 2 4 2 
455 5 6 5 5 5 5 4 3 2 1 6 1 4 2 5 5 6 3 6 2 2 1 2 1 2 4 
455 5 6 5 5 5 5 4 3 2 1 6 1 4 2 5 5 6 3 6 2 2 1 2 1 2 4 
455 5 6 5 5 5 5 4 3 2 1 6 1 4 2 5 5 6 3 6 2 2 1 2 1 2 4 
455 5 6 5 5 5 5 4 3 2 1 6 1 4 2 5 5 6 3 6 2 2 1 2 1 2 4 2 5 
455 5 6 5 5 5 5 4 3 2 1 6 1 4 2 5 5 6 3 6 2 2 1 2 1 2 4 
455 5 6 5 5 5 5 4 3 2 1 6 1 4 2 5 5 6 3 6 2 2 1 2 1 2 4 2 5 
455 5 6 5 5 5 5 4 3 2 1 6 1 4 2 5 5 6 3 6 2 2 1 2 1 2 4 
455 5 6 5 5 5 5 4 3 2 1 6 1 4 2 5 5 6 3 6 2 2 1 2 1 2 4 
455 5 6 5 5 5 5 4 3 2 1 6 1 4 2 5 5 6 3 6 2 2 1 2 1 2 4 
455 5 6 5 5 5 5 4 3 2 1 6 1 4 2 5 5 6 3 6 2 2 1 2 1 2 4 2 5 
455 5 6 5 5 5 5 4 3 2 1 6 1 4 2 5 5 6 3 6 2 2 1 2 1 2 4 
455 5 6 5 5 5 5 4 3 2 1 6 1 4 2 5 5 6 3 6 2 2 1 2 1 2 4 2 5 
455 5 6 5 5 5 5 4 3 2 1 6 1 4 2 5 5 6 3 6 2 2 1 2 1 2 4 2 
455 5 6 5 5 5 5 4 3 2 1 6 1 4 2 5 5 6 3 6 2 2 1 2 1 2 4 2 
455 5 6 5 5 5 5 4 3 2 1 6 1 4 2 5 5 6 3 6 2 2 1 2 1 2 4 2 3 4 1 
455 5 6 5 5 5 5 4 3 2 1 6 1 4 2 5 5 6 3 6 2 2 1 2 1 2 4 2 5 
455 5 6 5 5 5 5 4 3 2 1 6 1 4 2 5 5 6 3 6 2 2 1 2 1 2 4 2 3 4 1 4 
