135 6 5 5 5 3 5 5 2 6 
130 6 5 5 5 5 5 2 6 
130 6 5 5 5 5 5 2 6 
115 6 5 5 5 5 5 2 2 
115 6 5 5 5 5 5 2 2 
115 6 5 5 5 5 5 2 5 
115 6 5 5 5 5 5 2 5 
115 6 5 5 5 5 5 2 5 
115 6 5 5 5 5 5 2 2 
115 6 5 5 5 5 5 2 2 
115 6 5 5 5 5 5 2 2 
115 6 5 5 5 5 5 2 5 
115 6 5 5 5 5 5 2 5 
105 6 5 5 5 5 5 1 6 
90 6 5 5 5 5 5 1 5 
90 6 5 5 5 5 5 2 1 
90 6 5 5 5 5 5 2 4 
90 6 5 5 5 5 5 4 2 
90 6 5 5 5 5 5 5 1 
90 6 5 5 5 5 5 2 1 
90 6 5 5 5 5 5 1 5 
80 6 5 5 5 5 6 5 
80 6 5 5 5 5 6 2 
80 6 5 5 5 5 5 6 
70 6 5 5 5 5 5 2 3 
70 6 5 5 5 5 5 2 3 
70 6 5 5 5 5 5 2 3 
70 6 5 5 5 5 5 4 3 4 
55 6 5 5 5 5 6 1 
55 6 5 5 5 5 6 4 
50 6 5 5 5 6 6 3 
50 6 5 5 5 6 6 3 
45 6 5 5 5 5 4 3 1 4 2 
15 6 5 5 5 5 2 
-10 6 5 5 5 5 1 
-10 6 5 5 5 5 1 
-30 6 5 5 5 5 3 
-30 6 5 5 5 5 3 
-30 6 5 5 5 5 3 
-30 6 5 5 5 5 3 4 4 3 1 
-35 6 5 5 5 5 3 5 
-35 6 5 5 5 5 3 3 2 6 
-130 6 5 5 3 4 5 5 6 2 2 
-130 6 5 5 3 4 5 5 6 2 4 
-130 6 5 5 3 4 5 5 6 2 2 
-130 6 5 5 3 4 5 5 4 5 4 
-135 6 5 5 3 4 5 5 1 
-135 6 5 5 3 4 5 5 6 4 
-135 6 5 5 3 4 5 5 6 1 
-135 6 5 5 3 4 5 5 6 5 
-135 6 5 5 3 4 5 5 6 5 
-135 6 5 5 3 4 5 5 6 3 
-135 6 5 5 3 4 5 5 4 1 
-135 6 5 5 3 4 5 1 
-135 6 5 5 3 4 5 5 4 4 
-135 6 5 5 3 4 5 1 
-135 6 5 5 3 4 5 5 5 5 
-135 6 5 5 3 4 5 5 4 
-135 6 5 5 3 4 5 5 4 6 
-135 6 5 5 3 4 5 5 6 6 
-135 6 5 5 3 4 5 5 2 
-135 6 5 5 3 4 5 4 
-135 6 5 5 3 4 5 5 2 
-135 6 5 5 3 4 5 5 6 3 
