140 4 2 5 5 5 5 5 5 6 
140 4 2 5 5 5 5 5 2 6 
140 4 2 5 5 5 5 5 2 6 
140 4 2 5 5 5 5 5 5 6 
140 4 2 5 5 5 5 5 2 6 
130 4 2 5 5 5 5 5 3 5 5 
125 4 2 5 5 5 5 5 2 2 
125 4 2 5 5 5 5 5 4 1 2 
125 4 2 5 5 5 5 5 2 5 
125 4 2 5 5 5 5 5 2 2 
125 4 2 5 5 5 5 5 2 5 
125 4 2 5 5 5 5 5 2 2 
125 4 2 5 5 5 5 5 2 2 
115 4 2 5 5 5 5 5 1 6 
115 4 2 5 5 5 5 4 6 2 
105 4 2 5 5 5 5 5 3 1 2 
100 4 2 5 5 5 5 5 2 4 
100 4 2 5 5 5 5 5 1 2 
100 4 2 5 5 5 5 5 2 4 
100 4 2 5 5 5 5 5 2 4 
100 4 2 5 5 5 5 5 2 1 
100 4 2 5 5 5 5 4 5 2 
100 4 2 5 5 5 5 5 1 5 
100 4 2 5 5 5 5 5 2 4 
90 4 2 5 5 5 5 5 6 
90 4 2 5 5 5 5 5 6 
90 4 2 5 5 5 5 5 6 
90 4 2 5 5 5 5 5 6 
90 4 2 5 5 5 5 6 2 
85 4 2 5 5 5 5 5 3 3 5 
80 4 2 5 5 5 5 5 2 3 
75 4 2 5 5 5 5 5 1 1 
60 4 2 5 5 5 5 4 3 3 5 1 
55 4 2 5 5 5 5 5 1 3 
55 4 2 5 5 5 5 5 1 3 
55 4 2 5 5 5 5 5 1 3 
25 4 2 5 5 5 5 2 
25 4 2 5 5 5 5 2 
25 4 2 5 5 5 5 2 
25 4 2 5 5 5 5 2 
25 4 2 5 5 5 5 2 
25 4 2 5 5 5 5 2 
25 4 2 5 5 5 5 2 
0 4 2 5 5 5 5 1 
0 4 2 5 5 5 5 1 
-20 4 2 5 5 5 5 3 
-20 4 2 5 5 5 5 3 
-20 4 2 5 5 5 5 3 
