1095 4 4 6 5 5 6 4 5 5 1 2 1 3 5 3 6 4 5 6 4 6 1 2 1 2 1 1 4 2 6 3 6 4 5 5 
1040 4 4 6 5 5 6 4 5 5 1 2 1 3 5 3 6 4 5 6 4 6 1 2 1 2 1 1 4 2 6 6 1 4 4 
1040 4 4 6 5 5 6 4 5 5 1 2 1 3 5 3 6 4 5 6 4 6 1 2 1 2 1 1 4 2 6 6 4 2 
1035 4 4 6 5 5 6 4 5 5 1 2 1 3 5 3 6 4 5 6 4 6 1 2 1 2 1 1 4 2 6 3 6 6 
1035 4 4 6 5 5 6 4 5 5 1 2 1 3 5 3 6 4 5 6 4 6 1 2 1 2 1 1 4 2 6 3 5 3 4 2 
1025 4 4 6 5 5 6 4 5 5 1 2 1 3 5 3 6 4 5 6 4 6 1 2 1 2 1 1 4 2 6 3 6 4 3 1 1 
1020 4 4 6 5 5 6 4 5 5 1 2 1 3 5 3 6 4 5 6 4 6 1 2 1 2 1 1 4 2 6 3 6 2 
1020 4 4 6 5 5 6 4 5 5 1 2 1 3 5 3 6 4 5 6 4 6 1 2 1 2 1 1 4 2 6 3 6 2 
1020 4 4 6 5 5 6 4 5 5 1 2 1 3 5 3 6 4 5 6 4 6 1 2 1 2 1 1 4 2 6 3 6 5 
1020 4 4 6 5 5 6 4 5 5 1 2 1 3 5 3 6 4 5 6 4 6 1 2 1 2 1 1 4 2 6 3 6 2 
1020 4 4 6 5 5 6 4 5 5 1 2 1 3 5 3 6 4 5 6 4 6 1 2 1 2 1 1 4 2 6 3 6 4 1 
1020 4 4 6 5 5 6 4 5 5 1 2 1 3 5 3 6 4 5 6 4 6 1 2 1 2 1 1 4 2 6 3 6 5 
1005 4 4 6 5 5 6 4 5 5 1 2 1 3 5 3 6 4 5 6 4 6 1 2 1 2 1 1 4 2 6 3 5 1 1 
1000 4 4 6 5 5 6 4 5 5 1 2 1 3 5 3 6 4 5 6 4 6 1 2 1 2 1 1 4 2 6 2 2 
995 4 4 6 5 5 6 4 5 5 1 2 1 3 5 3 6 4 5 6 4 6 1 2 1 2 1 1 4 2 6 3 6 1 
990 4 4 6 5 5 6 4 5 5 1 2 1 3 5 3 6 4 5 6 4 6 1 2 1 2 1 1 4 2 6 1 6 
980 4 4 6 5 5 6 4 5 5 1 2 1 3 5 3 6 4 5 6 4 6 1 2 1 1 2 1 5 6 4 3 3 3 6 
975 4 4 6 5 5 6 4 5 5 1 2 1 3 5 3 6 4 5 6 4 6 1 2 1 2 1 1 4 2 6 4 2 
975 4 4 6 5 5 6 4 5 5 1 2 1 3 5 3 6 4 5 6 4 6 1 2 1 2 1 1 4 2 6 1 5 
975 4 4 6 5 5 6 4 5 5 1 2 1 3 5 3 6 4 5 6 4 6 1 2 1 2 1 1 4 2 6 3 6 3 
975 4 4 6 5 5 6 4 5 5 1 2 1 3 5 3 6 4 5 6 4 6 1 2 1 2 1 1 4 2 6 3 3 6 
930 4 4 6 5 5 6 4 5 5 1 2 1 3 5 3 6 4 5 6 4 6 1 2 1 2 1 1 4 2 6 3 1 
930 4 4 6 5 5 6 4 5 5 1 2 1 3 5 3 6 4 5 6 4 6 1 2 1 2 1 1 4 2 6 3 1 
930 4 4 6 5 5 6 4 5 5 1 2 1 3 5 3 6 4 5 6 4 6 1 2 1 2 1 1 4 2 6 3 4 
930 4 4 6 5 5 6 4 5 5 1 2 1 3 5 3 6 4 5 6 4 6 1 2 1 2 1 1 4 2 6 3 1 
930 4 4 6 5 5 6 4 5 5 1 2 1 3 5 3 6 4 5 6 4 6 1 2 1 2 1 1 4 2 6 3 1 
930 4 4 6 5 5 6 4 5 5 1 2 1 3 5 3 6 4 5 6 4 6 1 2 1 2 1 1 4 2 6 4 3 
930 4 4 6 5 5 6 4 5 5 1 2 1 3 5 3 6 4 5 6 4 6 1 2 1 2 1 1 4 2 6 3 4 
930 4 4 6 5 5 6 4 5 5 1 2 1 3 5 3 6 4 5 6 4 6 1 2 1 2 1 1 4 2 6 3 1 
885 4 4 6 5 5 6 4 5 5 1 2 1 3 5 3 6 4 5 6 4 6 1 2 1 2 1 1 4 2 2 
