125 6 5 5 5 3 4 6 5 6 
125 6 5 5 5 3 4 6 2 6 
110 6 5 5 5 3 4 6 2 2 
110 6 5 5 5 3 4 6 5 2 
110 6 5 5 5 3 4 6 5 2 
110 6 5 5 5 3 4 6 5 5 
100 6 5 5 5 3 4 6 1 6 
85 6 5 5 5 3 4 6 2 1 
85 6 5 5 5 3 4 6 1 2 
85 6 5 5 5 3 4 6 5 1 
85 6 5 5 5 3 4 6 5 1 
85 6 5 5 5 3 4 6 4 2 
85 6 5 5 5 3 4 6 5 1 
85 6 5 5 5 3 4 6 1 5 
85 6 5 5 5 3 4 6 2 1 
85 6 5 5 5 3 4 6 4 2 
85 6 5 5 5 3 4 6 2 1 
85 6 5 5 5 3 4 6 2 4 
85 6 5 5 5 3 4 6 2 4 
85 6 5 5 5 3 4 6 2 4 
75 6 5 5 5 3 4 6 6 
75 6 5 5 5 3 4 6 6 
65 6 5 5 5 3 4 6 2 3 
65 6 5 5 5 3 4 6 2 3 
65 6 5 5 5 3 4 6 5 3 
65 6 5 5 5 3 4 6 2 3 
65 6 5 5 5 3 4 6 5 3 
65 6 5 5 5 3 4 6 5 3 
65 6 5 5 5 3 4 3 6 5 
65 6 5 5 5 3 4 6 2 3 
60 6 5 5 5 3 4 6 1 4 
60 6 5 5 5 3 4 6 4 1 2 
60 6 5 5 5 3 4 6 4 4 3 
45 6 5 5 5 3 4 4 5 1 2 
40 6 5 5 5 3 4 6 4 3 5 
40 6 5 5 5 3 4 6 4 3 2 
40 6 5 5 5 3 4 3 4 6 6 
-5 6 5 5 5 3 4 2 
-5 6 5 5 5 3 4 5 
-5 6 5 5 5 3 4 5 
-5 6 5 5 5 3 4 5 
-5 6 5 5 5 3 5 4 
-5 6 5 5 5 3 4 2 
-5 6 5 5 5 3 4 5 
-25 6 5 5 5 3 4 3 1 
-30 6 5 5 5 3 4 1 
-30 6 5 5 5 3 4 1 
-30 6 5 5 5 3 4 1 
