250 6 5 5 5 3 4 6 6 2 6 3 3 2 
200 6 5 5 5 3 4 6 6 3 4 6 4 3 5 
125 6 5 5 5 3 4 6 5 6 
125 6 5 5 5 3 4 6 5 6 
125 6 5 5 5 3 4 6 2 6 
110 6 5 5 5 3 4 6 4 1 5 
110 6 5 5 5 3 4 6 4 3 3 6 
110 6 5 5 5 3 4 6 5 2 
110 6 5 5 5 3 4 6 2 5 
110 6 5 5 5 3 4 6 5 5 
110 6 5 5 5 3 4 6 4 1 2 
110 6 5 5 5 3 4 6 5 5 
110 6 5 5 5 3 4 6 2 5 
110 6 5 5 5 3 4 6 2 2 
110 6 5 5 5 3 4 6 5 2 
110 6 5 5 5 3 4 6 5 2 
110 6 5 5 5 3 4 6 2 2 
110 6 5 5 5 3 4 6 4 4 5 
110 6 5 5 5 3 4 6 2 5 
105 6 5 5 5 3 4 6 4 3 6 
95 6 5 5 5 3 4 4 2 1 2 
85 6 5 5 5 3 4 6 5 1 
85 6 5 5 5 3 4 6 5 1 
85 6 5 5 5 3 4 6 2 1 
80 6 5 5 5 3 4 3 6 6 
65 6 5 5 5 3 4 6 5 3 
65 6 5 5 5 3 4 3 6 5 
65 6 5 5 5 3 4 6 2 3 
65 6 5 5 5 3 4 6 5 3 
65 6 5 5 5 3 4 6 2 3 
65 6 5 5 5 3 4 6 5 3 
65 6 5 5 5 3 4 6 5 3 
60 6 5 5 5 3 4 6 1 1 
40 6 5 5 5 3 4 6 1 3 
0 6 5 5 5 3 4 3 2 
-5 6 5 5 5 3 4 4 1 
-5 6 5 5 5 3 4 5 
-5 6 5 5 5 3 4 5 
-5 6 5 5 5 3 4 5 
-5 6 5 5 5 3 4 5 
-5 6 5 5 5 3 4 2 
-5 6 5 5 5 3 4 4 1 
-5 6 5 5 5 3 4 2 
-5 6 5 5 5 3 4 5 
-25 6 5 5 5 3 4 3 1 
-25 6 5 5 5 3 4 3 1 
-45 6 5 5 5 3 4 3 3 
-55 6 5 5 5 3 4 6 6 5 6 3 5 
