235 6 5 5 5 5 5 3 5 6 5 5 2 
135 6 5 5 5 3 5 5 2 6 
130 6 5 5 5 5 5 2 6 
120 6 5 5 5 3 5 5 5 2 
120 6 5 5 5 3 5 5 2 2 
120 6 5 5 5 3 5 5 2 5 
120 6 5 5 5 3 5 5 2 5 
120 6 5 5 5 3 5 5 2 5 
120 6 5 5 5 3 5 5 2 2 
120 6 5 5 5 3 5 5 2 5 
120 6 5 5 5 3 5 5 2 2 
120 6 5 5 5 3 5 5 2 5 
120 6 5 5 5 3 5 5 2 2 
115 6 5 5 5 5 5 2 2 
115 6 5 5 5 5 5 2 2 
115 6 5 5 5 5 5 5 2 
115 6 5 5 5 5 5 2 2 
115 6 5 5 5 5 5 2 5 
115 6 5 5 5 5 5 2 5 
115 6 5 5 5 5 5 2 5 
110 6 5 5 5 6 3 4 4 4 5 
110 6 5 5 5 3 5 5 1 6 
110 6 5 5 5 3 5 4 6 2 
105 6 5 5 5 5 5 1 6 
105 6 5 5 5 5 5 4 6 
95 6 5 5 5 3 5 5 4 5 
95 6 5 5 5 3 5 1 2 2 
95 6 5 5 5 3 5 4 5 5 
95 6 5 5 5 3 5 5 4 5 
95 6 5 5 5 3 5 5 2 4 
95 6 5 5 5 3 5 5 2 1 
95 6 5 5 5 3 5 5 2 4 
90 6 5 5 5 5 5 2 4 
90 6 5 5 5 3 5 5 3 6 
90 6 5 5 5 5 5 1 5 
90 6 5 5 5 5 5 1 2 
90 6 5 5 5 5 5 4 5 
90 6 5 5 5 5 5 4 2 
90 6 5 5 5 5 5 5 1 
90 6 5 5 5 3 5 5 3 6 
85 6 5 5 5 3 5 5 6 
85 6 5 5 5 3 5 1 1 6 
85 6 5 5 5 3 5 1 4 6 
75 6 5 5 5 3 5 5 2 3 
75 6 5 5 5 3 5 5 2 3 
75 6 5 5 5 3 5 5 5 3 
75 6 5 5 5 3 5 2 3 2 
70 6 5 5 5 3 5 5 1 4 
70 6 5 5 5 5 5 2 3 
70 6 5 5 5 5 5 2 3 
70 6 5 5 5 5 4 3 2 4 
65 6 5 5 5 5 5 1 1 
55 6 5 5 5 6 5 1 
40 6 5 5 5 3 5 6 3 
35 6 5 5 5 5 6 3 
5 6 5 5 5 6 1 
0 6 5 5 5 3 5 3 1 
-10 6 5 5 5 5 1 
-10 6 5 5 5 5 1 
-10 6 5 5 5 4 4 1 
-10 6 5 5 5 5 1 
-10 6 5 5 5 5 1 
-35 6 5 5 5 2 
-35 6 5 5 5 2 
