125 6 5 5 5 3 4 6 2 6 
110 6 5 5 5 3 4 6 2 2 
110 6 5 5 5 3 4 6 5 2 
110 6 5 5 5 3 4 6 5 5 
110 6 5 5 5 3 4 6 5 2 
100 6 5 5 5 3 4 6 4 6 
85 6 5 5 5 3 4 6 2 4 
85 6 5 5 5 3 4 6 2 1 
75 6 5 5 5 3 4 6 6 2 6 3 
75 6 5 5 5 3 4 6 6 2 6 3 
75 6 5 5 5 3 4 6 6 2 6 3 3 
75 6 5 5 5 3 4 6 6 2 6 3 3 
75 6 5 5 5 3 4 6 6 2 6 3 3 
75 6 5 5 5 3 4 6 6 2 6 3 3 
75 6 5 5 5 3 4 6 6 2 6 3 
75 6 5 5 5 3 4 6 6 2 6 
75 6 5 5 5 3 4 6 6 2 6 
75 6 5 5 5 3 4 6 6 2 6 
75 6 5 5 5 3 4 6 6 2 6 3 
75 6 5 5 5 3 4 6 6 2 6 3 
75 6 5 5 5 3 4 6 6 2 6 3 3 
75 6 5 5 5 3 4 6 6 2 6 3 
75 6 5 5 5 3 4 6 6 2 6 3 
75 6 5 5 5 3 4 6 6 2 6 3 3 
75 6 5 5 5 3 4 6 6 2 6 
75 6 5 5 5 3 4 6 6 2 6 
75 6 5 5 5 3 4 6 6 2 6 3 
75 6 5 5 5 3 4 6 6 2 6 
75 6 5 5 5 3 4 6 6 2 6 3 3 
75 6 5 5 5 3 4 6 6 3 4 6 
75 6 5 5 5 3 4 6 6 
75 6 5 5 5 3 4 6 6 
75 6 5 5 5 3 4 6 6 2 6 3 3 
75 6 5 5 5 3 4 6 6 2 6 3 3 
75 6 5 5 5 3 4 6 6 2 6 
75 6 5 5 5 3 4 6 6 2 6 3 3 
65 6 5 5 5 3 4 6 3 2 
65 6 5 5 5 3 4 6 5 3 
65 6 5 5 5 3 4 3 6 2 
65 6 5 5 5 3 4 6 2 3 
60 6 5 5 5 3 4 6 4 4 2 
60 6 5 5 5 3 4 6 4 1 5 
60 6 5 5 5 3 4 6 4 1 6 
60 6 5 5 5 3 4 6 4 4 4 
45 6 5 5 5 3 4 4 1 2 5 
40 6 5 5 5 3 4 6 4 3 5 
-5 6 5 5 5 3 4 2 
-30 6 5 5 5 3 4 1 
