-110 4 5 5 5 5 3 5 1 4 2 2 4 4 2 6 2 
-170 4 5 5 5 5 3 5 1 4 2 2 5 3 5 
-225 4 5 5 5 5 3 5 1 4 3 4 2 6 4 5 
-225 4 5 5 5 5 3 5 1 4 3 4 2 6 4 5 
-225 4 5 5 5 5 3 5 1 4 3 4 2 6 4 5 
-225 4 5 5 5 5 3 5 1 4 3 4 2 
-225 4 5 5 5 5 3 5 1 4 3 4 2 6 
-225 4 5 5 5 5 3 5 1 4 3 4 2 6 4 5 
-225 4 5 5 5 5 3 5 1 4 3 4 2 6 
-225 4 5 5 5 5 3 5 1 4 3 4 2 6 
-225 4 5 5 5 5 3 5 1 4 3 4 2 
-225 4 5 5 5 5 3 5 1 4 3 4 2 6 4 
-225 4 5 5 5 5 3 5 1 4 3 4 2 6 4 
-225 4 5 5 5 5 3 5 1 4 3 4 2 6 4 
-225 4 5 5 5 5 3 5 1 4 3 4 2 6 
-225 4 5 5 5 5 3 5 1 4 3 4 2 6 4 5 
-225 4 5 5 5 5 3 5 1 4 3 4 2 6 
-225 4 5 5 5 5 3 5 1 4 3 4 2 6 4 
-225 4 5 5 5 5 3 5 1 4 3 4 2 6 4 
-225 4 5 5 5 5 3 5 1 4 3 4 2 6 4 5 
-225 4 5 5 5 5 3 5 1 4 3 4 2 6 4 
-225 4 5 5 5 5 3 5 1 4 3 4 2 6 4 
-225 4 5 5 5 5 3 5 1 4 3 4 2 6 
-225 4 5 5 5 5 3 5 1 4 3 4 2 6 4 5 6 
-225 4 5 5 5 5 3 5 1 4 3 4 2 6 4 5 
-225 4 5 5 5 5 3 5 1 4 3 4 2 6 4 
-225 4 5 5 5 5 3 5 1 4 3 6 5 2 
-225 4 5 5 5 5 3 5 1 5 3 
-225 4 5 5 5 5 3 5 1 4 2 2 4 6 2 3 1 
-225 4 5 5 5 5 3 5 1 4 2 2 4 6 1 3 
-225 4 5 5 5 5 3 5 1 4 2 2 4 6 6 2 
-225 4 5 5 5 5 3 5 1 5 
-225 4 5 5 5 5 3 5 1 4 3 
-225 4 5 5 5 5 3 5 1 4 3 6 1 
-225 4 5 5 5 5 3 5 1 4 2 2 4 6 
-225 4 5 5 5 5 3 5 1 4 2 2 4 6 
-225 4 5 5 5 5 3 5 1 4 2 2 1 
-225 4 5 5 5 5 3 5 1 4 2 2 
-225 4 5 5 5 5 3 5 1 4 6 
-225 4 5 5 5 5 3 5 1 4 2 2 
-225 4 5 5 5 5 3 5 1 4 2 
-225 4 5 5 5 5 3 5 1 4 2 2 4 
-225 4 5 5 5 5 3 5 1 4 2 2 4 
-225 4 5 5 5 5 3 5 1 4 2 
-225 4 5 5 5 5 3 5 1 4 2 2 
-225 4 5 5 5 5 3 5 1 4 2 2 4 
-225 4 5 5 5 5 3 5 1 4 3 6 
-225 4 5 5 5 5 3 5 1 4 3 4 2 6 4 
