-155 4 5 5 5 5 3 5 1 4 5 
-175 4 5 5 5 5 3 5 1 4 2 2 4 5 1 
-195 4 5 5 5 5 3 5 1 4 2 2 4 4 3 
-195 4 5 5 5 5 3 5 1 4 2 2 4 
-200 4 5 5 5 5 3 5 1 4 1 
-200 4 5 5 5 5 3 5 1 4 2 4 5 
-200 4 5 5 5 5 3 5 1 3 
-200 4 5 5 5 5 3 5 1 2 
-205 4 5 5 5 5 3 5 1 4 2 2 4 4 2 6 4 
-215 4 5 5 5 5 3 5 3 
-220 4 5 5 5 5 3 5 1 4 2 2 4 4 2 2 
-220 4 5 5 5 5 3 5 1 4 2 2 6 
-220 4 5 5 5 5 3 5 1 4 2 2 4 2 
-220 4 5 5 5 5 3 5 1 4 2 2 4 4 
-220 4 5 5 5 5 3 5 1 4 
-220 4 5 5 5 5 3 5 1 4 
-220 4 5 5 5 5 3 5 1 6 
-220 4 5 5 5 5 3 1 
-220 4 5 5 5 5 3 5 1 4 2 2 4 2 
-220 4 5 5 5 5 3 2 5 
-245 4 5 5 5 5 3 5 1 4 2 2 4 4 1 
-265 4 5 5 5 5 3 5 1 4 2 2 4 4 2 6 
-265 4 5 5 5 5 3 5 1 4 2 2 4 
-265 4 5 5 5 5 3 5 1 4 2 2 4 4 2 
-265 4 5 5 5 5 3 5 1 4 2 2 4 4 2 
-265 4 5 5 5 5 3 5 1 4 2 2 4 
-265 4 5 5 5 5 3 5 1 4 2 2 4 4 
-265 4 5 5 5 5 3 5 1 4 2 2 4 
-265 4 5 5 5 5 3 5 1 4 2 2 4 4 
-265 4 5 5 5 5 3 5 1 4 2 2 4 4 2 
-265 4 5 5 5 5 3 5 1 4 2 2 4 4 
-265 4 5 5 5 5 3 5 1 4 2 2 4 
-265 4 5 5 5 5 3 5 1 4 2 2 4 4 2 
-265 4 5 5 5 5 3 5 1 4 2 2 4 4 2 
-265 4 5 5 5 5 3 5 1 4 2 2 4 4 
-265 4 5 5 5 5 3 5 1 4 2 2 4 
-265 4 5 5 5 5 3 5 1 4 2 2 4 4 2 
-265 4 5 5 5 5 3 5 1 4 2 2 4 4 
-265 4 5 5 5 5 3 5 1 4 2 2 4 
-265 4 5 5 5 5 3 
-265 4 5 5 5 5 3 5 
-265 4 5 5 5 5 3 5 1 4 2 2 4 4 
-265 4 5 5 5 5 3 5 1 
-265 4 5 5 5 5 3 5 1 4 2 2 
-265 4 5 5 5 5 3 5 1 4 2 2 4 
-265 4 5 5 5 5 3 5 1 4 2 2 4 4 2 
-265 4 5 5 5 5 3 5 1 4 2 2 4 4 2 
-545 4 5 5 5 5 3 5 1 4 2 2 
