800 5 6 5 5 5 4 4 4 2 5 6 5 1 1 4 2 
530 5 6 5 5 5 4 4 4 3 3 6 5 2 6 2 5 
525 5 6 5 5 5 4 4 4 2 6 
510 5 6 5 5 5 4 4 4 2 6 2 5 
495 5 6 5 5 5 4 4 4 2 5 
485 5 6 5 5 5 4 4 4 2 6 
485 5 6 5 5 5 4 4 4 2 6 
465 5 6 5 5 5 4 4 4 6 3 5 
445 5 6 5 5 5 4 4 4 2 4 
445 5 6 5 5 5 4 4 4 2 1 
445 5 6 5 5 5 4 4 4 1 5 
425 5 6 5 5 5 4 4 4 4 3 5 
370 5 6 5 5 5 2 3 5 4 
360 5 6 5 2 5 3 6 4 2 
355 5 6 5 5 5 3 4 2 3 2 
315 5 6 5 5 5 5 2 2 
290 5 6 5 5 5 4 4 4 2 6 5 6 5 4 
190 5 6 5 5 5 4 4 4 2 3 4 2 
160 5 6 5 5 5 4 4 4 2 4 1 6 
145 5 6 5 5 5 4 4 3 5 4 
115 5 6 5 5 5 4 4 4 1 5 4 1 3 2 2 4 5 3 3 3 
115 5 6 5 5 5 4 4 4 1 5 
110 5 6 5 5 5 4 4 4 1 5 4 5 2 
100 5 6 5 5 5 1 4 3 
90 5 6 5 5 5 4 4 4 2 
85 5 6 5 5 5 4 4 4 4 4 2 
80 5 6 5 5 5 4 4 4 2 6 
70 5 6 5 5 5 4 4 4 2 3 
45 5 6 5 2 6 
45 5 6 5 5 3 
40 5 6 5 5 5 4 4 4 2 6 2 
40 5 6 5 5 5 4 2 
40 5 6 5 5 5 4 4 4 
40 5 6 5 5 5 4 4 4 2 
30 5 6 5 5 5 4 4 4 
30 5 6 5 5 5 4 4 4 
-10 5 6 5 5 5 4 4 4 1 
-10 5 6 5 5 5 4 4 4 1 
-10 5 6 5 5 5 4 4 4 
-10 5 6 5 5 5 4 4 4 1 5 4 1 
-10 5 6 5 5 5 4 4 4 1 5 
-10 5 6 5 5 5 4 4 4 1 5 4 
-10 5 6 5 4 
-10 5 6 5 5 5 4 4 4 2 
-10 5 6 5 5 5 4 4 4 1 5 2 
-40 5 6 5 5 5 4 4 4 1 
-40 5 6 5 5 5 4 4 4 2 6 1 3 
-65 5 6 4 
