110 6 5 5 5 3 4 6 2 5 
110 6 5 5 5 3 4 6 2 2 
110 6 5 5 5 3 4 6 2 2 
110 6 5 5 5 3 4 6 4 1 5 
110 6 5 5 5 3 4 5 6 2 
110 6 5 5 5 3 4 6 2 5 
85 6 5 5 5 3 4 6 2 4 
85 6 5 5 5 3 4 6 2 1 
85 6 5 5 5 3 4 6 5 1 
85 6 5 5 5 3 4 6 4 4 4 
85 6 5 5 5 3 4 6 4 2 
85 6 5 5 5 3 4 6 2 4 
85 6 5 5 5 3 4 5 6 4 
85 6 5 5 5 3 4 6 2 4 
85 6 5 5 5 3 4 6 2 1 
85 6 5 5 5 3 4 4 2 6 
85 6 5 5 5 3 4 6 2 4 
85 6 5 5 5 3 4 6 2 4 
75 6 5 5 5 3 4 6 6 
75 6 5 5 5 3 4 6 6 
75 6 5 5 5 3 4 6 6 
75 6 5 5 5 3 4 6 6 
75 6 5 5 5 3 4 6 6 
70 6 5 5 5 3 5 5 1 4 
70 6 5 5 5 3 4 5 2 1 
70 6 5 5 5 3 4 4 2 5 
65 6 5 5 5 3 4 6 3 5 
65 6 5 5 5 3 4 6 4 3 1 
65 6 5 5 5 3 4 3 5 6 
65 6 5 5 5 3 4 6 3 2 
60 6 5 5 5 3 4 6 1 1 
60 6 5 5 5 3 4 4 6 4 
60 6 5 5 5 3 4 6 1 4 
55 6 5 5 5 6 5 1 
40 6 5 5 5 3 4 6 3 1 
40 6 5 5 5 3 4 6 1 3 
40 6 5 5 5 3 4 6 3 4 
30 6 5 5 5 3 4 3 5 3 4 2 
20 6 5 5 5 3 4 6 3 3 
-5 6 5 5 5 3 4 2 
-5 6 5 5 5 3 4 2 
-5 6 5 5 5 3 4 2 
-5 6 5 5 5 3 4 2 
-15 6 5 5 5 3 6 6 
-30 6 5 5 5 3 4 1 
-30 6 5 5 5 3 4 1 
-30 6 5 5 5 3 4 1 
-30 6 5 5 5 3 4 1 
