1520 4 4 6 5 5 6 4 5 5 1 2 1 3 5 3 6 4 5 6 4 6 1 2 1 2 1 1 4 2 6 3 6 4 5 6 5 6 5 4 3 6 5 2 2 
1485 4 4 6 5 5 6 4 5 5 1 2 1 3 5 3 6 4 5 6 4 6 1 2 1 2 1 1 4 2 6 3 6 4 5 6 5 6 5 4 3 6 5 6 
1460 4 4 6 5 5 6 4 5 5 1 2 1 3 5 3 6 4 5 6 4 6 1 2 1 2 1 1 4 2 6 3 6 4 5 6 5 6 5 4 3 6 4 6 
1450 4 4 6 5 5 6 4 5 5 1 2 1 3 5 3 6 4 5 6 4 6 1 2 1 2 1 1 4 2 6 3 6 4 5 6 5 6 5 4 3 6 5 3 4 1 
1445 4 4 6 5 5 6 4 5 5 1 2 1 3 5 3 6 4 5 6 4 6 1 2 1 2 1 1 4 2 6 3 6 4 5 6 5 6 5 4 3 6 5 4 
1435 4 4 6 5 5 6 4 5 5 1 2 1 3 5 3 6 4 5 6 4 6 1 2 1 2 1 1 4 2 6 3 6 4 5 6 5 6 5 4 3 6 6 
1425 4 4 6 5 5 6 4 5 5 1 2 1 3 5 3 6 4 5 6 4 6 1 2 1 2 1 1 4 2 6 3 6 4 5 6 5 6 5 4 4 2 2 
1425 4 4 6 5 5 6 4 5 5 1 2 1 3 5 3 6 4 5 6 4 6 1 2 1 2 1 1 4 2 6 3 6 4 5 6 5 6 5 3 3 4 2 6 
1420 4 4 6 5 5 6 4 5 5 1 2 1 3 5 3 6 4 5 6 4 6 1 2 1 2 1 1 4 2 6 3 6 4 5 6 5 6 5 4 3 6 2 
1420 4 4 6 5 5 6 4 5 5 1 2 1 3 5 3 6 4 5 6 4 6 1 2 1 2 1 1 4 2 6 3 6 4 5 6 5 6 5 4 3 6 2 
1420 4 4 6 5 5 6 4 5 5 1 2 1 3 5 3 6 4 5 6 4 6 1 2 1 2 1 1 4 2 6 3 6 4 5 6 5 6 5 4 3 6 2 
1415 4 4 6 5 5 6 4 5 5 1 2 1 3 5 3 6 4 5 6 4 6 1 2 1 2 1 1 4 2 6 3 6 4 5 6 5 6 5 4 6 5 
1405 4 4 6 5 5 6 4 5 5 1 2 1 3 5 3 6 4 5 6 4 6 1 2 1 2 1 1 4 2 6 3 6 4 5 6 5 6 5 1 5 2 3 
1395 4 4 6 5 5 6 4 5 5 1 2 1 3 5 3 6 4 5 6 4 6 1 2 1 2 1 1 4 2 6 3 6 4 5 6 5 6 5 4 3 6 1 
1390 4 4 6 5 5 6 4 5 5 1 2 1 3 5 3 6 4 5 6 4 6 1 2 1 2 1 1 4 2 6 3 6 4 5 6 5 6 5 4 6 4 
1390 4 4 6 5 5 6 4 5 5 1 2 1 3 5 3 6 4 5 6 4 6 1 2 1 2 1 1 4 2 6 3 6 4 5 6 5 6 5 4 4 6 
1390 4 4 6 5 5 6 4 5 5 1 2 1 3 5 3 6 4 5 6 4 6 1 2 1 2 1 1 4 2 6 3 6 4 5 6 5 6 5 4 6 4 
1390 4 4 6 5 5 6 4 5 5 1 2 1 3 5 3 6 4 5 6 4 6 1 2 1 2 1 1 4 2 6 3 6 4 5 6 5 6 5 3 3 3 4 5 4 3 
1390 4 4 6 5 5 6 4 5 5 1 2 1 3 5 3 6 4 5 6 4 6 1 2 1 2 1 1 4 2 6 3 6 4 5 6 5 6 5 4 6 1 
1360 4 4 6 5 5 6 4 5 5 1 2 1 3 5 3 6 4 5 6 4 6 1 2 1 2 1 1 4 2 6 3 6 4 5 6 2 1 4 6 3 5 3 2 
1350 4 4 6 5 5 6 4 5 5 1 2 1 3 5 3 6 4 5 6 4 6 1 2 1 2 1 1 4 2 6 3 6 4 5 6 5 6 5 4 2 
1350 4 4 6 5 5 6 4 5 5 1 2 1 3 5 3 6 4 5 6 4 6 1 2 1 2 1 1 4 2 6 3 6 4 5 6 5 6 5 4 5 
1350 4 4 6 5 5 6 4 5 5 1 2 1 3 5 3 6 4 5 6 4 6 1 2 1 2 1 1 4 2 6 3 6 4 5 6 5 6 5 4 5 
1350 4 4 6 5 5 6 4 5 5 1 2 1 3 5 3 6 4 5 6 4 6 1 2 1 2 1 1 4 2 6 3 6 4 5 6 5 6 5 4 5 
1340 4 4 6 5 5 6 4 5 5 1 2 1 3 5 3 6 4 5 6 4 6 1 2 1 2 1 1 4 2 6 3 6 4 5 6 5 6 5 6 
1340 4 4 6 5 5 6 4 5 5 1 2 1 3 5 3 6 4 5 6 4 6 1 2 1 2 1 1 4 2 6 3 6 4 5 6 5 6 5 4 3 3 3 1 
1325 4 4 6 5 5 6 4 5 5 1 2 1 3 5 3 6 4 5 6 4 6 1 2 1 2 1 1 4 2 6 3 6 4 5 6 5 6 5 4 1 
1290 4 4 6 5 5 6 4 5 5 1 2 1 3 5 3 6 4 5 6 4 6 1 2 1 2 1 1 4 2 6 3 6 4 5 6 5 6 6 
1205 4 4 6 5 5 6 4 5 5 1 2 1 3 5 3 6 4 5 6 4 6 1 2 1 2 1 1 4 2 6 3 6 4 5 6 3 1 6 
1185 4 4 6 5 5 6 4 5 5 1 2 1 3 5 3 6 4 5 6 4 6 1 2 1 2 1 1 4 2 6 3 6 4 5 6 5 1 
