325 6 5 5 5 3 4 6 6 2 1 5 4 2 5 
315 6 5 5 5 3 4 6 6 5 1 1 2 4 6 
305 6 5 5 5 3 4 6 6 2 1 1 6 6 
300 6 5 5 5 3 4 6 6 2 1 1 5 1 5 
295 6 5 5 5 3 4 6 6 2 1 6 3 2 1 
290 6 5 5 5 3 4 6 6 2 1 6 1 5 
290 6 5 5 5 3 4 6 6 2 2 5 6 
290 6 5 5 5 3 4 6 6 2 6 2 5 
290 6 5 5 5 3 4 6 6 2 1 1 6 2 
290 6 5 5 5 3 4 6 6 3 4 6 5 3 6 
280 6 5 5 5 3 4 6 6 2 1 6 6 
280 6 5 5 5 3 4 6 6 2 1 2 3 4 2 
280 6 5 5 5 3 4 6 6 2 1 6 6 
275 6 5 5 5 3 4 6 6 2 1 1 3 3 4 6 
275 6 5 5 5 3 4 6 6 2 1 1 2 5 
275 6 5 5 5 3 4 6 6 2 1 1 2 1 1 
275 6 5 5 5 3 4 6 6 2 1 1 1 4 5 
275 6 5 5 5 3 4 6 6 2 1 1 5 2 
275 6 5 5 5 3 4 6 6 5 4 5 4 5 
275 6 5 5 5 3 4 6 6 5 4 1 1 4 1 1 
275 6 5 5 5 3 4 6 6 4 4 3 1 3 6 2 
275 6 5 5 5 3 4 6 6 2 5 5 5 
265 6 5 5 5 3 4 6 6 2 1 1 6 1 
265 6 5 5 5 3 4 6 6 2 1 5 6 
265 6 5 5 5 3 4 6 6 2 1 1 6 4 
265 6 5 5 5 3 4 6 6 2 1 1 6 1 
260 6 5 5 5 3 4 6 6 2 6 3 6 
255 6 5 5 5 3 4 6 6 2 4 1 3 5 4 
255 6 5 5 5 3 4 6 6 2 5 4 1 3 1 
255 6 5 5 5 3 4 6 6 2 1 1 4 3 2 
255 6 5 5 5 3 4 6 6 2 1 3 1 5 4 
255 6 5 5 5 3 4 6 6 5 1 1 5 3 1 
255 6 5 5 5 3 4 6 6 2 1 5 3 5 
255 6 5 5 5 3 4 6 6 2 1 1 3 5 1 
250 6 5 5 5 3 4 6 6 3 6 3 2 2 
245 6 5 5 5 3 4 6 6 2 1 1 6 3 
245 6 5 5 5 3 4 6 6 2 1 1 6 3 
245 6 5 5 5 3 4 6 6 2 6 5 3 
245 6 5 5 5 3 4 6 6 2 5 3 6 
240 6 5 5 5 3 4 6 6 2 1 3 1 2 3 3 
240 6 5 5 5 3 4 4 5 4 1 6 6 3 3 3 4 4 
85 6 5 5 5 3 4 6 5 4 
85 6 5 5 5 3 4 6 2 1 
85 6 5 5 5 3 4 6 2 4 
85 6 5 5 5 3 4 6 2 4 
65 6 5 5 5 3 4 6 2 3 
65 6 5 5 5 3 4 6 2 3 
-15 6 5 5 5 3 4 3 4 3 3 
