105 4 5 5 5 5 3 5 1 4 
55 4 5 5 5 5 3 5 1 4 2 2 
-85 4 5 5 5 5 3 5 5 
-100 4 5 5 5 5 3 5 1 4 2 2 4 5 1 5 
-105 4 5 5 5 5 3 5 1 4 2 2 4 4 3 6 
-120 4 5 5 5 5 3 5 1 4 2 2 4 4 2 2 
-120 4 5 5 5 5 3 5 1 4 2 2 4 4 2 3 3 
-125 4 5 5 5 5 3 5 1 4 2 2 4 4 1 
-130 4 5 5 5 5 3 5 1 4 2 2 3 1 
-135 4 5 5 5 5 3 5 1 4 2 2 4 4 4 
-135 4 5 5 5 5 3 5 1 4 3 
-135 4 5 5 5 5 3 5 6 
-135 4 5 5 5 5 3 5 
-135 4 5 5 5 5 3 5 1 4 2 2 4 4 4 
-135 4 5 5 5 5 3 5 2 1 
-135 4 5 5 5 5 3 5 3 
-135 4 5 5 5 5 3 5 1 4 2 2 6 3 
-140 4 5 5 5 5 3 5 1 4 2 2 1 
-140 4 5 5 5 5 3 5 6 1 1 
-140 4 5 5 5 5 3 5 5 
-140 4 5 5 5 5 3 5 1 4 2 2 2 
-145 4 5 5 5 5 3 5 1 4 2 2 3 1 
-145 4 5 5 5 5 3 5 1 4 2 2 
-145 4 5 5 5 5 3 5 1 4 2 2 4 4 2 1 
-145 4 5 5 5 5 3 5 1 4 2 2 4 4 5 4 
-145 4 5 5 5 5 3 5 1 4 2 2 
-145 4 5 5 5 5 3 5 1 4 2 2 4 4 2 4 
-145 4 5 5 5 5 3 5 1 5 1 
-145 4 5 5 5 5 3 5 1 4 2 2 4 3 
-145 4 5 5 5 5 3 5 1 4 2 4 4 
-150 4 5 5 5 5 3 5 1 4 2 2 4 4 4 1 
-150 4 5 5 5 2 
-155 4 5 5 5 5 3 5 5 6 
-155 4 5 5 5 5 3 5 2 
-155 4 5 5 5 5 3 5 1 4 2 2 4 4 2 6 2 4 
-155 4 5 5 5 5 2 4 
-155 4 5 5 5 5 3 5 2 2 2 
-155 4 5 5 5 5 3 5 1 4 2 2 4 
-160 4 5 5 5 5 3 5 1 4 2 2 3 3 4 
-165 6 4 5 5 5 5 3 
-170 4 5 5 5 5 3 5 1 4 6 2 
-180 4 5 5 5 5 3 5 4 3 
-180 4 5 5 5 5 3 5 1 4 2 2 4 1 3 
-180 4 5 5 5 5 3 5 1 4 2 2 5 
-200 4 5 5 5 5 3 5 1 4 2 2 4 
-200 4 5 5 5 5 3 5 1 4 3 
-205 4 5 5 5 5 3 5 1 4 2 2 4 6 1 
-225 5 4 5 5 5 5 3 5 
