1000064 6 5 5 5 6 4 3 4 6 2 2 3 6 5 5 5 5 4 3 4 6 2 2 2 2 1 3 5 6 2 6 4 6 5 6 5 4 6 6 1 6 3 2 6 6 
1000064 6 5 5 5 6 4 3 4 6 2 2 3 6 5 5 5 5 4 3 4 6 2 2 2 2 1 3 5 6 2 6 4 6 5 6 5 4 6 6 1 6 6 1 6 
1000049 6 5 5 5 6 4 3 4 6 2 2 3 6 5 5 5 5 4 3 4 6 2 2 2 2 1 3 5 6 2 6 4 6 5 6 5 4 6 6 4 3 5 4 3 6 2 5 
1000049 6 5 5 5 6 4 3 4 6 2 2 3 6 5 5 5 5 4 3 4 6 2 2 2 2 1 3 5 6 2 6 4 6 5 6 5 4 6 6 1 6 4 5 1 5 
1000049 6 5 5 5 6 4 3 4 6 2 2 3 6 5 5 5 5 4 3 4 6 2 2 2 2 1 3 5 6 2 6 4 6 5 6 5 4 6 6 4 6 1 4 6 5 
1000049 6 5 5 5 6 4 3 4 6 2 2 3 6 5 5 5 5 4 3 4 6 2 2 2 2 1 3 5 6 2 6 4 6 5 6 5 4 6 6 1 3 6 1 6 5 
999999 6 5 5 5 6 4 3 4 6 2 2 3 6 5 5 5 5 4 3 4 6 2 2 2 2 1 3 5 6 2 6 4 6 5 6 5 4 6 6 4 6 5 3 3 3 1 3 3 2 
999999 6 5 5 5 6 4 3 4 6 2 2 3 6 5 5 5 5 4 3 4 6 2 2 2 2 1 3 5 6 2 6 4 6 5 6 5 4 6 6 1 6 5 1 3 3 3 3 4 2 
1540 6 5 5 5 6 4 3 4 6 2 2 3 6 5 5 5 5 4 3 4 6 2 2 2 2 1 3 5 6 2 6 4 6 5 6 5 4 6 6 1 3 2 
1535 6 5 5 5 6 4 3 4 6 2 2 3 6 5 5 5 5 4 3 4 6 2 2 2 2 1 3 5 6 2 6 4 6 5 6 5 4 6 6 1 2 
1535 6 5 5 5 6 4 3 4 6 2 2 3 6 5 5 5 5 4 3 4 6 2 2 2 2 1 3 5 6 2 6 4 6 5 6 5 4 6 6 1 2 
1535 6 5 5 5 6 4 3 4 6 2 2 3 6 5 5 5 5 4 3 4 6 2 2 2 2 1 3 5 6 2 6 4 6 5 6 5 4 6 6 1 2 
1535 6 5 5 5 6 4 3 4 6 2 2 3 6 5 5 5 5 4 3 4 6 2 2 2 2 1 3 5 6 2 6 4 6 5 6 5 4 6 6 1 2 
1535 6 5 5 5 6 4 3 4 6 2 2 3 6 5 5 5 5 4 3 4 6 2 2 2 2 1 3 5 6 2 6 4 6 5 6 5 4 6 6 4 2 
1535 6 5 5 5 6 4 3 4 6 2 2 3 6 5 5 5 5 4 3 4 6 2 2 2 2 1 3 5 6 2 6 4 6 5 6 5 4 6 6 1 5 
1535 6 5 5 5 6 4 3 4 6 2 2 3 6 5 5 5 5 4 3 4 6 2 2 2 2 1 3 5 6 2 6 4 6 5 6 5 4 6 6 1 5 
1535 6 5 5 5 6 4 3 4 6 2 2 3 6 5 5 5 5 4 3 4 6 2 2 2 2 1 3 5 6 2 6 4 6 5 6 5 4 6 6 1 2 
1535 6 5 5 5 6 4 3 4 6 2 2 3 6 5 5 5 5 4 3 4 6 2 2 2 2 1 3 5 6 2 6 4 6 5 6 5 4 6 6 1 5 
1535 6 5 5 5 6 4 3 4 6 2 2 3 6 5 5 5 5 4 3 4 6 2 2 2 2 1 3 5 6 2 6 4 6 5 6 5 4 6 6 1 2 
1535 6 5 5 5 6 4 3 4 6 2 2 3 6 5 5 5 5 4 3 4 6 2 2 2 2 1 3 5 6 2 6 4 6 5 6 5 4 6 6 4 5 
1535 6 5 5 5 6 4 3 4 6 2 2 3 6 5 5 5 5 4 3 4 6 2 2 2 2 1 3 5 6 2 6 4 6 5 6 5 4 6 6 1 2 
1535 6 5 5 5 6 4 3 4 6 2 2 3 6 5 5 5 5 4 3 4 6 2 2 2 2 1 3 5 6 2 6 4 6 5 6 5 4 6 6 1 5 
1535 6 5 5 5 6 4 3 4 6 2 2 3 6 5 5 5 5 4 3 4 6 2 2 2 2 1 3 5 6 2 6 4 6 5 6 5 4 6 6 1 5 
1535 6 5 5 5 6 4 3 4 6 2 2 3 6 5 5 5 5 4 3 4 6 2 2 2 2 1 3 5 6 2 6 4 6 5 6 5 4 6 6 4 2 
1535 6 5 5 5 6 4 3 4 6 2 2 3 6 5 5 5 5 4 3 4 6 2 2 2 2 1 3 5 6 2 6 4 6 5 6 5 4 6 6 4 2 
1535 6 5 5 5 6 4 3 4 6 2 2 3 6 5 5 5 5 4 3 4 6 2 2 2 2 1 3 5 6 2 6 4 6 5 6 5 4 6 6 1 2 
1525 6 5 5 5 6 4 3 4 6 2 2 3 6 5 5 5 5 4 3 4 6 2 2 2 2 1 3 5 6 2 6 4 6 5 6 5 4 6 6 6 
1525 6 5 5 5 6 4 3 4 6 2 2 3 6 5 5 5 5 4 3 4 6 2 2 2 2 1 3 5 6 2 6 4 6 5 6 5 4 6 6 6 
1525 6 5 5 5 6 4 3 4 6 2 2 3 6 5 5 5 5 4 3 4 6 2 2 2 2 1 3 5 6 2 6 4 6 5 6 5 4 6 6 6 
1525 6 5 5 5 6 4 3 4 6 2 2 3 6 5 5 5 5 4 3 4 6 2 2 2 2 1 3 5 6 2 6 4 6 5 6 5 4 6 6 6 
1525 6 5 5 5 6 4 3 4 6 2 2 3 6 5 5 5 5 4 3 4 6 2 2 2 2 1 3 5 6 2 6 4 6 5 6 5 4 6 6 6 
1525 6 5 5 5 6 4 3 4 6 2 2 3 6 5 5 5 5 4 3 4 6 2 2 2 2 1 3 5 6 2 6 4 6 5 6 5 4 4 3 6 1 5 1 
1525 6 5 5 5 6 4 3 4 6 2 2 3 6 5 5 5 5 4 3 4 6 2 2 2 2 1 3 5 6 2 6 4 6 5 6 5 4 6 6 6 
1525 6 5 5 5 6 4 3 4 6 2 2 3 6 5 5 5 5 4 3 4 6 2 2 2 2 1 3 5 6 2 6 4 6 5 6 5 4 6 6 6 
1515 6 5 5 5 6 4 3 4 6 2 2 3 6 5 5 5 5 4 3 4 6 2 2 2 2 1 3 5 6 2 6 4 6 5 6 5 4 6 6 1 3 4 
1515 6 5 5 5 6 4 3 4 6 2 2 3 6 5 5 5 5 4 3 4 6 2 2 2 2 1 3 5 6 2 6 4 6 5 6 5 4 6 6 1 3 1 
1510 6 5 5 5 6 4 3 4 6 2 2 3 6 5 5 5 5 4 3 4 6 2 2 2 2 1 3 5 6 2 6 4 6 5 6 5 4 6 6 2 
1510 6 5 5 5 6 4 3 4 6 2 2 3 6 5 5 5 5 4 3 4 6 2 2 2 2 1 3 5 6 2 6 4 6 5 6 5 4 6 6 4 1 
1510 6 5 5 5 6 4 3 4 6 2 2 3 6 5 5 5 5 4 3 4 6 2 2 2 2 1 3 5 6 2 6 4 6 5 6 5 4 6 6 5 
1510 6 5 5 5 6 4 3 4 6 2 2 3 6 5 5 5 5 4 3 4 6 2 2 2 2 1 3 5 6 2 6 4 6 5 6 5 4 6 6 1 1 
1510 6 5 5 5 6 4 3 4 6 2 2 3 6 5 5 5 5 4 3 4 6 2 2 2 2 1 3 5 6 2 6 4 6 5 6 5 4 6 6 2 
1510 6 5 5 5 6 4 3 4 6 2 2 3 6 5 5 5 5 4 3 4 6 2 2 2 2 1 3 5 6 2 6 4 6 5 6 5 4 6 6 4 1 
1510 6 5 5 5 6 4 3 4 6 2 2 3 6 5 5 5 5 4 3 4 6 2 2 2 2 1 3 5 6 2 6 4 6 5 6 5 4 6 6 1 1 
1510 6 5 5 5 6 4 3 4 6 2 2 3 6 5 5 5 5 4 3 4 6 2 2 2 2 1 3 5 6 2 6 4 6 5 6 5 4 6 6 2 
1510 6 5 5 5 6 4 3 4 6 2 2 3 6 5 5 5 5 4 3 4 6 2 2 2 2 1 3 5 6 2 6 4 6 5 6 5 4 6 6 1 1 
1510 6 5 5 5 6 4 3 4 6 2 2 3 6 5 5 5 5 4 3 4 6 2 2 2 2 1 3 5 6 2 6 4 6 5 6 5 4 6 6 5 
1510 6 5 5 5 6 4 3 4 6 2 2 3 6 5 5 5 5 4 3 4 6 2 2 2 2 1 3 5 6 2 6 4 6 5 6 5 4 6 6 2 
1510 6 5 5 5 6 4 3 4 6 2 2 3 6 5 5 5 5 4 3 4 6 2 2 2 2 1 3 5 6 2 6 4 6 5 6 5 4 6 6 5 
1510 6 5 5 5 6 4 3 4 6 2 2 3 6 5 5 5 5 4 3 4 6 2 2 2 2 1 3 5 6 2 6 4 6 5 6 5 4 6 6 5 
1510 6 5 5 5 6 4 3 4 6 2 2 3 6 5 5 5 5 4 3 4 6 2 2 2 2 1 3 5 6 2 6 4 6 5 6 5 4 6 6 1 1 
1510 6 5 5 5 6 4 3 4 6 2 2 3 6 5 5 5 5 4 3 4 6 2 2 2 2 1 3 5 6 2 6 4 6 5 6 5 4 6 6 2 
1510 6 5 5 5 6 4 3 4 6 2 2 3 6 5 5 5 5 4 3 4 6 2 2 2 2 1 3 5 6 2 6 4 6 5 6 5 4 6 6 2 
1510 6 5 5 5 6 4 3 4 6 2 2 3 6 5 5 5 5 4 3 4 6 2 2 2 2 1 3 5 6 2 6 4 6 5 6 5 4 6 6 1 1 
1510 6 5 5 5 6 4 3 4 6 2 2 3 6 5 5 5 5 4 3 4 6 2 2 2 2 1 3 5 6 2 6 4 6 5 6 5 4 6 6 4 1 
1510 6 5 5 5 6 4 3 4 6 2 2 3 6 5 5 5 5 4 3 4 6 2 2 2 2 1 3 5 6 2 6 4 6 5 6 5 4 6 6 5 
1510 6 5 5 5 6 4 3 4 6 2 2 3 6 5 5 5 5 4 3 4 6 2 2 2 2 1 3 5 6 2 6 4 6 5 6 5 4 6 6 1 4 
1510 6 5 5 5 6 4 3 4 6 2 2 3 6 5 5 5 5 4 3 4 6 2 2 2 2 1 3 5 6 2 6 4 6 5 6 5 4 6 6 5 
1510 6 5 5 5 6 4 3 4 6 2 2 3 6 5 5 5 5 4 3 4 6 2 2 2 2 1 3 5 6 2 6 4 6 5 6 5 4 6 6 4 1 
1510 6 5 5 5 6 4 3 4 6 2 2 3 6 5 5 5 5 4 3 4 6 2 2 2 2 1 3 5 6 2 6 4 6 5 6 5 4 6 6 4 1 
1510 6 5 5 5 6 4 3 4 6 2 2 3 6 5 5 5 5 4 3 4 6 2 2 2 2 1 3 5 6 2 6 4 6 5 6 5 4 6 6 1 1 
1510 6 5 5 5 6 4 3 4 6 2 2 3 6 5 5 5 5 4 3 4 6 2 2 2 2 1 3 5 6 2 6 4 6 5 6 5 4 6 6 1 1 
1510 6 5 5 5 6 4 3 4 6 2 2 3 6 5 5 5 5 4 3 4 6 2 2 2 2 1 3 5 6 2 6 4 6 5 6 5 4 6 6 1 1 
1510 6 5 5 5 6 4 3 4 6 2 2 3 6 5 5 5 5 4 3 4 6 2 2 2 2 1 3 5 6 2 6 4 6 5 6 5 4 6 6 1 1 
1510 6 5 5 5 6 4 3 4 6 2 2 3 6 5 5 5 5 4 3 4 6 2 2 2 2 1 3 5 6 2 6 4 6 5 6 5 4 6 6 1 1 
1510 6 5 5 5 6 4 3 4 6 2 2 3 6 5 5 5 5 4 3 4 6 2 2 2 2 1 3 5 6 2 6 4 6 5 6 5 4 6 6 2 
1510 6 5 5 5 6 4 3 4 6 2 2 3 6 5 5 5 5 4 3 4 6 2 2 2 2 1 3 5 6 2 6 4 6 5 6 5 4 6 6 1 1 
1510 6 5 5 5 6 4 3 4 6 2 2 3 6 5 5 5 5 4 3 4 6 2 2 2 2 1 3 5 6 2 6 4 6 5 6 5 4 6 6 5 
1510 6 5 5 5 6 4 3 4 6 2 2 3 6 5 5 5 5 4 3 4 6 2 2 2 2 1 3 5 6 2 6 4 6 5 6 5 4 6 6 5 
1510 6 5 5 5 6 4 3 4 6 2 2 3 6 5 5 5 5 4 3 4 6 2 2 2 2 1 3 5 6 2 6 4 6 5 6 5 4 6 6 1 1 
1505 6 5 5 5 6 4 3 4 6 2 2 3 6 5 5 5 5 4 3 4 6 2 2 2 2 1 3 5 6 2 6 4 6 5 6 5 2 1 2 5 5 5 
1500 6 5 5 5 6 4 3 4 6 2 2 3 6 5 5 5 5 4 3 4 6 2 2 2 2 1 3 5 6 2 6 4 6 5 6 5 4 4 3 5 4 6 
1495 6 5 5 5 6 4 3 4 6 2 2 3 6 5 5 5 5 4 3 4 6 2 2 2 2 1 3 5 6 2 6 4 6 5 6 5 4 6 6 4 3 3 
1475 6 5 5 5 6 4 3 4 6 2 2 3 6 5 5 5 5 4 3 4 6 2 2 2 2 1 3 5 6 2 6 4 6 5 6 5 4 6 3 5 1 
1470 6 5 5 5 6 4 3 4 6 2 2 3 6 5 5 5 5 4 3 4 6 2 2 2 2 1 3 5 6 2 6 4 6 5 6 5 5 5 6 
1465 6 5 5 5 6 4 3 4 6 2 2 3 6 5 5 5 5 4 3 4 6 2 2 2 2 1 3 5 6 2 6 4 6 5 6 5 4 6 6 3 
1465 6 5 5 5 6 4 3 4 6 2 2 3 6 5 5 5 5 4 3 4 6 2 2 2 2 1 3 5 6 2 6 4 6 5 6 5 4 6 6 3 
1450 6 5 5 5 6 4 3 4 6 2 2 3 6 5 5 5 5 4 3 4 6 2 2 2 2 1 3 5 6 2 6 4 6 5 6 5 4 6 3 2 
1445 6 5 5 5 6 4 3 4 6 2 2 3 6 5 5 5 5 4 3 4 6 2 2 2 2 1 3 5 6 2 6 4 6 5 6 5 4 6 2 
1445 6 5 5 5 6 4 3 4 6 2 2 3 6 5 5 5 5 4 3 4 6 2 2 2 2 1 3 5 6 2 6 4 6 5 6 5 4 6 2 
1445 6 5 5 5 6 4 3 4 6 2 2 3 6 5 5 5 5 4 3 4 6 2 2 2 2 1 3 5 6 2 6 4 6 5 6 5 4 6 5 
1445 6 5 5 5 6 4 3 4 6 2 2 3 6 5 5 5 5 4 3 4 6 2 2 2 2 1 3 5 6 2 6 4 6 5 6 5 4 6 5 
1445 6 5 5 5 6 4 3 4 6 2 2 3 6 5 5 5 5 4 3 4 6 2 2 2 2 1 3 5 6 2 6 4 6 5 6 5 4 6 5 
1445 6 5 5 5 6 4 3 4 6 2 2 3 6 5 5 5 5 4 3 4 6 2 2 2 2 1 3 5 6 2 6 4 6 5 6 5 4 6 2 
1445 6 5 5 5 6 4 3 4 6 2 2 3 6 5 5 5 5 4 3 4 6 2 2 2 2 1 3 5 6 2 6 4 6 5 6 5 4 6 2 
1445 6 5 5 5 6 4 3 4 6 2 2 3 6 5 5 5 5 4 3 4 6 2 2 2 2 1 3 5 6 2 6 4 6 5 6 5 4 6 2 
1445 6 5 5 5 6 4 3 4 6 2 2 3 6 5 5 5 5 4 3 4 6 2 2 2 2 1 3 5 6 2 6 4 6 5 6 5 4 6 5 
1440 6 5 5 5 6 4 3 4 6 2 2 3 6 5 5 5 5 4 3 4 6 2 2 2 2 1 3 5 6 2 6 4 6 5 6 5 1 1 5 6 
1430 6 5 5 5 6 4 3 4 6 2 2 3 6 5 5 5 5 4 3 4 6 2 2 2 2 1 3 5 6 2 6 4 6 5 6 5 4 4 5 4 
1430 6 5 5 5 6 4 3 4 6 2 2 3 6 5 5 5 5 4 3 4 6 2 2 2 2 1 3 5 6 2 6 4 6 5 6 5 4 4 2 1 
1425 6 5 5 5 6 4 3 4 6 2 2 3 6 5 5 5 5 4 3 4 6 2 2 2 2 1 3 5 6 2 6 4 6 5 6 5 4 6 3 1 
1425 6 5 5 5 6 4 3 4 6 2 2 3 6 5 5 5 5 4 3 4 6 2 2 2 2 1 3 5 6 2 6 4 6 5 6 5 4 6 3 1 
1420 6 5 5 5 6 4 3 4 6 2 2 3 6 5 5 5 5 4 3 4 6 2 2 2 2 1 3 5 6 2 6 4 6 5 6 5 4 6 1 
1420 6 5 5 5 6 4 3 4 6 2 2 3 6 5 5 5 5 4 3 4 6 2 2 2 2 1 3 5 6 2 6 4 6 5 6 5 4 6 1 
1420 6 5 5 5 6 4 3 4 6 2 2 3 6 5 5 5 5 4 3 4 6 2 2 2 2 1 3 5 6 2 6 4 6 5 6 5 4 6 1 
1420 6 5 5 5 6 4 3 4 6 2 2 3 6 5 5 5 5 4 3 4 6 2 2 2 2 1 3 5 6 2 6 4 6 5 6 5 4 6 1 
1420 6 5 5 5 6 4 3 4 6 2 2 3 6 5 5 5 5 4 3 4 6 2 2 2 2 1 3 5 6 2 6 4 6 5 6 5 4 6 4 
1420 6 5 5 5 6 4 3 4 6 2 2 3 6 5 5 5 5 4 3 4 6 2 2 2 2 1 3 5 6 2 6 4 6 5 6 5 4 6 1 
1420 6 5 5 5 6 4 3 4 6 2 2 3 6 5 5 5 5 4 3 4 6 2 2 2 2 1 3 5 6 2 6 4 6 5 6 5 4 6 1 
1420 6 5 5 5 6 4 3 4 6 2 2 3 6 5 5 5 5 4 3 4 6 2 2 2 2 1 3 5 6 2 6 4 6 5 6 5 4 6 4 
1420 6 5 5 5 6 4 3 4 6 2 2 3 6 5 5 5 5 4 3 4 6 2 2 2 2 1 3 5 6 2 6 4 6 5 6 5 4 6 4 
1420 6 5 5 5 6 4 3 4 6 2 2 3 6 5 5 5 5 4 3 4 6 2 2 2 2 1 3 5 6 2 6 4 6 5 6 5 4 6 4 
1420 6 5 5 5 6 4 3 4 6 2 2 3 6 5 5 5 5 4 3 4 6 2 2 2 2 1 3 5 6 2 6 4 6 5 6 5 4 6 1 
1405 6 5 5 5 6 4 3 4 6 2 2 3 6 5 5 5 5 4 3 4 6 2 2 2 2 1 3 5 6 2 6 4 6 5 6 5 4 6 3 3 
1405 6 5 5 5 6 4 3 4 6 2 2 3 6 5 5 5 5 4 3 4 6 2 2 2 2 1 3 5 6 2 6 4 6 5 6 5 4 6 3 3 
1395 6 5 5 5 6 4 3 4 6 2 2 3 6 5 5 5 5 4 3 4 6 2 2 2 2 1 3 5 6 2 6 4 6 5 6 5 4 3 3 2 3 
1385 6 5 5 5 6 4 3 4 6 2 2 3 6 5 5 5 5 4 3 4 6 2 2 2 2 1 3 5 6 2 6 4 6 5 6 5 2 3 1 
1385 6 5 5 5 6 4 3 4 6 2 2 3 6 5 5 5 5 4 3 4 6 2 2 2 2 1 3 5 6 2 6 4 6 5 6 5 4 3 2 
1380 6 5 5 5 6 4 3 4 6 2 2 3 6 5 5 5 5 4 3 4 6 2 2 2 2 1 3 5 6 2 6 4 6 5 6 5 5 1 
1380 6 5 5 5 6 4 3 4 6 2 2 3 6 5 5 5 5 4 3 4 6 2 2 2 2 1 3 5 6 2 6 4 6 5 6 5 4 4 4 
1380 6 5 5 5 6 4 3 4 6 2 2 3 6 5 5 5 5 4 3 4 6 2 2 2 2 1 3 5 6 2 6 4 6 5 6 5 4 2 
1380 6 5 5 5 6 4 3 4 6 2 2 3 6 5 5 5 5 4 3 4 6 2 2 2 2 1 3 5 6 2 6 4 6 5 6 5 4 5 
1380 6 5 5 5 6 4 3 4 6 2 2 3 6 5 5 5 5 4 3 4 6 2 2 2 2 1 3 5 6 2 6 4 6 5 6 5 4 5 
1380 6 5 5 5 6 4 3 4 6 2 2 3 6 5 5 5 5 4 3 4 6 2 2 2 2 1 3 5 6 2 6 4 6 5 6 5 4 2 
1380 6 5 5 5 6 4 3 4 6 2 2 3 6 5 5 5 5 4 3 4 6 2 2 2 2 1 3 5 6 2 6 4 6 5 6 5 4 2 
1380 6 5 5 5 6 4 3 4 6 2 2 3 6 5 5 5 5 4 3 4 6 2 2 2 2 1 3 5 6 2 6 4 6 5 6 5 4 2 
1380 6 5 5 5 6 4 3 4 6 2 2 3 6 5 5 5 5 4 3 4 6 2 2 2 2 1 3 5 6 2 6 4 6 5 6 5 4 2 
1380 6 5 5 5 6 4 3 4 6 2 2 3 6 5 5 5 5 4 3 4 6 2 2 2 2 1 3 5 6 2 6 4 6 5 6 5 4 2 
1380 6 5 5 5 6 4 3 4 6 2 2 3 6 5 5 5 5 4 3 4 6 2 2 2 2 1 3 5 6 2 6 4 6 5 6 5 4 2 
1380 6 5 5 5 6 4 3 4 6 2 2 3 6 5 5 5 5 4 3 4 6 2 2 2 2 1 3 5 6 2 6 4 6 5 6 5 4 5 
1370 6 5 5 5 6 4 3 4 6 2 2 3 6 5 5 5 5 4 3 4 6 2 2 2 2 1 3 5 6 2 6 4 6 5 6 5 6 
1365 6 5 5 5 6 4 3 4 6 2 2 3 6 5 5 5 5 4 3 4 6 2 2 2 2 1 3 5 6 2 6 4 6 5 6 5 4 3 4 3 
1365 6 5 5 5 6 4 3 4 6 2 2 3 6 5 5 5 5 4 3 4 6 2 2 2 2 1 3 5 6 2 6 4 6 5 6 5 4 3 4 3 
1360 6 5 5 5 6 4 3 4 6 2 2 3 6 5 5 5 5 4 3 4 6 2 2 2 2 1 3 5 6 2 6 4 6 5 6 5 5 3 
1355 6 5 5 5 6 4 3 4 6 2 2 3 6 5 5 5 5 4 3 4 6 2 2 2 2 1 3 5 6 2 6 4 6 5 6 5 4 1 
1355 6 5 5 5 6 4 3 4 6 2 2 3 6 5 5 5 5 4 3 4 6 2 2 2 2 1 3 5 6 2 6 4 6 5 6 5 4 1 
1355 6 5 5 5 6 4 3 4 6 2 2 3 6 5 5 5 5 4 3 4 6 2 2 2 2 1 3 5 6 2 6 4 6 5 6 5 4 1 
1305 6 5 5 5 6 4 3 4 6 2 2 3 6 5 5 5 5 4 3 4 6 2 2 2 2 1 3 5 6 2 6 4 6 5 6 2 
1215 6 5 5 5 6 4 3 4 6 2 2 3 6 5 5 5 5 4 3 4 6 2 2 2 2 1 3 5 6 2 6 4 6 5 1 
