305 6 5 5 5 3 4 6 6 2 1 1 6 6 
300 6 5 5 5 3 4 6 6 5 1 1 5 1 2 
295 6 5 5 5 3 4 6 6 5 4 5 4 3 6 
290 6 5 5 5 3 4 6 6 2 6 5 2 
290 6 5 5 5 3 4 6 6 2 2 5 6 
285 6 5 5 5 3 4 6 6 2 5 3 5 3 2 
280 6 5 5 5 3 4 6 6 2 6 4 6 
275 6 5 5 5 3 4 6 6 5 4 1 1 4 2 
275 6 5 5 5 3 4 6 6 2 6 3 3 4 2 
270 6 5 5 5 3 4 6 6 4 4 3 2 1 6 
265 6 5 5 5 3 4 6 6 2 5 4 6 
265 6 5 5 5 3 4 6 6 2 4 6 2 
255 6 5 5 5 3 4 6 6 2 4 1 3 5 1 
250 6 5 5 5 3 4 6 6 3 4 6 5 3 4 
240 6 5 5 5 3 4 6 6 3 6 3 4 6 
215 6 5 5 5 3 4 4 5 4 1 6 6 3 3 3 4 
125 6 5 5 5 3 4 6 2 6 
125 6 5 5 5 3 4 6 2 6 
125 6 5 5 5 3 4 6 2 6 
125 6 5 5 5 3 4 6 2 6 
110 6 5 5 5 3 4 6 2 5 
110 6 5 5 5 3 4 6 2 5 
100 6 5 5 5 3 4 6 1 6 
100 6 5 5 5 3 4 6 4 6 
85 6 5 5 5 3 4 6 2 4 
85 6 5 5 5 3 4 6 1 2 
85 6 5 5 5 3 4 6 1 5 
85 6 5 5 5 3 4 6 5 1 
85 6 5 5 5 3 4 6 2 4 
85 6 5 5 5 3 4 6 2 4 
85 6 5 5 5 3 4 6 5 4 
85 6 5 5 5 3 4 6 2 1 
85 6 5 5 5 3 4 6 4 4 4 
80 6 5 5 5 3 4 3 6 6 
80 6 5 5 5 3 4 6 3 6 
65 6 5 5 5 3 4 6 2 3 
65 6 5 5 5 3 4 6 5 3 
0 6 5 5 5 3 4 3 2 
0 6 5 5 5 3 4 4 3 1 
-5 6 5 5 5 3 4 5 
-5 6 5 5 5 3 4 5 
-5 6 5 5 5 3 4 2 
-5 6 5 5 5 3 4 2 
-25 6 5 5 5 3 4 3 1 
-30 6 5 5 5 3 4 1 
-30 6 5 5 5 3 4 1 
-40 6 5 5 5 3 4 6 6 2 6 3 6 
-55 6 5 5 5 3 1 
