345 5 6 5 5 5 4 4 4 2 3 4 2 5 1 5 1 6 
315 5 6 5 5 5 4 4 4 1 5 5 2 5 5 
270 5 6 5 5 5 5 5 2 6 4 6 
270 5 6 5 5 5 4 4 4 3 2 2 5 4 2 
255 5 6 5 5 5 4 4 4 1 5 3 2 1 3 3 2 5 
115 5 6 5 5 5 4 4 5 2 
105 5 6 5 5 5 4 4 4 6 
105 5 6 5 5 5 4 4 4 6 
90 5 6 5 5 5 4 4 4 2 5 6 5 1 1 
90 5 6 5 5 5 4 4 4 2 5 6 5 1 
90 5 6 5 5 5 4 4 4 2 5 6 5 1 1 
90 5 6 5 5 5 4 4 4 2 5 6 5 1 1 4 
90 5 6 5 5 5 4 4 4 2 5 6 5 1 
90 5 6 5 5 5 4 4 4 2 5 6 5 1 
90 5 6 5 5 5 4 4 4 2 5 6 5 1 1 
90 5 6 5 5 5 4 4 4 2 5 6 5 1 
90 5 6 5 5 5 4 4 4 2 5 6 5 1 1 4 
90 5 6 5 5 5 4 4 4 2 5 6 5 1 
90 5 6 5 5 5 4 4 4 2 5 6 5 1 
90 5 6 5 5 5 4 4 4 2 5 6 5 1 
90 5 6 5 5 5 4 4 4 2 5 6 5 1 1 4 
90 5 6 5 5 5 4 4 4 2 5 6 5 1 
90 5 6 5 5 5 4 4 4 2 5 6 5 1 1 4 
90 5 6 5 5 5 4 4 4 2 5 6 5 1 
90 5 6 5 5 5 4 4 4 2 5 6 5 1 
90 5 6 5 5 5 4 4 4 2 5 6 5 1 1 
90 5 6 5 5 5 4 4 4 2 5 6 5 1 1 
90 5 6 5 5 5 4 4 4 2 5 6 5 1 1 
90 5 6 5 5 5 4 4 4 2 5 6 5 1 1 4 
90 5 6 5 5 5 4 4 4 2 5 6 5 1 1 
90 5 6 5 5 5 4 4 4 2 5 6 5 1 1 4 
90 5 6 5 5 5 4 4 4 2 5 6 5 1 
90 5 6 5 5 5 4 4 1 2 
90 5 6 5 5 5 4 4 4 2 
90 5 6 5 5 5 4 4 3 3 6 
90 5 6 5 5 5 4 4 4 2 4 
90 5 6 5 5 5 4 4 4 2 6 5 6 
90 5 6 5 5 5 4 4 4 2 6 2 
90 5 6 5 5 5 4 4 4 2 
80 5 6 5 5 5 4 4 6 
70 5 6 5 5 5 4 4 4 4 3 
70 5 6 5 5 5 3 4 5 4 
45 5 6 5 5 5 3 3 6 3 
15 5 6 5 5 5 2 
0 5 6 5 5 5 4 4 4 1 5 4 1 3 2 2 4 5 2 
-45 5 6 5 5 5 4 4 4 2 5 6 5 1 1 4 4 5 6 
-85 5 6 5 2 5 3 
-200 5 6 5 5 5 4 4 4 3 3 6 5 2 6 
