280 5 6 5 5 5 5 5 2 6 2 2 
220 5 6 5 5 5 4 4 4 1 5 5 2 3 6 
220 5 6 5 5 5 4 4 4 3 2 2 5 4 6 
125 5 6 5 5 5 4 3 6 6 
115 5 6 5 5 5 4 4 2 5 
115 5 6 5 5 5 4 4 5 2 
105 5 6 5 5 5 4 4 4 6 
90 5 6 5 5 5 4 4 4 2 3 4 2 5 1 5 
90 5 6 5 5 5 4 4 4 2 3 4 2 5 1 5 1 
90 5 6 5 5 5 4 4 4 2 3 4 2 5 1 5 
90 5 6 5 5 5 4 4 4 2 3 4 2 5 1 
90 5 6 5 5 5 4 4 4 2 3 4 2 5 1 5 1 
90 5 6 5 5 5 4 4 4 2 3 4 2 5 1 
90 5 6 5 5 5 4 4 4 2 3 4 2 5 1 
90 5 6 5 5 5 4 4 4 2 3 4 2 5 1 5 
90 5 6 5 5 5 4 4 4 2 3 4 2 5 1 5 
90 5 6 5 5 5 4 4 4 2 3 4 2 5 1 5 1 
90 5 6 5 5 5 4 4 4 2 3 4 2 5 1 5 1 
90 5 6 5 5 5 4 4 4 2 3 4 2 5 1 5 
90 5 6 5 5 5 4 4 4 2 3 4 2 5 1 
90 5 6 5 5 5 4 4 4 2 3 4 2 5 1 5 1 
90 5 6 5 5 5 4 4 4 2 3 4 2 5 1 5 
90 5 6 5 5 5 4 4 4 2 3 4 2 5 1 5 1 
90 5 6 5 5 5 4 4 4 2 3 4 2 5 1 5 1 
90 5 6 5 5 5 4 4 4 2 3 4 2 5 1 5 1 
90 5 6 5 5 5 4 4 4 2 3 4 2 5 1 5 1 
90 5 6 5 5 5 4 4 4 2 5 6 5 
90 5 6 5 5 5 4 4 4 2 5 6 5 1 
90 5 6 5 5 5 4 4 4 2 5 6 5 1 
90 5 6 5 5 5 4 4 4 2 5 6 
90 5 6 5 5 5 4 4 4 2 5 6 5 
90 5 6 5 5 5 4 4 4 2 5 6 5 1 
90 5 6 5 5 5 4 4 4 2 5 6 5 1 
90 5 6 5 5 5 4 4 4 2 5 
90 5 6 5 5 5 4 4 4 2 
90 5 6 5 5 5 4 4 4 2 6 
90 5 6 5 5 5 4 4 4 2 5 6 5 1 
90 5 6 5 5 5 4 4 4 2 3 4 2 5 1 
90 5 6 5 5 5 4 4 4 2 3 4 2 5 1 5 
90 5 6 5 5 5 4 4 4 2 3 4 2 5 1 5 1 
85 5 6 5 5 5 4 4 3 6 
70 5 6 5 5 5 4 4 4 3 4 
70 5 6 5 5 5 4 4 5 3 
15 5 6 5 5 5 4 1 
-100 5 6 5 5 5 4 4 4 2 3 4 2 5 1 5 4 4 
-115 5 6 5 5 5 4 4 4 1 5 3 2 1 3 3 2 4 6 
-200 5 6 5 5 5 4 4 4 2 3 4 2 5 1 
-400 5 6 5 5 5 4 4 4 2 3 4 2 5 1 5 
