125 6 5 5 5 3 4 6 5 6 
110 6 5 5 5 3 4 6 2 5 
110 6 5 5 5 3 4 6 2 2 
110 6 5 5 5 3 4 6 2 5 
110 6 5 5 5 3 4 6 2 2 
110 6 5 5 5 3 4 6 5 5 
85 6 5 5 5 3 4 6 4 5 
85 6 5 5 5 3 4 6 5 1 
85 6 5 5 5 3 4 6 2 4 
85 6 5 5 5 3 4 6 2 4 
85 6 5 5 5 3 4 6 2 1 
85 6 5 5 5 3 4 6 2 1 
85 6 5 5 5 3 4 6 2 1 
85 6 5 5 5 3 4 6 2 4 
85 6 5 5 5 3 4 6 2 4 
85 6 5 5 5 3 4 6 2 1 
75 6 5 5 5 3 4 6 6 
75 6 5 5 5 3 4 6 6 
75 6 5 5 5 3 4 6 6 
65 6 5 5 5 3 4 6 3 5 
65 6 5 5 5 3 4 6 2 3 
65 6 5 5 5 3 4 6 5 3 
65 6 5 5 5 3 4 6 5 3 
65 6 5 5 5 3 4 6 2 3 
60 6 5 5 5 3 4 6 4 1 5 
60 6 5 5 5 3 4 6 4 4 4 
60 6 5 5 5 3 4 6 4 1 1 
60 6 5 5 5 3 4 6 1 1 
60 6 5 5 5 3 4 6 4 4 3 
40 6 5 5 5 3 4 3 4 6 4 
20 6 5 5 5 3 4 3 6 3 
0 6 5 5 5 3 4 3 4 1 
0 6 5 5 5 3 4 3 2 
0 6 5 5 5 3 4 4 3 4 6 
-5 6 5 5 5 3 4 2 
-5 6 5 5 5 3 4 5 
-5 6 5 5 5 3 4 2 
-5 6 5 5 5 3 4 2 
-5 6 5 5 5 3 4 2 
-5 6 5 5 5 3 4 2 
-5 6 5 5 5 3 4 2 
-5 6 5 5 5 3 4 2 
-5 6 5 5 5 3 4 5 
-5 6 5 5 5 3 4 5 
-30 6 5 5 5 3 4 1 
-30 6 5 5 5 3 4 1 
-30 6 5 5 5 3 4 1 
-75 6 5 5 5 3 3 
