-20 4 5 5 5 5 3 5 1 4 2 2 4 4 2 6 
-125 4 5 5 5 5 3 5 1 4 2 2 4 4 
-160 4 5 5 5 5 3 5 1 4 2 2 4 4 2 6 6 
-175 4 5 5 5 5 3 5 1 4 2 
-175 4 5 5 5 5 3 5 1 4 2 2 4 4 2 3 5 
-175 4 5 5 5 5 3 5 1 4 2 2 4 4 2 
-175 4 5 5 5 5 3 5 1 4 2 2 4 4 5 
-175 4 5 5 5 5 3 5 1 
-185 4 5 5 5 5 3 5 1 5 
-185 4 5 5 5 5 3 5 1 4 3 6 4 
-185 4 5 5 5 5 3 5 1 4 2 2 4 4 2 6 
-185 4 5 5 5 5 3 5 1 4 3 6 
-200 4 5 5 5 5 3 5 1 4 2 2 4 4 2 
-200 4 5 5 5 5 3 5 1 4 2 2 
-200 4 5 5 5 5 3 5 1 
-200 4 5 5 5 5 3 5 1 4 2 2 4 4 2 6 4 
-200 4 5 5 5 5 3 5 1 2 
-200 4 5 5 5 5 3 5 1 4 2 
-200 4 5 5 5 5 3 5 1 4 2 2 4 6 
-200 4 5 5 5 5 3 5 1 4 2 2 4 
-200 4 5 5 5 5 3 5 1 4 2 2 5 
-200 4 5 5 5 5 3 5 1 4 2 2 4 6 
-200 4 5 5 5 5 3 5 1 4 2 2 4 4 
-200 4 5 5 5 5 3 5 1 4 3 
-200 4 5 5 5 5 3 5 1 4 2 2 
-200 4 5 5 5 5 3 5 1 4 2 
-200 4 5 5 5 5 3 5 1 4 1 
-200 4 5 5 5 5 3 5 1 4 2 1 
-200 4 5 5 5 5 3 5 1 4 
-200 4 5 5 5 5 3 5 1 5 
-200 4 5 5 5 5 3 5 1 4 2 
-205 4 5 5 5 5 3 5 1 4 2 2 4 4 2 6 3 
-205 4 5 5 5 5 3 5 1 4 2 2 4 4 2 6 1 
-205 4 5 5 5 5 3 5 1 4 2 2 4 4 2 6 
-205 4 5 5 5 5 3 5 1 4 2 2 4 4 2 6 3 
-205 4 5 5 5 5 3 5 5 
-205 4 5 5 5 5 3 5 1 4 2 2 4 4 2 6 3 
-205 4 5 5 5 5 3 5 1 4 2 2 4 4 4 
-205 4 5 5 5 5 3 5 1 4 2 2 4 4 1 
-205 4 5 5 5 5 3 5 1 4 2 2 4 4 2 2 
-205 4 5 5 5 5 3 5 1 4 2 2 4 4 2 6 6 
-205 4 5 5 5 5 3 5 1 4 2 2 4 4 2 6 4 
-225 4 5 5 5 5 3 5 1 4 3 4 2 
-225 4 5 5 5 5 3 5 1 4 2 2 4 4 1 
-230 4 5 5 5 5 3 5 1 4 2 2 4 4 2 4 
-230 4 5 5 5 5 3 5 1 4 2 2 4 4 4 
-515 4 5 5 5 5 3 5 1 4 2 2 4 4 2 
-515 4 5 5 5 5 3 5 1 4 2 2 4 
