205 5 6 5 5 5 4 4 4 2 6 5 
205 5 6 5 5 5 4 4 4 5 6 1 
190 5 6 5 5 5 4 4 4 1 5 2 4 
40 5 6 5 5 5 4 
40 5 6 5 5 5 4 
40 5 6 5 5 5 4 2 
40 5 6 5 5 5 4 
40 5 6 5 5 5 
40 5 6 5 5 5 4 
40 5 6 5 5 5 4 
40 5 6 5 5 5 4 
40 5 6 5 5 5 4 2 
40 5 6 5 5 5 
40 5 6 5 5 5 
40 5 6 5 5 5 
40 5 6 5 5 5 
40 5 6 5 5 5 
40 5 6 5 5 5 4 2 
40 5 6 5 5 5 
40 5 6 5 5 5 4 2 
40 5 6 5 5 5 4 
40 5 6 5 5 5 
40 5 6 5 5 5 
40 5 6 5 5 5 4 
40 5 6 5 5 5 
40 5 6 5 5 5 4 4 4 1 
40 5 6 5 5 5 4 4 4 1 
40 5 6 5 5 5 4 4 4 1 5 4 1 2 
40 5 6 5 5 5 4 4 4 1 5 4 
40 5 6 5 5 5 4 4 4 1 5 4 1 2 
40 5 6 5 5 5 4 4 4 1 5 4 
40 5 6 5 5 5 4 4 4 1 5 4 
40 5 6 5 5 5 4 4 4 1 
40 5 6 5 5 5 4 4 4 1 5 4 1 
40 5 6 5 5 5 4 4 4 1 5 
40 5 6 5 5 5 4 4 4 1 5 4 1 3 
40 5 6 5 5 5 4 4 4 1 5 4 1 3 2 2 4 5 3 3 3 6 5 
40 5 6 5 5 5 4 
35 5 6 5 5 5 4 4 4 1 5 1 
35 5 6 5 5 5 4 4 4 1 4 
35 5 6 5 5 5 4 4 4 1 
35 5 6 5 5 5 4 4 4 1 
-40 5 6 5 5 5 4 4 4 5 
-40 5 6 5 5 5 4 4 4 5 
-40 5 6 5 5 5 4 4 4 1 2 
-110 5 6 5 5 5 4 
-125 5 6 5 5 5 4 4 4 1 5 4 1 3 2 2 4 5 3 3 3 6 
-140 5 6 5 5 5 4 6 
