-25 5 4 5 5 5 5 2 
-50 5 4 5 5 5 4 5 
-75 6 6 4 5 5 5 5 3 3 
-115 5 6 4 5 5 5 5 4 1 
-115 5 6 4 5 5 5 5 3 5 1 2 
-115 5 6 4 5 5 2 1 6 
-115 5 6 4 5 5 2 1 5 
-115 5 6 4 5 5 5 5 3 2 
-165 5 6 4 5 4 2 
-175 1 4 5 5 5 5 3 5 1 2 6 3 
-175 1 4 5 5 5 5 3 5 1 2 6 5 
-175 1 4 5 5 5 5 3 5 1 2 6 5 6 
-175 1 4 5 5 5 5 3 5 1 2 6 5 6 5 
-175 1 4 5 5 5 5 3 5 1 2 6 3 
-175 1 4 5 5 5 5 3 5 1 2 6 5 6 5 
-175 1 4 5 5 5 5 3 5 1 2 6 5 6 5 6 
-175 1 4 5 5 5 5 3 5 1 2 6 5 6 5 6 6 
-175 1 4 5 5 5 5 3 5 1 2 6 5 6 5 6 
-180 5 4 5 5 5 5 3 
-190 5 6 4 5 5 6 2 
-195 2 4 5 5 5 5 3 5 1 3 1 1 6 4 1 5 5 
-200 1 2 4 5 5 5 5 4 1 5 
-205 5 4 5 5 5 5 2 
-205 5 5 4 5 
-205 5 6 4 5 5 5 5 3 1 
-225 5 4 5 5 5 5 1 
-225 5 4 5 5 5 5 3 
-225 5 4 5 5 5 5 6 
-225 5 4 5 5 5 5 4 
-225 5 4 5 5 5 5 4 
-225 5 4 5 5 5 5 6 
-230 5 4 5 5 2 4 
-230 5 4 5 5 5 3 
-230 5 4 5 5 4 
-230 5 4 5 5 5 6 1 
-230 5 4 5 5 5 3 
-230 5 4 5 5 5 6 4 
-230 5 4 5 5 5 5 
-230 5 4 5 5 5 
-230 5 4 5 5 5 6 
-230 5 4 5 5 5 
-230 4 2 4 5 5 5 6 
-440 5 6 4 5 5 5 5 
-465 5 4 5 5 5 6 
-505 5 4 5 
-505 5 4 5 5 6 
-535 5 4 5 5 
-535 5 4 5 5 
