1125 6 5 5 5 6 4 3 4 6 2 2 3 6 5 5 5 5 4 3 4 6 2 2 2 2 1 3 5 6 2 6 4 2 
1115 6 5 5 5 6 4 3 4 6 2 2 3 6 5 5 5 5 4 3 4 6 2 2 2 2 1 3 5 6 2 6 6 
1105 6 5 5 5 6 4 3 4 6 2 2 3 6 5 5 5 5 4 3 4 6 2 2 2 2 1 3 5 3 6 5 6 5 
1105 6 5 5 5 6 4 3 4 6 2 2 3 6 5 5 5 5 4 3 4 6 2 2 2 2 1 3 5 6 6 2 3 5 
1100 6 5 5 5 6 4 3 4 6 2 2 3 6 5 5 5 5 4 3 4 6 2 2 2 2 1 3 5 6 5 6 2 
1100 6 5 5 5 6 4 3 4 6 2 2 3 6 5 5 5 5 4 3 4 6 2 2 2 2 1 3 5 6 5 4 1 6 
1100 6 5 5 5 6 4 3 4 6 2 2 3 6 5 5 5 5 4 3 4 6 2 2 2 2 1 3 5 6 2 6 2 
1100 6 5 5 5 6 4 3 4 6 2 2 3 6 5 5 5 5 4 3 4 6 2 2 2 2 1 3 5 6 6 2 5 
1090 6 5 5 5 6 4 3 4 6 2 2 3 6 5 5 5 5 4 3 4 6 2 2 2 2 1 3 4 6 6 6 1 4 4 
1085 6 5 5 5 6 4 3 4 6 2 2 3 6 5 5 5 5 4 3 4 6 2 2 2 2 1 3 5 6 5 5 2 
1080 6 5 5 5 6 4 3 4 6 2 2 3 6 5 5 5 5 4 3 4 6 2 2 2 2 1 3 5 6 6 3 4 5 4 
1075 6 5 5 5 6 4 3 4 6 2 2 3 6 5 5 5 5 4 3 4 6 2 2 2 2 1 3 5 6 6 1 5 
1075 6 5 5 5 6 4 3 4 6 2 2 3 6 5 5 5 5 4 3 4 6 2 2 2 2 1 3 5 6 6 1 2 
1075 6 5 5 5 6 4 3 4 6 2 2 3 6 5 5 5 5 4 3 4 6 2 2 2 2 1 3 5 6 6 2 4 
1075 6 5 5 5 6 4 3 4 6 2 2 3 6 5 5 5 5 4 3 4 6 2 2 2 2 1 3 5 6 6 5 4 
1075 6 5 5 5 6 4 3 4 6 2 2 3 6 5 5 5 5 4 3 4 6 2 2 2 2 1 3 5 6 6 1 4 4 
1075 6 5 5 5 6 4 3 4 6 2 2 3 6 5 5 5 5 4 3 4 6 2 2 2 2 1 3 5 6 6 1 5 
1075 6 5 5 5 6 4 3 4 6 2 2 3 6 5 5 5 5 4 3 4 6 2 2 2 2 1 3 5 6 6 2 1 
1075 6 5 5 5 6 4 3 4 6 2 2 3 6 5 5 5 5 4 3 4 6 2 2 2 2 1 3 5 6 6 1 5 
1070 6 5 5 5 6 4 3 4 6 2 2 3 6 5 5 5 5 4 3 4 6 2 2 2 2 1 3 5 6 6 3 6 
1065 6 5 5 5 6 4 3 4 6 2 2 3 6 5 5 5 5 4 3 4 6 2 1 2 2 2 1 2 6 5 3 2 3 5 
1065 6 5 5 5 6 4 3 4 6 2 2 3 6 5 5 5 5 4 3 4 6 2 2 2 2 1 3 5 6 6 6 
1065 6 5 5 5 6 4 3 4 6 2 2 3 6 5 5 5 5 4 3 4 6 2 2 2 2 1 3 5 6 6 6 
1065 6 5 5 5 6 4 3 4 6 2 2 3 6 5 5 5 5 4 3 4 6 2 2 2 2 1 3 5 6 6 6 
1065 6 5 5 5 6 4 3 4 6 2 2 3 6 5 5 5 5 4 3 4 6 2 2 2 2 1 3 5 6 6 6 
1060 6 5 5 5 6 4 3 4 6 2 2 3 6 5 5 5 5 4 3 4 6 2 2 2 2 1 3 5 6 2 4 1 1 
1060 6 5 5 5 6 4 3 4 6 2 2 3 6 5 5 5 5 4 3 4 6 2 2 2 2 1 3 5 6 2 5 1 
1060 6 5 5 5 6 4 3 4 6 2 2 3 6 5 5 5 5 4 3 4 6 2 2 2 2 1 3 5 6 2 5 1 
1055 6 5 5 5 6 4 3 4 6 2 2 3 6 5 5 5 5 4 3 4 6 2 2 2 2 1 3 5 6 6 3 4 4 6 
1055 6 5 5 5 6 4 3 4 6 2 2 3 6 5 5 5 5 4 3 4 6 2 2 2 2 1 3 5 6 6 3 2 
1055 6 5 5 5 6 4 3 4 6 2 2 3 6 5 5 5 5 4 3 4 6 2 2 2 2 1 3 5 6 6 3 2 
1055 6 5 5 5 6 4 3 4 6 2 2 3 6 5 5 5 5 4 3 4 6 2 2 2 2 1 3 5 6 6 3 2 
1045 6 5 5 5 6 4 3 4 6 2 2 3 6 5 5 5 5 4 3 4 6 2 2 2 2 1 3 5 5 5 4 2 
1040 6 5 5 5 6 4 3 4 6 2 2 3 6 5 5 5 5 4 3 4 6 2 2 2 2 1 3 5 6 5 4 3 1 5 
1035 6 5 5 5 6 4 3 4 6 2 2 3 6 5 5 5 5 4 3 4 6 2 2 2 2 1 3 5 5 6 2 
1035 6 5 5 5 6 4 3 4 6 2 2 3 6 5 5 5 5 4 3 4 6 2 2 2 2 1 3 5 6 5 2 
1035 6 5 5 5 6 4 3 4 6 2 2 3 6 5 5 5 5 4 3 4 6 2 2 2 2 1 3 5 6 5 2 
1035 6 5 5 5 6 4 3 4 6 2 2 3 6 5 5 5 5 4 3 4 6 2 2 2 2 1 3 5 6 5 2 
1035 6 5 5 5 6 4 3 4 6 2 2 3 6 5 5 5 5 4 3 4 6 2 2 2 2 2 3 1 5 6 1 1 
1035 6 5 5 5 6 4 3 4 6 2 2 3 6 5 5 5 5 4 3 4 6 2 2 2 2 1 3 5 6 4 4 5 
1025 6 5 5 5 6 4 3 4 6 2 2 3 6 5 5 5 5 4 3 4 6 2 2 2 2 1 6 3 4 5 6 
1025 6 5 5 5 6 4 3 4 6 2 2 3 6 5 5 5 5 4 3 4 6 2 2 2 2 1 3 5 1 5 1 3 2 
1020 6 5 5 5 6 4 3 4 6 2 2 3 6 5 5 5 5 4 3 4 6 2 2 2 2 2 3 5 5 4 5 
1020 6 5 5 5 6 4 3 4 6 2 2 3 6 5 5 5 5 4 3 4 6 2 2 2 2 1 1 5 3 5 4 5 
1020 6 5 5 5 6 4 3 4 6 2 2 3 6 5 5 5 5 4 3 4 6 2 2 2 2 1 3 4 2 4 5 5 
1015 6 5 5 5 6 4 3 4 6 2 2 3 6 5 5 5 5 4 3 4 6 2 2 2 2 1 6 3 6 6 
1015 6 5 5 5 6 4 3 4 6 2 2 3 6 5 5 5 5 4 3 4 6 2 2 2 2 1 6 6 5 4 1 
1010 6 5 5 5 6 4 3 4 6 2 2 3 6 5 5 5 5 4 3 4 6 2 2 2 2 1 3 5 6 6 3 3 
1010 6 5 5 5 6 4 3 4 6 2 2 3 6 5 5 5 5 4 3 4 6 2 2 2 2 1 3 5 6 4 5 
1010 6 5 5 5 6 4 3 4 6 2 2 3 6 5 5 5 5 4 3 4 6 2 2 2 2 1 3 2 4 6 2 
1010 6 5 5 5 6 4 3 4 6 2 2 3 6 5 5 5 5 4 3 4 6 2 2 2 2 1 3 5 6 4 2 
1010 6 5 5 5 6 4 3 4 6 2 2 3 6 5 5 5 5 4 3 4 6 2 2 2 2 1 3 5 6 4 5 
1010 6 5 5 5 6 4 3 4 6 2 2 3 6 5 5 5 5 4 3 4 6 2 2 2 2 1 3 5 6 1 2 
1005 6 5 5 5 6 4 3 4 6 2 2 3 6 5 5 5 5 4 3 4 6 2 2 2 2 1 6 6 6 3 
995 6 5 5 5 6 4 3 4 6 2 2 3 6 5 5 5 5 4 3 4 6 2 2 2 2 1 3 5 3 6 3 5 
995 6 5 5 5 6 4 3 4 6 2 2 3 6 5 5 5 5 4 3 4 6 2 2 2 2 1 6 6 2 
990 6 5 5 5 6 4 3 4 6 2 2 3 6 5 5 5 5 4 3 4 6 2 2 2 2 1 3 5 6 3 2 
990 6 5 5 5 6 4 3 4 6 2 2 3 6 5 5 5 5 4 3 4 6 2 2 2 2 1 3 5 6 5 3 
990 6 5 5 5 6 4 3 4 6 2 2 3 6 5 5 5 5 4 3 4 6 2 2 2 1 1 1 3 5 5 6 3 
985 6 5 5 5 6 4 3 4 6 2 2 3 6 5 5 5 5 4 3 4 6 2 2 2 2 1 3 5 6 4 1 
985 6 5 5 5 6 4 3 4 6 2 2 3 6 5 5 5 5 4 3 4 6 2 2 2 2 1 3 5 6 1 1 
980 6 5 5 5 6 4 3 4 6 2 2 3 6 5 5 5 5 4 3 4 6 2 2 2 2 1 6 5 2 
975 6 5 5 5 6 4 3 4 6 2 2 3 6 5 5 5 5 4 3 4 6 2 2 2 2 1 6 6 3 1 
970 6 5 5 5 6 4 3 4 6 2 2 3 6 5 5 5 5 4 3 4 6 2 2 2 2 1 3 5 5 2 
970 6 5 5 5 6 4 3 4 6 2 2 3 6 5 5 5 5 4 3 4 6 2 2 2 2 1 6 6 1 
970 6 5 5 5 6 4 3 4 6 2 2 3 6 5 5 5 5 4 3 4 6 2 2 2 2 1 3 5 5 2 
945 6 5 5 5 6 4 3 4 6 2 2 3 6 5 5 5 5 4 3 4 6 2 2 2 2 1 3 1 4 1 2 
945 6 5 5 5 6 4 3 4 6 2 2 3 6 5 5 5 5 4 3 4 6 2 2 2 2 1 3 5 1 2 
945 6 5 5 5 6 4 3 4 6 2 2 3 6 5 5 5 5 4 3 4 6 2 2 2 2 1 3 5 4 2 
940 6 5 5 5 6 4 3 4 6 2 2 3 6 5 5 5 5 4 3 4 6 2 2 2 1 1 1 1 2 2 
940 6 5 5 5 6 4 3 4 6 2 2 3 6 5 5 5 5 4 3 4 6 2 2 2 2 1 1 5 2 
930 6 5 5 5 6 4 3 4 6 2 2 3 6 5 5 5 5 4 3 4 6 2 2 2 2 1 3 2 3 3 2 
930 6 5 5 5 6 4 3 4 6 2 2 3 6 5 5 5 5 4 3 4 6 2 2 2 2 1 6 2 
925 6 5 5 5 6 4 3 4 6 2 2 3 6 5 5 5 5 4 3 4 6 2 2 2 2 1 3 5 5 3 
925 6 5 5 5 6 4 3 4 6 2 2 3 6 5 5 5 5 4 3 4 6 2 2 2 2 1 3 5 3 5 
920 6 5 5 5 6 4 3 4 6 2 2 3 6 5 5 5 5 4 3 4 6 2 2 2 2 1 3 1 1 1 1 
920 6 5 5 5 6 4 3 4 6 2 2 3 6 5 5 5 5 4 3 4 6 2 2 2 2 1 3 5 2 
920 6 5 5 5 6 4 3 4 6 2 2 3 6 5 5 5 5 4 3 4 6 2 2 2 2 1 4 3 2 1 
920 6 5 5 5 6 4 3 4 6 2 2 3 6 5 5 5 5 4 3 4 6 2 2 2 2 1 3 5 2 
920 6 5 5 5 6 4 3 4 6 2 2 3 6 5 5 5 5 4 3 4 6 2 2 2 2 1 3 5 2 
920 6 5 5 5 6 4 3 4 6 2 2 3 6 5 5 5 5 4 3 4 6 2 2 2 2 1 3 5 1 1 
920 6 5 5 5 6 4 3 4 6 2 2 3 6 5 5 5 5 4 3 4 6 2 2 2 2 1 3 5 2 
920 6 5 5 5 6 4 3 4 6 2 2 3 6 5 5 5 5 4 3 4 6 2 2 2 2 1 3 5 2 
905 6 5 5 5 6 4 3 4 6 2 2 3 6 5 5 5 5 4 3 4 6 2 2 2 2 1 1 6 
905 6 5 5 5 6 4 3 4 6 2 2 3 6 5 5 5 5 4 3 4 6 2 2 2 2 1 3 3 3 2 1 
905 6 5 5 5 6 4 3 4 6 2 2 3 6 5 5 5 5 4 3 4 6 2 2 2 2 1 1 6 
905 6 5 5 5 6 4 3 4 6 2 2 3 6 5 5 5 5 4 3 4 6 2 2 2 2 1 6 1 
905 6 5 5 5 6 4 3 4 6 2 2 3 6 5 5 5 5 4 3 4 6 2 2 2 2 1 6 1 
905 6 5 5 5 6 4 3 4 6 2 2 3 6 5 5 5 5 4 3 4 6 2 2 2 2 1 6 4 
900 6 5 5 5 6 4 3 4 6 2 2 3 6 5 5 5 5 4 3 4 6 2 2 2 2 1 3 5 1 3 
900 6 5 5 5 6 4 3 4 6 2 2 3 6 5 5 5 5 4 3 4 6 2 2 2 2 1 3 5 4 3 
900 6 5 5 5 6 4 3 4 6 2 2 3 6 5 5 5 5 4 3 4 6 2 2 2 2 1 3 5 3 1 
900 6 5 5 5 6 4 3 4 6 2 2 3 6 5 5 5 5 4 3 4 6 2 2 2 2 1 3 5 1 3 
900 6 5 5 5 6 4 3 4 6 2 2 3 6 5 5 5 5 4 3 4 6 2 2 2 2 1 1 3 5 3 
885 6 5 5 5 6 4 3 4 6 2 2 3 6 5 5 5 5 4 3 4 6 2 2 2 2 1 3 5 3 3 3 
865 6 5 5 5 6 4 3 4 6 2 2 3 6 5 5 5 5 4 3 4 6 2 2 2 2 1 2 
865 6 5 5 5 6 4 3 4 6 2 2 3 6 5 5 5 5 4 3 4 6 2 2 2 2 1 1 1 
865 6 5 5 5 6 4 3 4 6 2 2 3 6 5 5 5 5 4 3 4 6 2 2 2 2 1 5 
865 6 5 5 5 6 4 3 4 6 2 2 3 6 5 5 5 5 4 3 4 6 2 2 2 2 1 2 
865 6 5 5 5 6 4 3 4 6 2 2 3 6 5 5 5 5 4 3 4 6 2 2 2 2 1 5 
865 6 5 5 5 6 4 3 4 6 2 2 3 6 5 5 5 5 4 3 4 6 2 2 2 2 1 1 4 
865 6 5 5 5 6 4 3 4 6 2 2 3 6 5 5 5 5 4 3 4 6 2 2 2 2 1 5 
865 6 5 5 5 6 4 3 4 6 2 2 3 6 5 5 5 5 4 3 4 6 2 2 2 2 1 2 
855 6 5 5 5 6 4 3 4 6 2 2 3 6 5 5 5 5 4 3 4 6 2 2 2 2 6 
855 6 5 5 5 6 4 3 4 6 2 2 3 6 5 5 5 5 4 3 4 6 2 2 2 1 1 6 
855 6 5 5 5 6 4 3 4 6 2 2 3 6 5 5 5 5 4 3 4 6 2 2 2 2 6 
850 6 5 5 5 6 4 3 4 6 2 2 3 6 5 5 5 5 4 3 4 6 2 2 2 2 1 3 3 4 
840 6 5 5 5 6 4 3 4 6 2 2 3 6 5 5 5 5 4 3 4 6 2 2 2 2 5 
840 6 5 5 5 6 4 3 4 6 2 2 3 6 5 5 5 5 4 3 4 6 2 2 2 2 5 
840 6 5 5 5 6 4 3 4 6 2 2 3 6 5 5 5 5 4 3 4 6 2 2 2 2 5 
840 6 5 5 5 6 4 3 4 6 2 2 3 6 5 5 5 5 4 3 4 6 2 2 2 2 5 
830 6 5 5 5 6 4 3 4 6 2 2 3 6 5 5 5 5 4 3 4 6 2 2 2 1 6 
815 6 5 5 5 6 4 3 4 6 2 2 3 6 5 5 5 5 4 3 4 6 2 2 2 2 4 
815 6 5 5 5 6 4 3 4 6 2 2 3 6 5 5 5 5 4 3 4 6 2 2 2 2 4 
815 6 5 5 5 6 4 3 4 6 2 2 3 6 5 5 5 5 4 3 4 6 2 2 2 1 5 
815 6 5 5 5 6 4 3 4 6 2 2 3 6 5 5 5 5 4 3 4 6 2 2 2 2 4 
805 6 5 5 5 6 4 3 4 6 2 2 3 6 5 5 5 5 4 3 4 6 2 2 2 6 
795 6 5 5 5 6 4 3 4 6 2 2 3 6 5 5 5 5 4 3 4 6 2 2 2 2 3 
795 6 5 5 5 6 4 3 4 6 2 2 3 6 5 5 5 5 4 3 4 6 2 2 2 2 3 
795 6 5 5 5 6 4 3 4 6 2 2 3 6 5 5 5 5 4 3 4 6 2 2 2 2 3 
790 6 5 5 5 6 4 3 4 6 2 2 3 6 5 5 5 5 4 3 4 6 2 2 2 5 
790 6 5 5 5 6 4 3 4 6 2 2 3 6 5 5 5 5 4 3 4 6 2 2 2 5 
790 6 5 5 5 6 4 3 4 6 2 2 3 6 5 5 5 5 4 3 4 6 2 2 2 1 4 
770 6 5 5 5 6 4 3 4 6 2 2 3 6 5 5 5 5 4 3 4 6 2 2 2 1 3 
765 6 5 5 5 6 4 3 4 6 2 2 3 6 5 5 5 5 4 3 4 6 2 2 2 4 
745 6 5 5 5 6 4 3 4 6 2 2 3 6 5 5 5 5 4 3 4 6 2 2 2 3 
745 6 5 5 5 6 4 3 4 6 2 2 3 6 5 5 5 5 4 3 4 6 2 2 2 3 
740 6 5 5 5 6 4 3 4 6 2 2 3 6 5 5 5 5 4 3 4 6 2 2 5 
