620 4 2 5 5 5 5 5 3 4 3 2 4 2 2 5 6 4 6 6 6 5 
565 4 2 5 5 5 5 5 3 4 3 2 4 2 2 5 6 1 6 5 4 5 4 
515 4 2 5 5 5 5 5 3 4 3 2 4 2 2 5 6 1 6 4 2 
455 4 2 5 5 5 5 5 3 4 3 2 4 2 2 5 6 3 5 2 
455 4 2 5 5 5 5 5 3 4 3 2 4 2 2 5 6 1 4 3 2 
450 4 2 5 5 5 5 5 3 4 3 2 4 2 2 5 1 6 4 2 
445 4 2 5 5 5 5 5 3 4 3 2 4 2 2 5 6 3 6 4 
430 4 2 5 5 5 5 5 3 4 3 2 4 2 2 5 6 1 3 4 1 
425 4 2 5 5 5 5 5 3 4 3 2 4 2 2 5 6 1 5 
425 4 2 5 5 5 5 5 3 4 3 2 4 2 2 5 6 5 4 
425 4 2 5 5 5 5 5 3 4 3 2 4 2 2 5 6 1 2 
425 4 2 5 5 5 5 5 3 4 3 2 4 2 2 5 6 1 4 4 
425 4 2 5 5 5 5 5 3 4 3 2 4 2 2 5 6 1 5 
425 4 2 5 5 5 5 5 3 4 3 2 4 2 2 5 6 4 5 
415 4 2 5 5 5 5 5 3 4 3 2 4 2 2 5 6 6 
410 4 2 5 5 5 5 5 3 4 3 2 1 5 2 2 4 5 4 1 
410 4 2 5 5 5 5 5 3 4 3 2 4 2 2 5 6 1 3 3 1 
405 4 2 5 5 5 5 5 3 4 3 2 4 2 2 5 6 1 3 1 
405 4 2 5 5 5 5 5 3 4 3 2 4 2 2 5 6 3 4 1 
400 4 2 5 5 5 5 5 3 4 3 2 4 2 2 5 6 1 1 
400 4 2 5 5 5 5 5 3 4 3 2 4 2 2 5 6 2 
400 4 2 5 5 5 5 5 3 4 3 2 4 2 2 5 1 6 1 
400 4 2 5 5 5 5 5 3 4 3 2 4 2 2 5 6 1 1 
360 4 2 5 5 5 5 5 3 4 3 2 4 2 2 5 1 2 
335 4 2 5 5 5 5 5 3 4 3 2 4 2 2 5 1 4 
335 4 2 5 5 5 5 5 3 4 3 2 5 2 4 1 1 5 
335 4 2 5 5 5 5 5 3 4 3 2 5 2 2 1 2 
335 4 2 5 5 5 5 5 3 4 3 2 4 2 2 5 2 
330 4 2 5 5 5 5 5 3 4 3 2 5 1 3 1 5 6 
325 4 2 5 5 5 5 5 3 4 3 2 5 2 1 1 6 
325 4 2 5 5 5 5 5 3 4 3 2 5 2 5 6 
325 4 2 5 5 5 5 5 3 4 3 2 5 2 5 6 
315 4 2 5 5 5 5 5 6 2 4 4 1 2 5 
310 4 2 5 5 5 5 5 3 4 3 2 5 2 1 4 5 
310 4 2 5 5 5 5 5 3 4 3 2 5 2 5 2 
305 4 2 5 5 5 5 5 3 4 3 2 5 1 3 1 4 6 
300 4 2 5 5 5 5 5 3 4 3 2 5 4 6 5 
295 4 2 5 5 5 5 5 3 4 3 2 5 6 3 6 
295 4 2 5 5 5 5 5 3 4 3 2 5 4 3 3 5 5 
290 4 2 5 5 5 5 5 3 4 3 2 5 5 1 1 3 1 
290 4 2 5 5 5 5 5 3 4 3 2 5 2 3 4 2 
285 4 2 5 5 5 5 5 3 4 3 2 3 5 3 6 5 
280 4 2 5 5 5 5 5 3 4 3 2 3 2 2 6 
280 4 2 5 5 5 5 5 3 4 3 2 6 5 1 3 1 
275 4 2 5 5 5 5 5 3 4 3 2 5 6 4 4 
275 4 2 5 5 5 5 5 3 4 3 2 4 5 5 3 1 3 3 
275 4 2 5 5 5 5 5 3 4 3 2 2 5 4 1 3 3 3 
275 4 2 5 5 5 5 5 3 4 3 2 5 6 4 4 
