225 6 5 5 5 3 4 6 6 2 1 5 4 2 6 6 4 6 1 2 2 1 1 2 
225 6 5 5 5 3 4 6 6 2 1 5 4 2 6 6 4 6 1 2 2 1 1 2 2 1 
225 6 5 5 5 3 4 6 6 2 1 5 4 2 6 6 4 6 1 2 2 1 1 2 2 1 
225 6 5 5 5 3 4 6 6 2 1 5 4 2 6 6 4 6 1 2 2 1 1 2 2 1 
225 6 5 5 5 3 4 6 6 2 1 5 4 2 6 6 4 6 1 2 2 1 1 2 
225 6 5 5 5 3 4 6 6 2 1 5 4 2 6 6 4 6 1 2 2 1 1 2 2 1 
225 6 5 5 5 3 4 6 6 2 1 5 4 2 6 6 4 6 1 2 2 1 1 2 2 1 
225 6 5 5 5 3 4 6 6 2 1 5 4 2 6 6 4 6 1 2 2 1 1 2 
225 6 5 5 5 3 4 6 6 2 1 5 4 2 6 6 4 6 1 2 2 1 1 2 2 1 
225 6 5 5 5 3 4 6 6 2 1 5 4 2 6 6 4 6 1 2 2 1 1 2 2 
225 6 5 5 5 3 4 6 6 2 1 5 4 2 6 6 4 6 1 2 2 1 1 2 2 
225 6 5 5 5 3 4 6 6 2 1 5 4 2 6 6 4 6 1 2 2 1 1 2 2 1 
225 6 5 5 5 3 4 6 6 2 1 5 4 2 6 6 4 6 1 2 2 1 1 2 
225 6 5 5 5 3 4 6 6 2 1 5 4 2 6 6 4 6 1 2 2 1 1 2 
225 6 5 5 5 3 4 6 6 2 1 5 4 2 6 6 4 6 1 2 2 1 1 2 
225 6 5 5 5 3 4 6 6 2 1 5 4 2 6 6 4 6 1 2 2 1 1 2 
225 6 5 5 5 3 4 6 6 2 1 5 4 2 6 6 4 6 1 2 2 1 1 2 
225 6 5 5 5 3 4 6 6 2 1 5 4 2 6 6 4 6 1 2 2 1 1 2 2 1 
225 6 5 5 5 3 4 6 6 2 1 5 4 2 6 6 4 6 1 2 2 1 1 2 2 1 
225 6 5 5 5 3 4 6 6 2 1 5 4 2 6 6 4 6 1 2 2 1 1 2 2 
225 6 5 5 5 3 4 6 6 2 1 5 4 2 6 6 4 6 1 2 2 1 1 2 2 1 
225 6 5 5 5 3 4 6 6 2 1 5 4 2 6 6 4 6 1 2 2 1 1 2 2 1 
225 6 5 5 5 3 4 6 6 2 1 5 4 2 6 6 4 6 1 2 2 1 1 2 
225 6 5 5 5 3 4 6 6 2 1 5 4 2 6 6 4 6 1 2 2 1 1 2 2 
225 6 5 5 5 3 4 6 6 2 1 5 4 2 6 6 4 6 1 2 2 1 1 2 2 
225 6 5 5 5 3 4 6 6 2 1 5 4 2 6 6 4 6 1 2 2 1 
225 6 5 5 5 3 4 6 6 2 1 5 4 2 6 6 4 6 1 2 2 2 2 
225 6 5 5 5 3 4 6 6 2 1 5 4 2 6 6 4 6 1 2 2 1 2 
225 6 5 5 5 3 4 6 6 2 1 5 4 2 6 6 4 6 1 2 2 1 
225 6 5 5 5 3 4 6 6 2 1 5 4 2 6 6 4 6 1 2 2 1 1 1 
225 6 5 5 5 3 4 6 6 2 1 5 4 2 6 6 4 6 1 2 2 
225 6 5 5 5 3 4 6 6 2 1 5 4 2 6 6 4 6 1 2 
225 6 5 5 5 3 4 6 6 2 1 5 4 2 6 6 4 6 1 2 2 
225 6 5 5 5 3 4 6 6 2 1 5 4 2 6 6 4 6 1 2 2 
225 6 5 5 5 3 4 6 6 2 1 5 4 2 6 6 4 6 1 2 2 1 
225 6 5 5 5 3 4 6 6 2 1 5 4 2 6 6 4 6 1 2 2 1 
225 6 5 5 5 3 4 6 6 2 1 5 4 2 6 6 4 6 1 2 2 
225 6 5 5 5 3 4 6 6 2 1 5 4 2 6 1 6 4 4 3 1 6 
225 6 5 5 5 3 4 6 6 2 1 5 4 2 6 6 4 6 1 2 2 1 
225 6 5 5 5 3 4 6 6 2 1 5 4 2 6 6 4 4 3 5 5 1 
225 6 5 5 5 3 4 6 6 2 1 5 4 2 6 6 4 6 1 2 2 
225 6 5 5 5 3 4 6 6 2 1 5 4 2 6 6 4 6 1 2 2 
225 6 5 5 5 3 4 6 6 2 1 5 4 2 6 6 4 6 1 2 
225 6 5 5 5 3 4 6 6 2 1 5 4 2 6 6 4 6 1 2 2 1 
225 6 5 5 5 3 4 6 6 2 1 5 4 2 6 6 4 6 1 2 2 1 
225 6 5 5 5 3 4 6 6 2 1 5 4 2 6 6 4 6 1 
225 6 5 5 5 3 4 6 6 2 1 5 4 2 6 6 4 6 1 2 
225 6 5 5 5 3 4 6 6 2 1 5 4 2 6 6 4 6 1 2 
