205 2 4 5 5 5 6 4 4 4 6 1 5 2 
130 2 4 5 5 5 6 4 5 6 
130 2 4 5 5 5 3 5 5 2 2 
120 2 4 5 5 5 6 4 3 5 2 
120 2 4 5 5 5 6 6 6 
120 2 4 5 5 5 3 5 5 1 6 
110 2 4 5 5 5 6 3 6 2 
110 2 4 5 5 5 6 3 6 5 
105 2 4 5 5 5 6 2 6 
105 2 4 5 5 5 3 5 2 1 2 
105 2 4 5 5 5 6 2 6 
105 2 4 5 5 5 6 2 6 
105 2 4 5 5 5 6 2 6 
105 2 4 5 5 5 6 2 6 
105 2 4 5 5 5 6 2 6 
105 2 4 5 5 5 6 6 5 
105 2 4 5 5 5 6 6 2 
105 2 4 5 5 5 6 2 6 
105 2 4 5 5 5 6 2 6 
105 2 4 5 5 5 6 2 6 
95 2 4 5 5 5 3 6 2 5 
95 2 4 5 5 5 6 3 2 2 
95 1 2 5 5 3 5 6 5 2 
95 2 4 5 5 5 6 3 4 2 1 
95 2 4 5 5 5 6 3 5 2 
95 2 4 5 5 5 6 2 3 2 
90 2 4 5 5 5 6 2 2 
90 2 4 5 5 5 6 2 5 
90 2 4 5 5 5 6 2 2 
90 2 4 5 5 5 6 2 5 
90 2 4 5 5 5 6 2 2 
90 2 4 5 5 5 6 4 4 4 4 
90 2 4 5 5 5 6 2 2 
90 2 4 5 5 5 6 4 4 4 1 
90 2 4 5 5 5 6 2 2 
90 2 4 5 5 5 3 6 3 4 6 
90 2 4 5 5 5 6 2 2 
90 2 4 5 5 5 6 2 2 
90 2 4 5 5 5 5 5 6 
90 2 4 5 5 5 6 2 2 
90 2 4 5 5 5 6 2 5 
90 2 4 5 5 5 6 2 2 
90 2 4 5 5 5 6 2 2 
90 2 4 5 5 5 6 2 5 
90 2 4 5 5 5 6 2 5 
90 2 4 5 5 5 6 2 5 
90 2 4 5 5 5 6 2 2 
90 2 4 5 5 5 6 2 2 
90 2 4 5 5 5 6 2 2 
90 2 4 5 5 5 6 2 2 
90 2 4 5 5 5 6 2 2 
90 2 4 5 5 5 6 2 5 
80 2 4 5 5 5 3 5 4 5 1 
80 2 4 5 5 5 6 4 6 
80 2 4 5 5 5 6 4 6 
80 2 4 5 5 5 6 4 6 
80 2 4 5 5 5 6 6 4 
80 2 4 5 5 5 6 6 4 
80 2 4 5 5 5 6 6 1 
80 2 4 5 5 5 6 3 3 4 3 5 
75 2 4 5 5 5 6 3 3 2 4 
70 2 4 5 5 5 6 2 3 4 
70 2 4 5 5 5 6 3 5 1 
70 2 4 5 5 5 6 2 3 4 
70 2 4 5 5 5 6 4 4 4 3 
70 2 4 5 5 5 6 2 3 4 
70 2 4 5 5 5 6 4 4 1 3 
70 2 4 5 5 5 6 3 1 5 
70 2 4 5 5 5 6 2 3 1 
70 2 4 5 5 5 6 3 5 1 
70 2 4 5 5 5 6 3 1 2 
70 2 4 5 5 5 6 4 2 3 
65 2 4 5 5 5 6 2 1 
65 2 4 5 5 5 6 2 4 
65 2 4 5 5 5 6 2 4 
65 2 4 5 5 5 6 5 4 
65 2 4 5 5 5 6 2 1 
65 2 4 5 5 5 6 2 4 
65 2 4 5 5 5 6 2 4 
65 2 4 5 5 5 6 2 1 
65 2 4 5 5 5 6 2 1 
65 2 4 5 5 5 6 2 4 
65 2 4 5 5 5 6 2 1 
65 2 4 5 5 5 6 2 4 
65 2 4 5 5 5 6 2 1 
65 2 4 5 5 5 6 5 4 
65 2 4 5 5 5 6 2 1 
65 2 4 5 5 5 6 2 4 
65 2 4 5 5 5 6 2 4 
65 2 4 5 5 5 6 2 1 
65 2 4 5 5 5 6 2 4 
65 2 4 5 5 5 6 2 4 
65 2 4 5 5 5 6 2 4 
65 2 4 5 5 5 6 2 1 
65 2 4 5 5 5 6 2 4 
65 2 4 5 5 5 6 2 1 
65 2 4 5 5 5 6 2 1 
65 2 4 5 5 5 6 2 4 
65 2 4 5 5 5 6 2 1 
65 2 4 5 5 5 6 5 1 
65 2 4 5 5 5 6 2 1 
65 2 4 5 5 5 5 6 4 
60 3 3 2 5 5 5 3 4 3 6 1 1 
45 2 4 5 5 5 6 5 3 
45 2 4 5 5 5 6 5 3 
15 2 4 5 5 5 6 1 
15 2 4 5 5 5 6 1 
15 2 4 5 5 5 6 1 
15 2 4 5 5 5 6 1 
15 2 4 5 5 5 6 1 
15 2 4 5 5 5 6 1 
15 2 4 5 5 5 6 1 
15 2 4 5 5 5 6 1 
15 2 4 5 5 5 6 1 
15 2 4 5 5 5 6 1 
-20 2 4 5 5 5 3 2 
-20 2 4 5 5 5 5 3 
-20 2 4 5 5 5 3 4 1 
-20 2 4 5 5 5 3 2 
-25 2 4 5 5 5 2 
-25 2 4 5 5 5 2 
-25 2 4 5 5 5 2 
-25 2 4 5 5 5 2 
-25 2 4 5 5 5 2 
-25 2 4 5 5 5 2 
-45 2 4 5 5 5 3 1 
-45 2 4 5 5 5 3 1 
-50 2 4 5 5 5 4 
-50 2 4 5 5 5 4 
-50 2 4 5 5 5 4 
-50 2 4 5 5 5 1 
-50 2 4 5 5 5 1 
-50 2 4 5 5 5 1 
-50 2 4 5 5 5 4 
-50 2 4 5 5 5 1 
-50 2 4 5 5 5 1 
-50 2 4 5 5 5 1 
-50 2 4 5 5 5 1 
-50 2 4 5 5 5 1 
-50 2 4 5 5 5 1 
-50 2 4 5 5 5 4 
-50 2 4 5 5 5 4 
-50 2 4 5 5 5 4 
-50 2 4 5 5 5 4 
-50 2 4 5 5 5 4 
-50 2 4 5 5 5 4 
-50 2 4 5 5 5 4 
-50 2 4 5 5 5 4 
-50 2 4 5 5 5 1 
-50 2 4 5 5 5 4 
-50 2 4 5 5 5 4 
-65 2 4 5 5 5 3 3 
-65 2 4 5 5 5 3 3 
-70 2 6 5 6 
-70 4 4 6 5 6 
-75 1 5 5 5 2 
-85 2 6 5 2 
-95 3 3 1 6 3 5 2 
-110 5 6 5 1 
-110 5 6 5 4 
-120 5 6 6 
-120 2 6 6 
-120 3 4 1 3 3 5 6 
-125 4 1 4 5 2 
-125 2 1 5 2 
-125 1 2 5 2 
-135 5 6 2 
-150 5 4 5 4 
-150 5 1 5 1 
-150 2 1 5 1 
-155 3 1 2 6 
-155 4 3 2 6 
-155 3 4 5 6 
-155 3 2 4 6 
-160 6 5 4 
-160 4 2 6 
-160 2 4 6 
-160 2 1 6 
-160 2 6 1 
-160 5 6 1 
-160 6 5 1 
-160 4 5 6 
-160 6 5 1 
-160 2 1 6 
-160 2 6 4 
-160 5 6 1 
-160 1 5 6 
-160 6 5 1 
-165 3 4 1 3 5 4 
-165 3 4 1 3 5 1 
-170 3 2 4 2 
-170 4 5 5 3 
-170 4 5 3 5 
-170 1 1 4 3 5 
-170 1 4 1 3 2 
-170 6 6 
-170 1 2 3 5 
-170 2 3 4 5 
-170 3 1 2 2 
-170 2 4 5 3 
-170 5 3 4 5 
-170 1 5 3 5 
-170 5 1 3 2 
-170 2 3 4 2 
-170 5 4 3 5 
-175 4 2 2 
-175 2 4 2 
-175 4 2 2 
-175 5 1 2 
-175 1 3 3 4 6 
-175 2 1 2 
-175 3 2 3 6 
-175 5 1 2 
-180 3 5 6 
-180 3 5 6 
-180 5 6 3 
-180 3 2 6 
-180 6 3 2 
-180 3 6 5 
-180 1 4 3 6 
-180 2 6 3 
-180 6 3 5 
-180 6 3 5 
-180 5 6 3 
-180 1 1 6 3 
-185 6 2 
-185 6 2 
-185 3 2 3 3 2 
-185 6 2 
-190 3 2 3 2 
-195 2 3 1 1 
-195 4 1 1 3 1 
-195 3 5 5 
-195 3 1 4 5 
-195 1 3 5 4 
-195 4 4 4 3 1 
-195 4 4 3 1 4 
-195 3 5 1 4 
-195 3 5 2 
-195 2 3 4 1 
-195 5 1 3 4 
-195 1 1 1 3 1 
-195 3 4 1 2 
-195 3 1 5 1 
-195 3 1 4 2 
-195 3 4 2 4 
-195 3 2 2 
-195 2 3 5 
-200 2 1 1 
-200 2 2 
-200 1 5 1 
-200 1 5 1 
-200 1 1 4 1 
-200 2 2 
-200 4 2 1 
-200 5 4 1 
-200 2 2 
-200 2 5 
-200 1 2 1 
-200 2 5 
-200 5 5 
-200 5 4 1 
-200 4 2 1 
-200 1 1 2 
-200 4 4 4 4 
-200 5 1 1 
-205 6 3 4 
-205 3 4 6 
-210 6 4 
-210 1 6 
-210 3 4 3 3 2 
-210 6 4 
-210 6 1 
-210 6 4 
-210 6 4 
-210 6 4 
-210 6 1 
-210 3 3 4 3 5 
-210 6 4 
-210 6 4 
-210 6 1 
-210 4 6 
-210 4 6 
-210 6 4 
-215 4 5 3 3 
-215 3 5 4 3 
-215 3 2 4 3 
-215 4 2 3 3 
-215 1 2 3 3 
-215 4 5 3 3 
-215 5 1 3 3 
-215 5 4 3 3 
-215 2 3 3 4 
-215 4 1 3 1 3 
-215 1 3 1 3 4 
-215 3 5 4 3 
-215 3 5 3 4 
-215 5 4 3 3 
-215 3 5 4 3 
-230 3 2 3 3 3 
