990 6 5 5 5 3 4 6 6 2 1 5 4 2 6 6 4 6 1 2 2 1 1 2 1 2 3 1 6 5 4 1 3 
875 6 5 5 5 3 4 6 6 2 1 5 4 2 6 6 4 6 1 2 2 1 1 1 2 1 1 3 4 2 
805 6 5 5 5 3 4 6 6 2 1 5 4 2 6 6 4 6 1 2 2 1 1 2 2 3 3 1 
785 6 5 5 5 3 4 6 6 2 1 5 4 2 6 6 4 6 1 2 2 1 1 2 6 
785 6 5 5 5 3 4 6 6 2 1 5 4 2 6 6 4 6 1 2 2 1 1 2 6 
770 6 5 5 5 3 4 6 6 2 1 5 4 2 6 6 4 6 1 2 2 1 1 2 5 
770 6 5 5 5 3 4 6 6 2 1 5 4 2 6 6 4 6 1 2 2 1 1 2 5 
760 6 5 5 5 3 4 6 6 2 1 5 4 2 6 6 4 6 1 2 2 1 1 1 6 
760 6 5 5 5 3 4 6 6 2 1 5 4 2 6 6 4 6 1 2 2 1 1 1 6 
745 6 5 5 5 3 4 6 6 2 1 5 4 2 6 6 4 6 1 2 2 1 1 2 4 
745 6 5 5 5 3 4 6 6 2 1 5 4 2 6 6 4 6 1 2 2 1 1 2 4 
735 6 5 5 5 3 4 6 6 2 1 5 4 2 6 6 4 6 1 2 2 2 6 
735 6 5 5 5 3 4 6 6 2 1 5 4 2 6 6 4 6 1 2 2 1 1 6 
725 6 5 5 5 3 4 6 6 2 1 5 4 2 6 6 4 6 1 2 2 1 1 2 3 
725 6 5 5 5 3 4 6 6 2 1 5 4 2 6 6 4 6 1 2 2 1 1 2 3 
725 6 5 5 5 3 4 6 6 2 1 5 4 2 6 6 4 6 1 2 2 1 1 2 3 
725 6 5 5 5 3 4 6 6 2 1 5 4 2 6 6 4 6 1 2 2 1 1 2 3 
720 6 5 5 5 3 4 6 6 2 1 5 4 2 6 6 4 6 1 2 2 1 1 5 
720 6 5 5 5 3 4 6 6 2 1 5 4 2 6 6 4 6 1 2 2 1 2 4 
710 6 5 5 5 3 4 6 6 2 1 5 4 2 6 6 4 6 1 2 2 1 6 
695 6 5 5 5 3 4 6 6 2 1 5 4 2 6 6 4 6 1 2 2 1 5 
695 6 5 5 5 3 4 6 6 2 1 5 4 2 6 6 4 6 1 2 2 1 1 4 
695 6 5 5 5 3 4 6 6 2 1 5 4 2 6 6 4 6 1 2 2 1 5 
695 6 5 5 5 3 4 6 6 2 1 5 4 2 6 6 4 6 1 2 2 1 5 
695 6 5 5 5 3 4 6 6 2 1 5 4 2 6 6 4 6 1 2 2 2 4 
675 6 5 5 5 3 4 6 6 2 1 5 4 2 6 6 4 6 1 2 2 1 1 3 
670 6 5 5 5 3 4 6 6 2 1 5 4 2 6 6 4 6 1 2 2 1 4 
670 6 5 5 5 3 4 6 6 2 1 5 4 2 6 6 4 6 1 2 2 1 4 
670 6 5 5 5 3 4 6 6 2 1 5 4 2 6 6 4 6 1 2 2 1 4 
650 6 5 5 5 3 4 6 6 2 1 5 4 2 6 6 4 6 1 2 2 1 3 
650 6 5 5 5 3 4 6 6 2 1 5 4 2 6 6 4 4 3 2 1 5 6 
650 6 5 5 5 3 4 6 6 2 1 5 4 2 6 6 4 6 1 6 6 
645 6 5 5 5 3 4 6 6 2 1 5 4 2 6 6 4 6 1 2 2 4 
645 6 5 5 5 3 4 6 6 2 1 5 4 2 6 6 4 6 1 2 1 5 
645 6 5 5 5 3 4 6 6 2 1 5 4 2 6 6 4 6 1 2 2 4 
645 6 5 5 5 3 4 6 6 2 1 5 4 2 6 6 4 6 1 2 1 5 
645 6 5 5 5 3 4 6 6 2 1 5 4 2 6 6 4 6 5 2 1 4 
635 6 5 5 5 3 4 6 6 2 1 5 4 2 6 6 4 6 1 2 6 
635 6 5 5 5 3 4 6 6 2 1 5 4 2 6 1 6 4 4 3 4 5 1 5 
625 6 5 5 5 3 4 6 6 2 1 5 4 2 6 6 4 6 1 2 2 3 
610 6 5 5 5 3 4 6 6 2 1 5 4 2 6 6 4 6 1 4 6 
595 6 5 5 5 3 4 6 6 2 1 5 4 2 6 6 4 6 1 2 4 
580 6 5 5 5 3 4 6 6 2 1 5 4 2 6 6 4 6 1 3 5 3 
575 6 5 5 5 3 4 6 6 2 1 5 4 2 6 6 4 6 1 3 1 4 
570 6 5 5 5 3 4 6 6 2 1 5 4 2 6 6 4 6 2 4 
570 6 5 5 5 3 4 6 6 2 1 5 4 2 6 6 4 6 3 6 3 
550 6 5 5 5 3 4 6 6 2 1 5 4 2 6 6 4 6 1 4 3 
455 6 5 5 5 3 4 6 6 2 1 5 4 2 6 6 2 
