1065 5 6 5 5 5 5 5 2 6 5 1 6 5 1 6 6 2 6 5 6 2 6 
420 5 6 5 5 5 5 5 2 6 2 5 2 4 3 6 6 6 6 5 1 1 1 2 6 6 5 2 2 5 6 1 6 6 6 4 1 1 
320 5 6 5 5 5 5 5 2 6 2 4 2 6 2 3 5 6 
270 5 6 5 5 5 5 5 2 6 2 6 6 3 
185 5 6 5 5 5 5 5 2 6 2 5 2 4 3 6 6 6 6 5 1 1 1 2 6 6 5 2 2 5 6 1 3 
180 5 6 5 5 5 5 5 2 6 6 4 1 5 2 1 5 5 4 4 1 2 5 
115 5 6 5 5 5 5 5 2 6 2 3 
100 5 6 5 5 5 5 5 2 6 2 5 2 4 3 6 6 6 6 5 1 1 1 2 6 6 5 2 2 5 6 1 3 5 4 2 3 
85 5 6 5 5 5 5 5 2 6 2 5 2 4 3 6 6 6 6 5 1 1 1 2 6 6 5 2 2 5 6 1 3 3 3 1 1 6 
70 5 6 5 5 5 5 5 2 3 1 3 5 4 
45 5 6 5 5 5 5 5 2 6 2 6 4 1 
45 5 6 5 5 5 5 5 2 6 2 5 2 4 3 6 6 6 6 5 1 1 1 2 6 6 5 2 2 5 6 1 3 5 4 5 
40 5 6 5 5 5 5 5 2 6 2 
40 5 6 5 5 5 5 5 1 6 2 3 3 1 4 5 3 1 3 3 4 3 6 
40 5 6 5 5 5 5 5 2 6 2 5 2 4 3 6 6 6 6 5 1 1 1 2 6 6 5 2 2 5 6 1 3 5 6 1 
5 5 6 5 5 5 5 5 2 6 2 5 2 4 3 6 6 6 6 5 1 1 1 2 6 6 5 2 2 5 6 1 3 
5 5 6 5 5 5 5 5 2 6 
0 5 6 5 5 5 5 5 2 6 2 5 2 4 3 6 6 6 6 5 1 1 1 2 6 6 5 2 2 5 6 1 3 5 1 5 5 
0 5 6 5 5 5 5 5 2 6 2 5 2 4 3 6 6 6 6 5 1 1 1 2 6 6 5 2 2 5 6 1 3 6 1 4 
-15 5 6 5 5 5 5 5 2 5 2 5 
-15 5 6 5 5 5 5 5 2 6 2 5 2 4 3 6 6 6 6 5 1 1 1 2 6 6 5 2 2 5 6 1 3 5 1 5 1 6 6 3 2 
-30 5 6 5 5 5 3 
-40 5 6 5 5 5 5 5 2 6 3 4 5 4 1 5 5 
-60 5 6 5 5 5 5 5 2 6 2 5 2 4 3 6 6 6 6 5 1 1 1 2 6 6 5 2 2 5 6 1 4 3 
-70 5 6 5 5 5 5 5 2 6 2 5 2 4 3 6 6 6 6 5 1 1 1 2 6 6 5 2 2 5 6 1 
-70 5 6 5 5 5 5 5 2 6 2 5 3 6 2 3 3 5 1 5 
-70 5 6 5 5 5 5 5 2 6 2 5 2 4 5 3 2 5 2 1 
-70 5 6 5 5 5 5 5 2 6 2 2 3 
-70 5 6 5 5 5 5 5 2 6 2 5 2 4 3 6 6 6 6 5 1 1 1 2 6 6 5 2 2 5 6 1 3 5 
-70 5 6 5 5 5 5 5 2 6 2 5 4 4 
-70 5 6 5 5 5 5 5 2 6 2 5 2 4 3 6 6 6 6 5 1 1 1 2 6 6 5 2 2 5 6 1 3 5 
-70 5 6 5 5 5 5 5 2 6 2 5 1 2 
-70 5 6 5 5 5 5 5 2 6 2 5 2 5 
-70 5 6 5 5 5 5 5 2 6 2 5 2 4 3 6 6 6 6 5 1 1 1 2 6 6 5 2 2 5 6 1 3 5 
-70 5 6 5 5 5 5 5 2 6 2 5 2 4 3 6 6 6 6 5 1 1 1 2 6 6 5 2 2 5 6 1 3 
-70 5 6 5 5 5 5 5 2 6 2 
-70 5 6 5 5 5 5 5 2 6 2 5 2 4 3 6 6 6 6 5 1 1 1 2 6 6 5 2 2 5 6 1 3 5 
-70 5 6 5 5 5 5 5 2 6 2 5 2 4 3 6 6 6 6 5 1 1 1 2 6 6 5 2 2 5 6 1 3 
-70 5 6 5 5 5 5 5 2 6 2 5 2 4 3 6 6 6 6 5 1 1 1 2 6 6 5 2 2 5 6 1 3 5 
-70 5 6 5 5 5 5 5 2 6 2 5 2 4 3 6 6 6 6 5 1 1 1 2 6 6 5 2 2 5 6 1 3 5 
-70 5 6 5 5 5 5 5 2 6 2 5 2 4 3 6 6 6 6 5 1 1 1 2 6 6 5 2 2 5 6 1 3 
-70 5 6 5 5 5 5 5 2 6 2 5 2 1 
-70 5 6 5 5 5 5 5 2 6 2 5 2 
-70 5 6 5 5 5 5 5 2 6 2 5 2 4 3 6 6 6 6 5 1 1 1 2 6 6 5 2 2 5 6 1 
-70 5 6 5 5 5 5 5 2 6 2 5 2 4 3 6 6 6 6 5 1 1 1 2 6 6 5 2 2 5 6 1 3 
-70 5 6 5 5 5 5 5 2 6 2 5 2 4 3 6 6 6 6 5 1 1 1 2 6 6 5 2 2 5 6 1 3 
-70 5 6 5 5 5 5 5 2 6 2 5 2 
-325 5 6 5 5 5 5 5 2 6 2 5 2 4 3 6 6 6 6 5 1 1 1 2 6 6 5 2 2 5 6 1 3 
