335 5 4 5 5 5 5 5 5 6 3 1 4 1 5 6 
330 5 4 5 5 5 5 5 5 6 4 5 2 6 
330 5 4 5 5 5 5 5 5 6 4 5 5 6 
330 5 4 5 5 5 5 5 5 6 4 5 2 6 
315 5 4 5 5 5 5 5 5 6 4 1 5 1 5 
305 5 4 5 5 5 5 5 5 6 5 2 6 
305 5 4 5 5 5 5 5 5 6 4 6 1 5 
305 5 4 5 5 5 5 5 5 6 4 5 1 6 
300 5 4 5 5 5 5 5 5 6 4 5 3 5 4 3 4 
295 5 4 5 5 5 5 5 5 6 5 2 3 2 
295 5 4 5 5 5 5 5 5 6 4 5 3 1 1 4 
290 5 4 5 5 5 5 5 5 6 4 1 1 5 1 
290 5 4 5 5 5 5 5 5 6 4 5 5 1 
290 5 4 5 5 5 5 5 5 6 5 5 2 
290 5 4 5 5 5 5 5 5 6 4 2 1 5 
290 5 4 5 5 5 5 5 5 6 3 4 4 3 1 6 
285 5 4 5 5 5 5 5 5 6 4 3 6 2 
285 5 4 5 5 5 5 5 5 6 5 3 6 1 
280 5 4 5 5 5 5 5 5 6 4 6 2 
280 5 4 5 5 5 5 5 5 6 4 2 3 3 3 2 
280 5 4 5 5 5 5 5 5 6 6 4 5 
280 5 4 5 5 5 5 5 5 6 4 5 6 
280 5 4 5 5 5 5 5 5 6 4 5 6 
280 5 4 5 5 5 5 5 5 6 4 6 5 
280 5 4 5 5 5 5 5 5 6 4 5 6 
140 5 4 5 5 5 5 5 4 4 6 
140 5 4 5 5 5 5 5 4 1 6 
140 5 4 5 5 5 5 5 4 1 6 
125 5 4 5 5 5 5 5 4 4 5 
125 5 4 5 5 5 5 5 4 3 3 6 
120 5 4 5 5 5 5 5 3 4 6 
105 5 4 5 5 5 5 5 4 3 5 
100 5 4 5 5 5 5 5 4 2 
100 5 4 5 5 5 5 5 4 4 4 
100 5 4 5 5 5 5 5 5 1 
100 5 4 5 5 5 5 5 4 4 1 
100 5 4 5 5 5 5 5 4 2 
100 5 4 5 5 5 5 5 4 5 
100 5 4 5 5 5 5 5 2 1 
95 5 4 5 5 5 5 5 4 2 1 1 3 
95 5 4 5 5 5 5 5 4 2 5 4 5 6 
90 5 4 5 5 5 5 5 6 
85 5 4 5 5 5 5 5 3 4 3 1 
80 5 4 5 5 5 5 5 4 3 4 
80 5 4 5 5 5 5 5 3 1 4 
80 5 4 5 5 5 5 5 4 4 3 
80 5 4 5 5 5 5 5 4 1 3 
60 5 4 5 5 5 5 5 3 3 4 
