285 4 2 5 5 5 5 5 3 4 3 2 1 5 2 2 4 
285 4 2 5 5 5 5 5 3 4 3 2 4 2 2 4 1 4 
-15 4 2 5 5 5 5 5 3 4 3 2 4 2 2 5 6 4 6 6 
-15 4 2 5 5 5 5 5 3 4 3 2 4 2 2 5 6 4 6 6 6 
-15 4 2 5 5 5 5 5 3 4 3 2 4 2 2 5 6 4 6 
-15 4 2 5 5 5 5 5 3 4 3 2 4 2 2 5 6 4 6 
-15 4 2 5 5 5 5 5 3 4 3 2 4 2 2 5 6 4 6 6 
-15 4 2 5 5 5 5 5 3 4 3 2 4 2 2 5 6 4 6 6 
-15 4 2 5 5 5 5 5 3 4 3 2 4 2 2 5 6 4 6 
-15 4 2 5 5 5 5 5 3 4 3 2 4 2 2 5 6 4 6 6 
-15 4 2 5 5 5 5 5 3 4 3 2 4 2 2 5 6 4 6 
-15 4 2 5 5 5 5 5 3 4 3 2 4 2 2 5 6 4 6 6 
-15 4 2 5 5 5 5 5 3 4 3 2 4 2 2 5 6 4 6 
-15 4 2 5 5 5 5 5 3 4 3 2 4 2 2 5 6 4 6 6 6 
-15 4 2 5 5 5 5 5 3 4 3 2 4 2 2 5 6 4 6 6 
-15 4 2 5 5 5 5 5 3 4 3 2 4 2 2 5 6 4 6 6 6 
-15 4 2 5 5 5 5 5 3 4 3 2 4 2 2 5 6 4 6 6 6 
-15 4 2 5 5 5 5 5 3 4 3 2 4 2 2 5 6 4 6 6 6 
-15 4 2 5 5 5 5 5 3 4 3 2 4 2 2 5 6 4 6 6 6 
-15 4 2 5 5 5 5 5 3 4 3 2 4 2 2 5 6 4 6 
-15 4 2 5 5 5 5 5 3 4 3 2 4 2 2 5 6 4 6 6 6 
-15 4 2 5 5 5 5 5 3 4 3 2 4 2 2 5 6 4 6 
-15 4 2 5 5 5 5 5 3 4 3 2 4 2 2 5 6 4 6 6 6 
-15 4 2 5 5 5 5 5 3 4 3 2 4 2 2 5 6 4 6 6 6 
-15 4 2 5 5 5 5 5 3 4 3 2 4 2 2 5 6 4 6 6 6 
-15 4 2 5 5 5 5 5 3 4 3 2 4 2 2 5 6 4 6 6 6 
-15 4 2 5 5 5 5 5 3 4 3 2 4 2 2 5 6 1 6 5 
-15 4 2 5 5 5 5 5 3 4 3 2 4 2 2 5 6 1 6 
-15 4 2 5 5 5 5 5 3 4 3 2 4 2 2 5 6 3 5 
-15 4 2 5 5 5 5 5 3 4 3 2 4 2 2 5 6 1 4 3 
-15 4 2 5 5 5 5 5 3 4 3 2 4 2 2 5 1 6 
-15 4 2 5 5 5 5 5 3 4 3 2 4 2 2 5 6 3 6 
-15 4 2 5 5 5 5 5 3 4 3 2 4 2 2 5 6 1 
-15 4 2 5 5 5 5 5 3 4 3 2 4 2 2 5 6 4 
-15 4 2 5 5 5 5 5 3 4 3 2 4 2 2 5 6 1 
-15 4 2 5 5 5 5 5 3 4 3 2 4 2 2 5 6 1 4 
-15 4 2 5 5 5 5 5 3 4 3 2 4 2 2 5 
-15 4 2 5 5 5 5 5 3 4 3 2 4 2 2 5 
-15 4 2 5 5 5 5 5 3 4 3 2 4 2 2 5 6 
-15 4 2 5 5 5 5 5 3 4 3 2 4 2 2 5 6 1 3 3 
-15 4 2 5 5 5 5 5 3 4 3 2 4 2 2 5 6 1 
-15 4 2 5 5 5 5 5 3 4 3 2 4 2 2 5 6 3 
-15 4 2 5 5 5 5 5 3 4 3 2 4 2 2 5 6 
-15 4 2 5 5 5 5 5 3 4 3 2 4 2 2 5 
-15 4 2 5 5 5 5 5 3 4 3 2 4 2 2 5 1 6 
-15 4 2 5 5 5 5 5 3 4 3 2 4 2 2 5 
-15 4 2 5 5 5 5 5 3 4 3 2 4 2 2 5 
-15 4 2 5 5 5 5 5 3 4 3 2 4 2 2 5 6 4 6 6 6 
