140 5 4 5 5 5 5 5 4 4 6 
130 5 4 5 5 5 5 5 3 5 2 
125 5 4 5 5 5 5 5 4 4 5 
125 5 4 5 5 5 5 5 4 1 5 
125 5 4 5 5 5 5 5 4 4 5 
125 5 4 5 5 5 5 5 4 4 2 
120 5 4 5 5 5 5 5 4 3 6 
120 5 4 5 5 5 5 5 4 3 6 
115 5 4 5 5 5 5 5 4 6 
115 5 4 5 5 5 5 5 4 6 
105 5 4 5 5 5 5 5 4 3 5 
100 5 4 5 5 5 5 5 4 4 1 
100 5 4 5 5 5 5 5 4 2 
100 5 4 5 5 5 5 5 4 4 4 
100 5 4 5 5 5 5 5 4 2 
100 5 4 5 5 5 5 5 4 1 1 
100 5 4 5 5 5 5 5 4 2 
100 5 4 5 5 5 5 4 4 2 1 
100 5 4 5 5 5 5 5 4 4 1 
100 5 4 5 5 5 5 5 4 4 4 
95 5 4 5 5 5 5 5 4 5 4 
70 5 4 5 5 3 4 5 6 1 1 
55 5 4 5 5 5 5 5 1 3 
25 5 4 5 5 5 5 4 1 
15 5 4 5 5 5 3 4 4 3 3 1 5 
0 5 4 5 5 5 5 1 
-20 5 4 5 5 5 5 3 
-25 5 4 5 5 5 5 3 1 6 5 
-25 5 4 5 5 5 2 
-25 5 4 5 5 5 5 3 4 
-25 5 4 5 5 5 5 3 3 2 2 
-45 5 4 5 5 5 3 1 
-45 5 4 5 5 5 3 1 
-50 5 4 5 5 5 1 
-50 5 4 5 5 5 1 
-100 5 4 5 5 1 
-100 5 4 5 5 1 
-100 5 4 5 5 1 
-100 5 4 5 5 5 5 5 4 6 3 
-125 5 4 5 2 
-150 5 4 5 4 
-150 5 4 5 1 
-150 5 4 5 4 
-155 5 4 5 5 5 5 5 4 4 4 2 
-165 5 6 4 5 5 5 4 
-195 5 4 5 5 5 5 5 2 4 
-200 5 4 5 5 5 5 5 3 1 4 
-470 5 4 5 5 5 5 5 4 3 
