320 5 6 5 5 5 5 5 2 6 5 1 6 5 1 6 6 2 6 5 6 2 
320 5 6 5 5 5 5 5 2 6 5 1 6 5 1 6 6 2 6 5 6 
320 5 6 5 5 5 5 5 2 6 5 1 6 5 1 6 6 2 6 5 6 2 
320 5 6 5 5 5 5 5 2 6 5 1 6 5 1 6 6 2 6 5 6 2 
320 5 6 5 5 5 5 5 2 6 5 1 6 5 1 6 6 2 6 5 
320 5 6 5 5 5 5 5 2 6 5 1 6 5 1 6 6 2 6 5 
320 5 6 5 5 5 5 5 2 6 5 1 6 5 1 6 6 2 6 5 
320 5 6 5 5 5 5 5 2 6 5 1 6 5 1 6 6 2 6 5 
305 5 6 5 5 5 5 5 2 5 2 4 6 
295 5 6 5 5 5 5 5 2 6 2 6 6 
295 5 6 5 5 5 5 5 6 6 5 5 
295 5 6 5 5 5 5 5 2 6 2 6 4 
270 5 6 5 5 5 5 5 2 6 6 1 
255 5 6 5 5 5 5 5 2 6 4 4 4 1 
200 5 6 5 5 5 5 5 2 3 1 3 5 6 
0 5 6 5 5 5 5 5 2 6 2 5 2 4 3 6 6 6 6 5 1 1 1 2 6 6 5 2 2 5 6 1 3 5 1 5 1 6 6 3 
0 5 6 5 5 5 5 5 2 6 6 4 1 5 2 1 5 5 4 4 1 2 2 6 
-30 5 6 5 5 3 5 
-115 5 6 5 5 5 5 5 2 6 5 1 6 5 1 6 6 2 6 5 6 2 
-115 5 6 5 5 5 5 5 2 6 5 1 6 5 1 6 6 2 6 5 6 
-115 5 6 5 5 5 5 5 2 6 5 1 6 5 1 6 6 2 6 5 6 2 
-115 5 6 5 5 5 5 5 2 6 5 1 6 5 1 6 6 2 6 5 6 2 
-115 5 6 5 5 5 5 5 2 6 5 1 6 5 1 6 6 2 6 5 
-115 5 6 5 5 5 5 5 2 6 5 1 6 5 1 6 6 2 6 5 6 2 
-115 5 6 5 5 5 5 5 2 6 5 1 6 5 1 6 6 2 6 5 6 2 
-115 5 6 5 5 5 5 5 2 6 5 1 6 5 1 6 6 2 6 5 6 2 
-115 5 6 5 5 5 5 5 2 6 5 1 6 5 1 6 6 2 6 5 6 2 
-115 5 6 5 5 5 5 5 2 6 5 1 6 5 1 6 6 2 6 5 6 
-115 5 6 5 5 5 5 5 2 6 2 5 2 4 3 6 6 6 6 5 1 1 1 2 6 6 5 2 2 5 6 1 3 5 4 2 
-115 5 6 5 5 5 5 5 2 6 2 5 2 4 3 6 6 6 6 5 1 1 1 2 6 6 5 2 2 5 6 1 3 3 3 1 1 
-115 5 6 5 5 5 5 5 2 6 2 5 2 4 3 6 6 6 6 5 1 1 1 2 6 6 5 2 2 5 6 1 3 
-115 5 6 5 5 5 5 5 2 6 2 5 2 4 3 6 6 6 6 5 1 1 1 2 6 6 5 2 2 5 6 1 6 6 6 
-115 5 6 5 5 5 5 5 2 6 2 5 2 4 3 6 6 6 6 5 1 1 1 2 6 6 5 2 2 5 6 1 3 5 6 
-115 5 6 5 5 5 5 5 2 6 2 5 2 4 3 6 6 6 6 5 1 1 1 2 6 6 5 2 2 5 6 
-115 5 6 5 5 5 5 5 2 6 2 5 2 4 3 6 6 6 6 5 1 1 1 2 6 6 5 2 2 5 6 1 3 6 1 
-115 5 6 5 5 5 5 5 2 6 2 5 2 4 3 6 6 6 6 5 1 1 1 2 6 6 5 2 2 5 6 1 3 5 1 5 
-115 5 6 5 5 5 5 5 2 6 2 5 2 4 3 6 6 6 6 5 1 1 1 2 6 6 5 2 2 5 6 
-115 5 6 5 5 5 5 5 2 6 5 1 6 5 1 6 6 2 6 5 6 
-115 5 6 5 5 5 5 5 2 6 5 1 6 5 1 6 6 2 6 5 6 
-115 5 6 5 5 5 5 5 2 6 5 1 6 5 1 6 6 2 6 5 6 2 
-115 5 6 5 5 5 5 5 2 6 5 1 6 5 1 6 6 2 6 5 6 2 
-130 5 6 5 5 5 5 5 2 6 5 1 6 5 1 6 6 2 6 5 6 2 
-130 5 6 5 5 5 5 5 2 6 2 4 2 6 2 3 
-130 5 6 5 5 5 5 5 2 6 5 1 6 5 1 6 6 2 6 5 6 
-165 5 6 5 5 5 5 5 2 6 5 1 6 5 1 6 6 2 6 5 6 2 5 
-220 5 6 5 5 5 5 5 1 6 2 3 3 1 4 5 3 1 3 3 4 3 
-225 5 6 5 5 5 5 5 2 6 3 4 5 4 1 
-245 5 6 5 5 5 5 5 2 6 2 5 2 4 3 6 6 6 6 5 1 1 1 2 6 6 5 2 2 5 6 1 5 
