670 6 5 5 5 3 4 6 6 2 1 5 4 2 6 6 4 6 1 2 2 1 1 3 
620 6 5 5 5 3 4 6 6 2 1 5 4 2 6 6 4 5 2 6 4 
620 6 5 5 5 3 4 6 6 2 1 5 4 2 6 6 6 2 5 5 
610 6 5 5 5 3 4 6 6 2 1 5 4 2 6 6 4 4 3 5 5 1 1 3 
610 6 5 5 5 3 4 6 6 2 1 5 4 2 6 6 3 5 2 1 5 4 
605 6 5 5 5 3 4 6 6 2 1 5 4 2 6 6 6 5 3 5 1 3 
580 6 5 5 5 3 4 6 6 2 1 5 4 2 6 6 5 1 5 1 4 
565 6 5 5 5 3 4 6 6 2 1 5 4 2 6 6 5 3 5 3 4 4 
485 6 5 5 5 3 4 6 6 2 1 5 4 2 6 6 4 3 2 
480 6 5 5 5 3 4 6 6 2 1 5 4 2 6 6 4 2 
455 6 5 5 5 3 4 6 6 2 1 5 4 2 6 6 2 
455 6 5 5 5 3 4 6 6 2 1 5 4 2 6 6 4 1 
455 6 5 5 5 3 4 6 6 2 1 5 4 2 6 6 2 
455 6 5 5 5 3 4 6 6 2 1 5 4 2 6 6 4 1 
455 6 5 5 5 3 4 6 6 2 1 5 4 2 6 6 4 1 
455 6 5 5 5 3 4 6 6 2 1 5 4 2 6 6 4 1 
455 6 5 5 5 3 4 6 6 2 1 5 4 2 6 6 4 1 
450 6 5 5 5 3 4 6 6 2 1 5 4 2 6 3 3 5 2 
435 6 5 5 5 3 4 6 6 2 1 5 4 2 6 3 6 1 
395 6 5 5 5 3 4 6 6 2 1 5 4 2 6 3 2 
390 6 5 5 5 3 4 6 6 2 1 5 4 2 6 2 
390 6 5 5 5 3 4 6 6 2 1 5 4 2 6 5 
390 6 5 5 5 3 4 6 6 2 1 5 4 2 6 2 
390 6 5 5 5 3 4 6 6 2 1 5 4 2 6 2 
390 6 5 5 5 3 4 6 6 2 1 5 4 2 6 2 
390 6 5 5 5 3 4 6 6 6 3 5 4 2 6 3 2 
375 6 5 5 5 3 4 6 6 2 1 1 5 2 3 6 4 3 
370 6 5 5 5 3 4 6 6 2 1 1 2 2 3 6 1 
330 6 5 5 5 3 4 6 6 2 2 4 5 1 3 2 
325 6 5 5 5 3 4 6 6 2 1 5 4 2 5 
325 6 5 5 5 3 4 6 6 2 1 5 4 2 2 
300 6 5 5 5 3 4 6 6 2 1 5 4 2 1 
300 6 5 5 5 3 4 6 6 2 1 2 5 2 
300 6 5 5 5 3 4 6 6 2 1 5 5 5 
285 6 5 5 5 3 4 6 6 2 1 5 4 2 3 3 
280 6 5 5 5 3 4 6 6 2 6 4 6 
280 6 5 5 5 3 4 6 6 2 1 5 4 3 2 
275 6 5 5 5 3 4 6 6 2 1 5 5 4 
275 6 5 5 5 3 4 6 6 2 1 5 2 4 
275 6 5 5 5 3 4 6 6 2 1 5 5 4 
265 6 5 5 5 3 4 6 6 2 1 6 2 
265 6 5 5 5 3 4 6 6 3 6 3 6 2 
265 6 5 5 5 3 4 6 6 2 6 2 1 
260 6 5 5 5 3 4 6 6 2 1 5 4 3 3 1 
255 6 5 5 5 3 4 6 6 2 5 4 3 5 
255 6 5 5 5 3 4 6 6 5 4 5 4 1 3 
245 6 5 5 5 3 4 6 6 2 5 6 3 
235 6 5 5 5 3 4 6 6 6 6 3 1 
