90 5 6 5 5 5 5 5 2 6 2 2 1 
40 5 6 5 5 5 5 5 2 6 2 2 1 2 
40 5 6 5 5 5 5 5 2 6 2 
40 5 6 5 5 5 5 5 2 6 2 2 
40 5 6 5 5 5 5 5 2 6 2 2 1 
40 5 6 5 5 5 5 5 2 6 2 2 1 2 
40 5 6 5 5 5 5 5 2 6 2 2 1 
40 5 6 5 5 5 5 5 2 6 2 2 1 2 
40 5 6 5 5 5 5 5 2 6 2 2 
40 5 6 5 5 5 5 5 2 6 2 2 1 
40 5 6 5 5 5 5 5 2 6 2 2 1 
40 5 6 5 5 5 5 5 2 6 2 2 1 2 
40 5 6 5 5 5 5 5 2 6 2 2 
40 5 6 5 5 5 5 5 2 6 2 2 1 2 
40 5 6 5 5 5 5 5 2 6 2 2 
40 5 6 5 5 5 5 5 2 6 2 2 
40 5 6 5 5 5 5 5 2 6 2 2 
40 5 6 5 5 5 5 5 2 6 2 2 1 2 
40 5 6 5 5 5 5 5 2 6 2 2 
40 5 6 5 5 5 5 5 2 6 2 2 1 2 
40 5 6 5 5 5 5 5 2 6 2 2 
40 5 6 5 5 5 5 5 2 6 2 2 
40 5 6 5 5 5 5 5 2 6 2 2 1 
40 5 6 5 5 5 5 5 2 6 2 2 1 
40 5 6 5 5 5 5 5 2 6 2 2 1 2 
40 5 6 5 5 5 5 5 2 6 2 2 
40 5 6 5 5 5 5 5 2 6 2 2 
40 5 6 5 5 5 5 5 2 6 2 2 
40 5 6 5 5 5 5 5 2 6 2 2 
40 5 6 5 5 5 5 5 2 6 2 2 
40 5 6 5 5 5 5 5 2 6 2 2 1 
40 5 6 5 5 5 5 5 2 6 2 2 1 2 
40 5 6 5 5 5 5 5 2 6 2 2 1 
40 5 6 5 5 5 5 5 2 6 2 2 1 
40 5 6 5 5 5 5 5 2 6 2 2 1 2 5 6 
40 5 6 5 5 5 5 5 2 6 2 2 1 2 5 
40 5 6 5 5 5 5 5 2 6 2 2 1 
40 5 6 5 5 5 5 5 2 6 2 2 
40 5 6 5 5 5 5 5 2 6 2 2 1 2 5 6 6 
40 5 6 5 5 5 5 5 2 6 2 2 
-10 5 6 5 5 5 5 5 2 6 2 2 1 2 6 
-10 5 6 5 5 5 5 5 2 6 2 2 1 2 5 5 
-25 5 6 5 5 5 5 5 2 6 2 2 
-25 5 6 5 5 5 5 5 2 6 2 2 1 
-25 5 6 5 5 5 5 5 2 6 2 2 1 
-25 5 6 5 5 5 5 5 2 6 2 2 1 2 
-50 5 6 5 5 5 5 5 2 6 2 2 
-70 5 6 5 5 5 5 5 2 6 2 2 1 2 
