1435 4 1 6 5 5 5 5 5 6 1 6 5 6 5 6 5 4 2 1 2 2 2 2 3 1 3 6 6 4 4 1 6 2 4 6 5 4 6 2 
1435 4 1 6 5 5 5 5 5 6 1 6 5 6 5 6 5 4 2 1 2 2 2 2 3 1 3 6 6 4 4 1 6 2 4 6 3 5 3 6 6 5 
1430 4 1 6 5 5 5 5 5 6 1 6 5 6 5 6 5 4 2 1 2 2 2 2 3 1 3 6 6 4 4 1 6 2 4 6 3 5 6 6 
1425 4 1 6 5 5 5 5 5 6 1 6 5 6 5 6 5 4 2 1 2 2 2 2 3 1 3 6 6 4 4 1 6 2 4 6 6 6 2 
1385 4 1 6 5 5 5 5 5 6 1 6 5 6 5 6 5 4 2 1 2 2 2 2 3 1 3 6 6 4 4 1 6 2 4 6 5 1 6 
1370 4 1 6 5 5 5 5 5 6 1 6 5 6 5 6 5 4 2 1 2 2 2 2 3 1 3 6 6 4 4 1 6 2 4 6 5 5 1 
1360 4 1 6 5 5 5 5 5 6 1 6 5 6 5 6 5 4 2 1 2 2 2 2 3 1 3 6 6 4 4 1 6 2 4 6 6 2 
1350 4 1 6 5 5 5 5 5 6 1 6 5 6 5 6 5 4 2 1 2 2 2 2 3 1 3 6 6 4 4 1 6 2 4 6 5 1 3 1 
1345 4 1 6 5 5 5 5 5 6 1 6 5 6 5 6 5 4 2 1 2 2 2 2 3 1 3 6 6 4 4 1 6 2 4 6 5 3 1 4 1 
1315 4 1 6 5 5 5 5 5 6 1 6 5 6 5 6 5 4 2 1 2 2 2 2 3 1 3 6 6 4 4 1 6 2 4 6 3 6 
1295 4 1 6 5 5 5 5 5 6 1 6 5 6 5 6 5 4 2 1 2 2 2 2 3 1 3 6 6 4 4 1 6 2 4 6 2 
1275 4 1 6 5 5 5 5 5 6 1 6 5 6 5 6 5 4 2 1 2 2 2 2 3 1 3 6 6 4 4 1 6 2 4 3 4 6 
1270 4 1 6 5 5 5 5 5 6 1 6 5 6 5 6 5 4 2 1 2 2 2 2 3 1 3 6 6 4 4 1 6 2 4 6 4 
1270 4 1 6 5 5 5 5 5 6 1 6 5 6 5 6 5 4 2 1 2 2 2 2 3 1 3 6 6 4 4 1 6 2 4 6 4 
1270 4 1 6 5 5 5 5 5 6 1 6 5 6 5 6 5 4 2 1 2 2 2 2 3 1 3 6 6 4 4 1 6 2 4 6 1 
1270 4 1 6 5 5 5 5 5 6 1 6 5 6 5 6 5 4 2 1 2 2 2 2 3 1 3 6 6 4 4 1 6 2 4 6 4 
1235 4 1 6 5 5 5 5 5 6 1 6 5 6 5 6 5 4 2 1 2 2 2 2 2 3 6 4 4 6 4 5 5 6 3 3 
1230 4 1 6 5 5 5 5 5 6 1 6 5 6 5 6 5 4 2 1 2 2 2 2 3 1 3 6 6 4 4 1 6 2 4 5 
1230 4 1 6 5 5 5 5 5 6 1 6 5 6 5 6 5 4 2 1 2 2 2 2 3 1 3 6 6 4 4 1 6 2 4 2 
1220 4 1 6 5 5 5 5 5 6 1 6 5 6 5 6 5 4 2 1 2 2 2 2 3 1 3 6 6 4 4 1 6 2 6 
1220 4 1 6 5 5 5 5 5 6 1 6 5 6 5 6 5 4 2 1 2 2 2 2 3 1 3 6 6 4 4 1 6 2 6 
1215 4 1 6 5 5 5 5 5 6 1 6 5 6 5 6 5 4 2 1 2 2 2 2 3 1 3 6 6 4 4 1 6 2 2 6 
1215 4 1 6 5 5 5 5 5 6 1 6 5 6 5 6 5 4 2 1 2 2 2 2 3 1 3 6 6 4 4 1 6 2 3 6 
1215 4 1 6 5 5 5 5 5 6 1 6 5 6 5 6 5 4 2 1 2 2 2 2 2 3 6 4 4 6 6 1 1 6 
1215 4 1 6 5 5 5 5 5 6 1 6 5 6 5 6 5 4 2 1 2 2 2 2 3 1 3 6 6 4 4 1 6 2 3 6 
1205 4 1 6 5 5 5 5 5 6 1 6 5 6 5 6 5 4 2 1 2 2 2 2 3 1 3 6 6 4 4 1 6 2 4 1 
1205 4 1 6 5 5 5 5 5 6 1 6 5 6 5 6 5 4 2 1 2 2 2 2 3 1 3 6 6 4 4 1 6 2 4 1 
1205 4 1 6 5 5 5 5 5 6 1 6 5 6 5 6 5 4 2 1 2 2 2 2 3 1 3 6 6 4 4 1 6 2 4 1 
1205 4 1 6 5 5 5 5 5 6 1 6 5 6 5 6 5 4 2 1 2 2 2 2 3 1 3 6 6 4 4 1 6 2 5 
1205 4 1 6 5 5 5 5 5 6 1 6 5 6 5 6 5 4 2 1 2 2 2 2 3 1 3 6 6 4 4 1 6 2 5 
1200 4 1 6 5 5 5 5 5 6 1 6 5 6 5 6 5 4 2 1 2 2 2 2 3 1 3 6 6 4 4 1 6 2 3 5 
1200 4 1 6 5 5 5 5 5 6 1 6 5 6 5 6 5 4 2 1 2 2 2 2 3 1 3 6 6 4 4 1 6 2 3 5 
1200 4 1 6 5 5 5 5 5 6 1 6 5 6 5 6 5 4 2 1 2 2 2 2 3 1 3 6 6 4 4 1 6 2 1 5 
1200 4 1 6 5 5 5 5 5 6 1 6 5 6 5 6 5 4 2 1 2 2 2 2 2 3 6 4 4 6 5 4 4 6 
1190 4 1 6 5 5 5 5 5 6 1 6 5 6 5 6 5 4 2 1 2 2 2 2 3 1 3 6 6 4 4 1 6 2 4 3 3 
1070 4 1 6 5 5 5 5 5 6 1 6 5 6 5 6 5 4 2 1 2 2 2 2 2 3 6 4 4 5 1 1 
1070 4 1 6 5 5 5 5 5 6 1 6 5 6 5 6 5 4 2 1 2 2 2 2 2 3 6 4 4 3 1 3 6 
1065 4 1 6 5 5 5 5 5 6 1 6 5 6 5 6 5 4 2 1 2 2 2 2 3 1 3 6 6 4 4 1 6 2 2 
1060 4 1 6 5 5 5 5 5 6 1 6 5 6 5 6 5 4 2 1 2 2 2 2 2 3 6 4 4 1 6 
1055 4 1 6 5 5 5 5 5 6 1 6 5 6 5 6 5 4 2 1 2 2 2 2 2 3 6 4 4 3 1 3 5 
1050 4 1 6 5 5 5 5 5 6 1 6 5 6 5 6 5 4 2 1 2 2 2 2 2 3 6 4 4 3 1 5 
1045 4 1 6 5 5 5 5 5 6 1 6 5 6 5 6 5 4 2 1 2 2 2 2 2 3 6 4 4 1 2 
1040 4 1 6 5 5 5 5 5 6 1 6 5 6 5 6 5 4 2 1 2 2 2 2 2 3 6 4 4 6 3 
1040 4 1 6 5 5 5 5 5 6 1 6 5 6 5 6 5 4 2 1 2 2 2 2 2 3 6 4 4 3 6 
1030 4 1 6 5 5 5 5 5 6 1 6 5 6 5 6 5 4 2 1 2 2 2 2 3 2 5 1 4 4 2 
1025 4 1 6 5 5 5 5 5 6 1 6 5 6 5 6 5 4 2 1 2 2 2 2 2 3 6 4 4 3 5 
1025 4 1 6 5 5 5 5 5 6 1 6 5 6 5 6 5 4 2 1 2 2 2 2 2 3 6 4 4 3 1 4 
1020 4 1 6 5 5 5 5 5 6 1 6 5 6 5 6 5 4 2 1 2 2 2 2 2 3 6 4 4 3 2 6 1 4 3 1 1 4 
1020 4 1 6 5 5 5 5 5 6 1 6 5 6 5 6 5 4 2 1 2 2 2 2 2 3 6 4 4 3 2 6 3 1 3 2 
1020 4 1 6 5 5 5 5 5 6 1 6 5 6 5 6 5 4 2 1 2 2 2 2 2 3 6 4 4 3 2 3 4 2 
1020 4 1 6 5 5 5 5 5 6 1 6 5 6 5 6 5 4 2 1 2 2 2 2 2 3 6 4 4 3 5 6 2 3 2 2 2 
1020 4 1 6 5 5 5 5 5 6 1 6 5 6 5 6 5 4 2 1 2 2 2 2 2 3 6 4 4 3 2 6 4 
1020 4 1 6 5 5 5 5 5 6 1 6 5 6 5 6 5 4 2 1 2 2 2 2 2 3 6 4 4 3 2 5 
1020 4 1 6 5 5 5 5 5 6 1 6 5 6 5 6 5 4 2 1 2 2 2 2 2 3 6 4 4 3 2 6 4 
1020 4 1 6 5 5 5 5 5 6 1 6 5 6 5 6 5 4 2 1 2 2 2 2 2 3 6 4 4 3 2 6 
1020 4 1 6 5 5 5 5 5 6 1 6 5 6 5 6 5 4 2 1 2 2 2 2 2 3 6 4 4 3 5 2 
1020 4 1 6 5 5 5 5 5 6 1 6 5 6 5 6 5 4 2 1 2 2 2 2 2 3 6 4 4 3 2 4 
1020 4 1 6 5 5 5 5 5 6 1 6 5 6 5 6 5 4 2 1 2 2 2 2 2 3 6 4 4 3 2 1 
1020 4 1 6 5 5 5 5 5 6 1 6 5 6 5 6 5 4 2 1 2 2 2 2 2 3 4 6 4 2 
1020 4 1 6 5 5 5 5 5 6 1 6 5 6 5 6 5 4 2 1 2 2 2 2 2 3 6 4 4 4 1 
1020 4 1 6 5 5 5 5 5 6 1 6 5 6 5 6 5 4 2 1 2 2 2 2 2 3 6 4 4 1 4 
1000 4 1 6 5 5 5 5 5 6 1 6 5 6 5 6 5 4 2 1 2 2 2 2 2 3 6 4 4 4 3 
675 4 1 6 5 5 5 5 5 6 1 6 5 6 5 6 5 4 2 1 2 2 2 2 3 2 5 1 4 4 4 
675 4 1 6 5 5 5 5 5 6 1 6 5 6 5 6 5 4 2 1 2 2 2 2 3 2 5 1 4 4 4 
