395 5 6 5 5 5 5 5 2 6 2 2 1 2 5 
395 5 6 5 5 5 5 5 2 6 2 2 1 6 
395 5 6 5 5 5 5 5 2 6 2 2 1 2 6 
395 5 6 5 5 5 5 5 2 6 2 2 1 2 5 6 2 
395 5 6 5 5 5 5 5 2 6 2 2 1 5 
395 5 6 5 5 5 5 5 2 6 2 2 1 2 5 
395 5 6 5 5 5 5 5 2 6 2 2 1 2 
395 5 6 5 5 5 5 5 2 6 2 2 1 6 
395 5 6 5 5 5 5 5 2 6 2 2 1 2 
395 5 6 5 5 5 5 5 2 6 2 2 1 6 
280 5 6 5 5 5 5 5 2 6 2 2 
280 5 6 5 5 5 5 5 2 6 2 2 
280 5 6 5 5 5 5 5 2 6 2 2 3 
280 5 6 5 5 5 5 5 2 6 2 2 1 
280 5 6 5 5 5 5 5 2 6 2 2 3 
280 5 6 5 5 5 5 5 2 6 2 2 1 
280 5 6 5 5 5 5 5 2 6 2 2 
280 5 6 5 5 5 5 5 2 6 2 2 1 2 1 
280 5 6 5 5 5 5 5 2 6 2 2 4 
280 5 6 5 5 5 5 5 2 6 2 2 1 2 5 6 6 5 
280 5 6 5 5 5 5 5 2 6 2 2 1 2 5 6 6 
280 5 6 5 5 5 5 5 2 6 2 2 1 2 5 4 
280 5 6 5 5 5 5 5 2 6 2 2 1 2 5 1 
280 5 6 5 5 5 5 5 2 6 2 2 1 2 
280 5 6 5 5 5 5 5 2 6 2 2 1 2 5 6 
280 5 6 5 5 5 5 5 2 6 2 2 1 2 5 6 
280 5 6 5 5 5 5 5 2 6 2 2 1 2 5 6 6 
280 5 6 5 5 5 5 5 2 6 2 2 1 2 5 6 
280 5 6 5 5 5 5 5 2 6 2 2 1 2 
280 5 6 5 5 5 5 5 2 6 2 2 1 2 
115 5 6 5 5 5 5 5 2 6 2 2 1 1 2 
40 5 6 5 5 5 5 5 2 6 2 2 
15 5 6 5 5 5 5 5 2 6 2 2 1 2 
15 5 6 5 5 5 5 5 2 6 2 2 1 2 5 6 
15 5 6 5 5 5 5 5 2 6 2 2 
15 5 6 5 5 5 5 5 2 6 2 2 1 
15 5 6 5 5 5 5 5 2 6 2 2 1 2 
10 5 6 5 5 5 5 5 2 6 2 2 1 3 
10 5 6 5 5 5 5 5 2 6 2 2 1 4 
10 5 6 5 5 5 5 5 2 6 2 2 1 6 
10 5 6 5 5 5 5 5 2 6 2 1 
10 5 6 5 5 5 5 5 2 6 2 2 4 
10 5 6 5 5 5 5 5 2 6 2 2 1 2 5 3 
10 5 6 5 5 5 5 5 2 6 2 2 6 
-35 5 6 5 5 5 5 5 2 6 2 2 1 
-95 5 6 5 5 5 5 5 2 6 2 2 1 2 
-95 5 6 5 5 5 5 5 2 6 2 2 1 2 
-100 5 6 5 5 5 5 5 2 6 2 2 1 
