275 5 6 5 5 5 5 5 2 6 2 2 1 2 5 
275 5 6 5 5 5 5 5 2 6 2 2 1 2 5 6 6 
275 5 6 5 5 5 5 5 2 6 2 2 1 2 5 6 6 
275 5 6 5 5 5 5 5 2 6 2 2 1 2 5 6 
245 5 6 5 5 5 5 5 2 6 2 2 1 2 5 6 6 
245 5 6 5 5 5 5 5 2 6 2 2 1 2 5 6 
245 5 6 5 5 5 5 5 2 6 2 2 1 2 5 6 6 
245 5 6 5 5 5 5 5 2 6 2 2 1 2 5 6 
245 5 6 5 5 5 5 5 2 6 2 2 1 2 5 6 6 5 
245 5 6 5 5 5 5 5 2 6 2 2 1 2 5 6 6 5 
245 5 6 5 5 5 5 5 2 6 2 2 1 2 5 6 6 
245 5 6 5 5 5 5 5 2 6 2 2 1 2 5 6 
245 5 6 5 5 5 5 5 2 6 2 2 1 2 5 6 6 
245 5 6 5 5 5 5 5 2 6 2 2 1 2 5 6 6 
245 5 6 5 5 5 5 5 2 6 2 2 1 2 5 6 6 5 
245 5 6 5 5 5 5 5 2 6 2 2 1 2 5 6 
245 5 6 5 5 5 5 5 2 6 2 2 1 2 5 6 
245 5 6 5 5 5 5 5 2 6 2 2 1 2 5 6 6 
245 5 6 5 5 5 5 5 2 6 2 2 1 2 5 6 6 
245 5 6 5 5 5 5 5 2 6 2 2 1 2 5 6 6 5 
245 5 6 5 5 5 5 5 2 6 2 2 1 2 5 6 6 
245 5 6 5 5 5 5 5 2 6 2 2 1 2 5 6 6 5 
245 5 6 5 5 5 5 5 2 6 2 2 1 2 5 6 
245 5 6 5 5 5 5 5 2 6 2 2 1 2 5 6 
245 5 6 5 5 5 5 5 2 6 2 2 1 2 5 6 6 5 
245 5 6 5 5 5 5 5 2 6 2 2 1 2 
245 5 6 5 5 5 5 5 2 6 2 2 1 2 5 6 
245 5 6 5 5 5 5 5 2 6 2 2 1 2 5 6 
245 5 6 5 5 5 5 5 2 6 2 2 1 2 
245 5 6 5 5 5 5 5 2 6 2 2 1 2 5 6 
245 5 6 5 5 5 5 5 2 6 2 2 1 2 5 6 6 5 
245 5 6 5 5 5 5 5 2 6 2 2 1 2 5 6 6 5 
245 5 6 5 5 5 5 5 2 6 2 2 1 2 5 6 6 5 6 
245 5 6 5 5 5 5 5 2 6 2 2 1 2 5 6 6 5 6 
245 5 6 5 5 5 5 5 2 6 2 2 1 2 5 6 6 
245 5 6 5 5 5 5 5 2 6 2 2 1 2 5 6 6 
245 5 6 5 5 5 5 5 2 6 2 2 1 2 5 6 
245 5 6 5 5 5 5 5 2 6 2 2 1 2 5 6 6 5 
245 5 6 5 5 5 5 5 2 6 2 2 1 2 5 6 6 
245 5 6 5 5 5 5 5 2 6 2 2 1 2 5 6 6 5 
245 5 6 5 5 5 5 5 2 6 2 2 1 2 5 6 6 5 6 
245 5 6 5 5 5 5 5 2 6 2 2 1 2 5 6 6 
220 5 6 5 5 5 5 5 2 6 2 2 1 2 5 6 6 5 6 
220 5 6 5 5 5 5 5 2 6 2 2 1 2 5 6 6 5 
220 5 6 5 5 5 5 5 2 6 2 2 1 2 5 6 
220 5 6 5 5 5 5 5 2 6 2 2 1 2 5 6 6 5 6 
220 5 6 5 5 5 5 5 2 6 2 2 1 2 5 6 6 
-75 5 6 5 5 5 5 5 2 6 2 2 1 2 5 6 6 5 
