-210 5 6 5 5 5 5 5 2 6 2 2 1 2 5 6 6 5 6 4 
-210 5 6 5 5 5 5 5 2 6 2 2 1 2 5 6 6 5 6 6 2 6 
-210 5 6 5 5 5 5 5 2 6 2 2 1 2 5 6 6 5 6 6 2 5 4 
-210 5 6 5 5 5 5 5 2 6 2 2 1 2 5 6 6 5 6 6 
-210 5 6 5 5 5 5 5 2 6 2 2 1 2 5 6 6 5 6 6 2 
-210 5 6 5 5 5 5 5 2 6 2 2 1 2 5 6 6 5 6 6 2 
-210 5 6 5 5 5 5 5 2 6 2 2 1 2 5 6 6 5 6 6 2 
-210 5 6 5 5 5 5 5 2 6 2 2 1 2 5 6 6 5 6 6 2 
-210 5 6 5 5 5 5 5 2 6 2 2 1 2 5 6 6 5 6 3 
-210 5 6 5 5 5 5 5 2 6 2 2 1 2 5 6 6 5 
-210 5 6 5 5 5 5 5 2 6 2 2 1 2 5 6 6 5 6 6 4 
-210 5 6 5 5 5 5 5 2 6 2 2 1 2 5 6 6 5 6 6 2 
-210 5 6 5 5 5 5 5 2 6 2 2 1 2 5 6 6 5 6 6 
-210 5 6 5 5 5 5 5 2 6 2 2 1 2 5 6 6 5 6 6 2 5 4 
-210 5 6 5 5 5 5 5 2 6 2 2 1 2 5 6 6 5 6 6 2 5 1 
-210 5 6 5 5 5 5 5 2 6 2 2 1 2 5 6 6 5 6 6 2 
-210 5 6 5 5 5 5 5 2 6 2 2 1 2 5 6 6 5 6 6 2 
-210 5 6 5 5 5 5 5 2 6 2 2 1 2 5 6 6 5 6 
-210 5 6 5 5 5 5 5 2 6 2 2 1 2 5 6 6 5 2 
-225 5 6 5 5 5 5 5 2 6 2 2 1 2 5 6 6 5 6 6 
-225 5 6 5 5 5 5 5 2 6 2 2 1 2 5 6 6 5 6 4 
-250 5 6 5 5 5 5 5 2 6 2 2 1 2 5 6 6 5 6 6 2 1 
-270 5 6 5 5 5 5 5 2 6 2 2 1 2 5 6 6 5 6 6 4 
-270 5 6 5 5 5 5 5 2 6 2 2 1 2 5 6 6 5 6 6 5 
-275 5 6 5 5 5 5 5 2 6 2 2 1 2 5 6 6 5 6 6 2 
-275 5 6 5 5 5 5 5 2 6 2 2 1 2 5 6 6 5 6 6 
-275 5 6 5 5 5 5 5 2 6 2 2 1 2 5 6 6 5 6 6 
-275 5 6 5 5 5 5 5 2 6 2 2 1 2 5 6 6 5 6 
-275 5 6 5 5 5 5 5 2 6 2 2 1 2 5 6 6 5 6 6 2 
-275 5 6 5 5 5 5 5 2 6 2 2 1 2 5 6 6 5 6 6 2 
-275 5 6 5 5 5 5 5 2 6 2 2 1 2 5 6 6 5 6 6 
-275 5 6 5 5 5 5 5 2 6 2 2 1 2 5 6 6 5 6 
-275 5 6 5 5 5 5 5 2 6 2 2 1 2 5 6 6 5 6 
-275 5 6 5 5 5 5 5 2 6 2 2 1 2 5 6 6 5 6 6 2 
-275 5 6 5 5 5 5 5 2 6 2 2 1 2 5 6 6 5 6 6 2 
-275 5 6 5 5 5 5 5 2 6 2 2 1 2 5 6 6 5 6 
-275 5 6 5 5 5 5 5 2 6 2 2 1 2 5 6 6 5 6 6 
-275 5 6 5 5 5 5 5 2 6 2 2 1 2 5 6 6 5 6 
-275 5 6 5 5 5 5 5 2 6 2 2 1 2 5 6 6 5 6 6 
-275 5 6 5 5 5 5 5 2 6 2 2 1 2 5 6 6 5 6 
-275 5 6 5 5 5 5 5 2 6 2 2 1 2 5 6 6 5 6 6 
-275 5 6 5 5 5 5 5 2 6 2 2 1 2 5 6 6 5 6 6 
-275 5 6 5 5 5 5 5 2 6 2 2 1 2 5 6 6 5 6 
-275 5 6 5 5 5 5 5 2 6 2 2 1 2 5 6 6 5 6 
-275 5 6 5 5 5 5 5 2 6 2 2 1 2 5 6 6 5 6 
-275 5 6 5 5 5 5 5 2 6 2 2 1 2 5 6 6 5 6 6 2 5 
-275 5 6 5 5 5 5 5 2 6 2 2 1 2 5 6 6 5 6 6 
-275 5 6 5 5 5 5 5 2 6 2 2 1 2 5 6 6 5 6 6 
