999999 4 1 6 5 5 5 5 5 6 1 6 5 6 5 6 5 4 2 1 2 2 2 2 3 1 3 6 6 4 4 1 6 2 4 6 3 5 6 4 6 1 3 6 6 2 2 
1535 4 1 6 5 5 5 5 5 6 1 6 5 6 5 6 5 4 2 1 2 2 2 2 3 1 3 6 6 4 4 1 6 2 4 6 3 5 6 4 6 1 3 2 
1530 4 1 6 5 5 5 5 5 6 1 6 5 6 5 6 5 4 2 1 2 2 2 2 3 1 3 6 6 4 4 1 6 2 4 6 3 5 6 4 6 4 2 
1520 4 1 6 5 5 5 5 5 6 1 6 5 6 5 6 5 4 2 1 2 2 2 2 3 1 3 6 6 4 4 1 6 2 4 6 3 5 6 4 6 6 
1520 4 1 6 5 5 5 5 5 6 1 6 5 6 5 6 5 4 2 1 2 2 2 2 3 1 3 6 6 4 4 1 6 2 4 6 3 5 6 4 6 6 
1520 4 1 6 5 5 5 5 5 6 1 6 5 6 5 6 5 4 2 1 2 2 2 2 3 1 3 6 6 4 4 1 6 2 4 6 3 5 6 4 6 6 
1515 4 1 6 5 5 5 5 5 6 1 6 5 6 5 6 5 4 2 1 2 2 2 2 3 1 3 6 6 4 4 1 6 2 4 6 5 4 6 6 6 
1505 4 1 6 5 5 5 5 5 6 1 6 5 6 5 6 5 4 2 1 2 2 2 2 3 1 3 6 6 4 4 1 6 2 4 6 3 5 6 4 6 4 4 
1505 4 1 6 5 5 5 5 5 6 1 6 5 6 5 6 5 4 2 1 2 2 2 2 3 1 3 6 6 4 4 1 6 2 4 6 3 5 6 4 6 5 
1505 4 1 6 5 5 5 5 5 6 1 6 5 6 5 6 5 4 2 1 2 2 2 2 3 1 3 6 6 4 4 1 6 2 4 6 3 5 6 4 6 4 4 
1505 4 1 6 5 5 5 5 5 6 1 6 5 6 5 6 5 4 2 1 2 2 2 2 3 1 3 6 6 4 4 1 6 2 4 6 3 5 6 4 6 2 
1505 4 1 6 5 5 5 5 5 6 1 6 5 6 5 6 5 4 2 1 2 2 2 2 3 1 3 6 6 4 4 1 6 2 4 6 3 5 6 4 6 2 
1500 4 1 6 5 5 5 5 5 6 1 6 5 6 5 6 5 4 2 1 2 2 2 2 3 1 3 6 6 4 4 1 6 2 4 6 5 4 6 6 5 
1500 4 1 6 5 5 5 5 5 6 1 6 5 6 5 6 5 4 2 1 2 2 2 2 3 1 3 6 6 4 4 1 6 2 4 6 5 4 6 6 5 
1465 4 1 6 5 5 5 5 5 6 1 6 5 6 5 6 5 4 2 1 2 2 2 2 3 1 3 6 6 4 4 1 6 2 4 6 5 4 6 3 4 2 
1460 4 1 6 5 5 5 5 5 6 1 6 5 6 5 6 5 4 2 1 2 2 2 2 3 1 3 6 6 4 4 1 6 2 4 6 3 5 6 4 3 6 
1460 4 1 6 5 5 5 5 5 6 1 6 5 6 5 6 5 4 2 1 2 2 2 2 3 1 3 6 6 4 4 1 6 2 4 6 3 5 6 4 6 3 
1460 4 1 6 5 5 5 5 5 6 1 6 5 6 5 6 5 4 2 1 2 2 2 2 3 1 3 6 6 4 4 1 6 2 4 6 3 5 6 4 3 6 
1460 4 1 6 5 5 5 5 5 6 1 6 5 6 5 6 5 4 2 1 2 2 2 2 3 1 3 6 6 4 4 1 6 2 4 6 5 5 2 6 
1445 4 1 6 5 5 5 5 5 6 1 6 5 6 5 6 5 4 2 1 2 2 2 2 3 1 3 6 6 4 4 1 6 2 4 6 3 5 6 4 3 2 
1445 4 1 6 5 5 5 5 5 6 1 6 5 6 5 6 5 4 2 1 2 2 2 2 3 1 3 6 6 4 4 1 6 2 4 6 6 6 6 3 
1440 4 1 6 5 5 5 5 5 6 1 6 5 6 5 6 5 4 2 1 2 2 2 2 3 1 3 6 6 4 4 1 6 2 4 6 5 4 6 3 2 
1440 4 1 6 5 5 5 5 5 6 1 6 5 6 5 6 5 4 2 1 2 2 2 2 3 1 3 6 6 4 4 1 6 2 4 6 3 5 6 4 5 
1425 4 1 6 5 5 5 5 5 6 1 6 5 6 5 6 5 4 2 1 2 2 2 2 3 1 3 6 6 4 4 1 6 2 4 6 3 5 3 6 3 2 
1425 4 1 6 5 5 5 5 5 6 1 6 5 6 5 6 5 4 2 1 2 2 2 2 3 1 3 6 6 4 4 1 6 2 4 6 5 1 5 2 3 
1415 4 1 6 5 5 5 5 5 6 1 6 5 6 5 6 5 4 2 1 2 2 2 2 3 1 3 6 6 4 4 1 6 2 4 6 3 5 6 4 1 
1415 4 1 6 5 5 5 5 5 6 1 6 5 6 5 6 5 4 2 1 2 2 2 2 3 1 3 6 6 4 4 1 6 2 4 6 3 5 6 4 1 
1415 4 1 6 5 5 5 5 5 6 1 6 5 6 5 6 5 4 2 1 2 2 2 2 3 1 3 6 6 4 4 1 6 2 4 6 3 5 6 4 1 
1415 4 1 6 5 5 5 5 5 6 1 6 5 6 5 6 5 4 2 1 2 2 2 2 3 1 3 6 6 4 4 1 6 2 4 6 3 5 6 2 
1415 4 1 6 5 5 5 5 5 6 1 6 5 6 5 6 5 4 2 1 2 2 2 2 3 1 3 6 6 4 4 1 6 2 4 6 3 5 6 4 4 
1415 4 1 6 5 5 5 5 5 6 1 6 5 6 5 6 5 4 2 1 2 2 2 2 3 1 3 6 6 4 4 1 6 2 4 6 3 5 6 4 4 
1415 4 1 6 5 5 5 5 5 6 1 6 5 6 5 6 5 4 2 1 2 2 2 2 3 1 3 6 6 4 4 1 6 2 4 6 3 5 6 4 1 
1415 4 1 6 5 5 5 5 5 6 1 6 5 6 5 6 5 4 2 1 2 2 2 2 3 1 3 6 6 4 4 1 6 2 4 6 3 5 6 2 
1415 4 1 6 5 5 5 5 5 6 1 6 5 6 5 6 5 4 2 1 2 2 2 2 3 1 3 6 6 4 4 1 6 2 4 6 3 5 6 4 4 
1415 4 1 6 5 5 5 5 5 6 1 6 5 6 5 6 5 4 2 1 2 2 2 2 3 1 3 6 6 4 4 1 6 2 4 6 3 5 6 4 1 
1415 4 1 6 5 5 5 5 5 6 1 6 5 6 5 6 5 4 2 1 2 2 2 2 3 1 3 6 6 4 4 1 6 2 4 6 3 5 6 4 1 
1410 4 1 6 5 5 5 5 5 6 1 6 5 6 5 6 5 4 2 1 2 2 2 2 3 1 3 6 6 4 4 1 6 2 4 6 5 4 4 6 
1410 4 1 6 5 5 5 5 5 6 1 6 5 6 5 6 5 4 2 1 2 2 2 2 3 1 3 6 6 4 4 1 6 2 4 6 5 2 3 2 4 2 
1405 4 1 6 5 5 5 5 5 6 1 6 5 6 5 6 5 4 2 1 2 2 2 2 3 1 3 6 6 4 4 1 6 2 4 6 5 4 4 3 5 3 
1395 4 1 6 5 5 5 5 5 6 1 6 5 6 5 6 5 4 2 1 2 2 2 2 3 1 3 6 6 4 4 1 6 2 4 6 3 5 6 3 1 
1395 4 1 6 5 5 5 5 5 6 1 6 5 6 5 6 5 4 2 1 2 2 2 2 3 1 3 6 6 4 4 1 6 2 4 6 3 5 6 3 4 
1395 4 1 6 5 5 5 5 5 6 1 6 5 6 5 6 5 4 2 1 2 2 2 2 3 1 3 6 6 4 4 1 6 2 4 6 5 1 2 3 4 2 
1390 4 1 6 5 5 5 5 5 6 1 6 5 6 5 6 5 4 2 1 2 2 2 2 3 1 3 6 6 4 4 1 6 2 4 6 3 5 6 1 
1390 4 1 6 5 5 5 5 5 6 1 6 5 6 5 6 5 4 2 1 2 2 2 2 3 1 3 6 6 4 4 1 6 2 4 6 3 5 6 1 
1390 4 1 6 5 5 5 5 5 6 1 6 5 6 5 6 5 4 2 1 2 2 2 2 3 1 3 6 6 4 4 1 6 2 4 6 3 5 6 1 
1380 4 1 6 5 5 5 5 5 6 1 6 5 6 5 6 5 4 2 1 2 2 2 2 3 1 3 6 6 4 4 1 6 2 4 6 5 1 3 6 
1375 4 1 6 5 5 5 5 5 6 1 6 5 6 5 6 5 4 2 1 2 2 2 2 3 1 3 6 6 4 4 1 6 2 4 6 5 2 4 3 
1375 4 1 6 5 5 5 5 5 6 1 6 5 6 5 6 5 4 2 1 2 2 2 2 3 1 3 6 6 4 4 1 6 2 4 6 3 5 6 3 3 
1370 4 1 6 5 5 5 5 5 6 1 6 5 6 5 6 5 4 2 1 2 2 2 2 3 1 3 6 6 4 4 1 6 2 4 6 5 4 2 
1370 4 1 6 5 5 5 5 5 6 1 6 5 6 5 6 5 4 2 1 2 2 2 2 3 1 3 6 6 4 4 1 6 2 4 6 5 5 1 
1370 4 1 6 5 5 5 5 5 6 1 6 5 6 5 6 5 4 2 1 2 2 2 2 3 1 3 6 6 4 4 1 6 2 4 6 5 5 1 
1360 4 1 6 5 5 5 5 5 6 1 6 5 6 5 6 5 4 2 1 2 2 2 2 3 1 3 6 6 4 4 1 6 2 4 6 5 6 
1360 4 1 6 5 5 5 5 5 6 1 6 5 6 5 6 5 4 2 1 2 2 2 2 3 1 3 6 6 4 4 1 6 2 4 6 6 2 
1350 4 1 6 5 5 5 5 5 6 1 6 5 6 5 6 5 4 2 1 2 2 2 2 3 1 3 6 6 4 4 1 6 2 4 6 5 3 5 
1345 4 1 6 5 5 5 5 5 6 1 6 5 6 5 6 5 4 2 1 2 2 2 2 3 1 3 6 6 4 4 1 6 2 4 6 5 4 1 
1345 4 1 6 5 5 5 5 5 6 1 6 5 6 5 6 5 4 2 1 2 2 2 2 3 1 3 6 6 4 4 1 6 2 4 6 5 4 1 
1325 4 1 6 5 5 5 5 5 6 1 6 5 6 5 6 5 4 2 1 2 2 2 2 3 1 3 6 6 4 4 1 6 2 4 6 5 4 3 
1320 4 1 6 5 5 5 5 5 6 1 6 5 6 5 6 5 4 2 1 2 2 2 2 3 1 3 6 6 4 4 1 6 2 4 6 4 2 
1320 4 1 6 5 5 5 5 5 6 1 6 5 6 5 6 5 4 2 1 2 2 2 2 3 1 3 6 6 4 4 1 6 2 4 6 5 3 1 2 
1295 4 1 6 5 5 5 5 5 6 1 6 5 6 5 6 5 4 2 1 2 2 2 2 3 1 3 6 6 4 4 1 6 2 4 6 2 
1295 4 1 6 5 5 5 5 5 6 1 6 5 6 5 6 5 4 2 1 2 2 2 2 3 1 3 6 6 4 4 1 6 2 4 6 4 1 
1295 4 1 6 5 5 5 5 5 6 1 6 5 6 5 6 5 4 2 1 2 2 2 2 3 1 3 6 6 4 4 1 6 2 4 6 2 
1295 4 1 6 5 5 5 5 5 6 1 6 5 6 5 6 5 4 2 1 2 2 2 2 3 1 3 6 6 4 4 1 6 2 4 6 2 
1230 4 1 6 5 5 5 5 5 6 1 6 5 6 5 6 5 4 2 1 2 2 2 2 3 1 3 6 6 4 4 1 6 2 4 6 5 1 1 
