75 5 4 5 5 5 5 5 5 6 3 1 4 1 5 
75 5 4 5 5 5 5 5 5 6 3 1 4 1 5 
75 5 4 5 5 5 5 5 5 6 3 1 4 
75 5 4 5 5 5 5 5 5 6 3 1 4 1 5 
75 5 4 5 5 5 5 5 5 6 3 1 4 1 5 
75 5 4 5 5 5 5 5 5 6 3 1 4 1 5 
75 5 4 5 5 5 5 5 5 6 3 1 4 1 
75 5 4 5 5 5 5 5 5 6 3 1 4 
75 5 4 5 5 5 5 5 5 6 3 1 4 
75 5 4 5 5 5 5 5 5 6 3 1 4 
75 5 4 5 5 5 5 5 5 6 3 1 4 
75 5 4 5 5 5 5 5 5 6 3 1 4 
75 5 4 5 5 5 5 5 5 6 3 1 4 1 5 
75 5 4 5 5 5 5 5 5 6 3 1 4 
75 5 4 5 5 5 5 5 5 6 3 1 4 
75 5 4 5 5 5 5 5 5 6 3 1 4 1 
75 5 4 5 5 5 5 5 5 6 3 1 4 
75 5 4 5 5 5 5 5 5 6 3 1 4 1 5 
75 5 4 5 5 5 5 5 5 6 3 1 4 1 
75 5 4 5 5 5 5 5 5 6 3 1 4 
75 5 4 5 5 5 5 5 5 6 3 1 4 
75 5 4 5 5 5 5 5 5 6 3 1 4 
75 5 4 5 5 5 5 5 5 6 3 1 4 
75 5 4 5 5 5 5 5 5 6 3 1 4 
75 5 4 5 5 5 5 5 5 6 3 1 4 1 
75 5 4 5 5 5 5 5 5 6 4 5 
75 5 4 5 5 5 5 5 5 6 4 5 5 
75 5 4 5 5 5 5 5 5 6 4 5 2 
75 5 4 5 5 5 5 5 5 6 4 1 5 1 
75 5 4 5 5 5 5 5 5 6 
75 5 4 5 5 5 5 5 5 6 4 6 1 
75 5 4 5 5 5 5 5 5 6 4 5 
75 5 4 5 5 5 5 5 5 6 4 5 3 5 4 
75 5 4 5 5 5 5 5 5 6 4 5 3 
75 5 4 5 5 5 5 5 5 6 5 2 
75 5 4 5 5 5 5 5 5 6 4 1 1 5 
75 5 4 5 5 5 5 5 5 6 4 5 5 
75 5 4 5 5 5 5 5 5 6 5 
75 5 4 5 5 5 5 5 5 6 4 
75 5 4 5 5 5 5 5 5 6 3 4 4 3 
75 5 4 5 5 5 5 5 5 6 4 3 6 
75 5 4 5 5 5 5 5 5 6 5 
75 5 4 5 5 5 5 5 5 6 4 5 
75 5 4 5 5 5 5 5 5 6 
75 5 4 5 5 5 5 5 5 6 
75 5 4 5 5 5 5 5 5 6 
75 5 4 5 5 5 5 5 5 6 6 
75 5 4 5 5 5 5 5 5 6 4 2 3 3 3 
