1540 6 5 5 5 5 5 3 5 6 5 5 5 6 6 5 3 4 1 6 2 2 2 1 2 4 2 6 5 6 4 6 1 1 4 6 5 4 6 6 6 
1540 6 5 5 5 5 5 3 5 6 5 5 5 6 6 5 3 4 1 6 2 2 2 1 2 4 2 6 5 6 4 6 1 1 4 6 5 4 6 6 6 
1540 6 5 5 5 5 5 3 5 6 5 5 5 6 6 5 3 4 1 6 2 2 2 1 2 4 2 6 5 6 4 6 1 1 4 6 5 4 6 6 6 
1540 6 5 5 5 5 5 3 5 6 5 5 5 6 6 5 3 4 1 6 2 2 2 1 2 4 2 6 5 6 4 6 1 1 4 6 5 4 6 6 6 
1540 6 5 5 5 5 5 3 5 6 5 5 5 6 6 5 3 4 1 6 2 2 2 1 2 4 2 6 5 6 4 6 1 1 4 6 5 4 6 6 6 
1525 6 5 5 5 5 5 3 5 6 5 5 5 6 6 5 3 4 1 6 2 2 2 1 2 4 2 6 5 6 4 6 1 1 4 6 5 4 6 6 5 
1525 6 5 5 5 5 5 3 5 6 5 5 5 6 6 5 3 4 1 6 2 2 2 1 2 4 2 6 5 6 4 6 1 1 4 6 5 4 6 6 5 
1525 6 5 5 5 5 5 3 5 6 5 5 5 6 6 5 3 4 1 6 2 2 2 1 2 4 2 6 5 6 4 6 1 1 4 6 5 4 6 6 2 
1525 6 5 5 5 5 5 3 5 6 5 5 5 6 6 5 3 4 1 6 2 2 2 1 2 4 2 6 5 6 4 6 1 1 4 6 5 4 6 6 2 
1525 6 5 5 5 5 5 3 5 6 5 5 5 6 6 5 3 4 1 6 2 2 2 1 2 4 2 6 5 6 4 6 1 1 4 6 5 4 6 6 2 
1525 6 5 5 5 5 5 3 5 6 5 5 5 6 6 5 3 4 1 6 2 2 2 1 2 4 2 6 5 6 4 6 1 1 4 6 5 4 6 6 2 
1525 6 5 5 5 5 5 3 5 6 5 5 5 6 6 5 3 4 1 6 2 2 2 1 2 4 2 6 5 6 4 6 1 1 4 6 5 4 6 6 2 
1525 6 5 5 5 5 5 3 5 6 5 5 5 6 6 5 3 4 1 6 2 2 2 1 2 4 2 6 5 6 4 6 1 1 4 6 5 4 6 6 2 
1500 6 5 5 5 5 5 3 5 6 5 5 5 6 6 5 3 4 1 6 2 2 2 1 2 4 2 6 5 6 4 6 1 1 4 6 5 4 6 6 1 
1500 6 5 5 5 5 5 3 5 6 5 5 5 6 6 5 3 4 1 6 2 2 2 1 2 4 2 6 5 6 4 6 1 1 4 6 5 4 6 6 4 
1500 6 5 5 5 5 5 3 5 6 5 5 5 6 6 5 3 4 1 6 2 2 2 1 2 4 2 6 5 6 4 6 1 1 4 6 5 4 6 6 4 
1500 6 5 5 5 5 5 3 5 6 5 5 5 6 6 5 3 4 1 6 2 2 2 1 2 4 2 6 5 6 4 6 1 1 4 6 5 4 6 6 1 
1500 6 5 5 5 5 5 3 5 6 5 5 5 6 6 5 3 4 1 6 2 2 2 1 2 4 2 6 5 6 4 6 1 1 4 6 5 4 6 6 4 
1500 6 5 5 5 5 5 3 5 6 5 5 5 6 6 5 3 4 1 6 2 2 2 1 2 4 2 6 5 6 4 6 1 1 4 6 5 4 6 6 1 
1500 6 5 5 5 5 5 3 5 6 5 5 5 6 6 5 3 4 1 6 2 2 2 1 2 4 2 6 5 6 4 6 1 1 4 6 5 4 6 6 4 
1480 6 5 5 5 5 5 3 5 6 5 5 5 6 6 5 3 4 1 6 2 2 2 1 2 4 2 6 5 6 4 6 1 1 4 6 5 4 6 3 6 
1480 6 5 5 5 5 5 3 5 6 5 5 5 6 6 5 3 4 1 6 2 2 2 1 2 4 2 6 5 6 4 6 1 1 4 6 5 4 6 3 6 
1480 6 5 5 5 5 5 3 5 6 5 5 5 6 6 5 3 4 1 6 2 2 2 1 2 4 2 6 5 6 4 6 1 1 4 6 5 4 6 6 3 
1470 6 5 5 5 5 5 3 5 6 5 5 5 6 6 5 3 4 1 6 2 2 2 1 2 4 2 6 5 6 4 6 1 1 4 6 5 2 4 4 2 4 
1465 6 5 5 5 5 5 3 5 6 5 5 5 6 6 5 3 4 1 6 2 2 2 1 2 4 2 6 5 6 4 6 1 1 4 6 5 4 6 3 5 
1460 6 5 5 5 5 5 3 5 6 5 5 5 6 6 5 3 4 1 6 2 2 2 1 2 4 2 6 5 6 4 6 1 1 4 6 5 4 6 2 
1460 6 5 5 5 5 5 3 5 6 5 5 5 6 6 5 3 4 1 6 2 2 2 1 2 4 2 6 5 6 4 6 1 1 4 6 5 4 6 5 
1460 6 5 5 5 5 5 3 5 6 5 5 5 6 6 5 3 4 1 6 2 2 2 1 2 4 2 6 5 6 4 6 1 1 4 6 5 4 6 5 
1460 6 5 5 5 5 5 3 5 6 5 5 5 6 6 5 3 4 1 6 2 2 2 1 2 4 2 6 5 6 4 6 1 1 4 6 5 4 6 5 
1460 6 5 5 5 5 5 3 5 6 5 5 5 6 6 5 3 4 1 6 2 2 2 1 2 4 2 6 5 6 4 6 1 1 4 6 5 4 6 5 
1460 6 5 5 5 5 5 3 5 6 5 5 5 6 6 5 3 4 1 6 2 2 2 1 2 4 2 6 5 6 4 6 1 1 4 6 5 4 6 2 
1460 6 5 5 5 5 5 3 5 6 5 5 5 6 6 5 3 4 1 6 2 2 2 1 2 4 2 6 5 6 4 6 1 1 4 6 5 4 6 2 
1440 6 5 5 5 5 5 3 5 6 5 5 5 6 6 5 3 4 1 6 2 2 2 1 2 4 2 6 5 6 4 6 1 1 4 6 5 4 4 3 6 4 
1440 6 5 5 5 5 5 3 5 6 5 5 5 6 6 5 3 4 1 6 2 2 2 1 2 4 2 6 5 6 4 6 1 1 4 6 5 4 4 3 6 3 
1440 6 5 5 5 5 5 3 5 6 5 5 5 6 6 5 3 4 1 6 2 2 2 1 2 4 2 6 5 6 4 6 1 1 4 6 5 4 6 3 4 2 
1440 6 5 5 5 5 5 3 5 6 5 5 5 6 6 5 3 4 1 6 2 2 2 1 2 4 2 6 5 6 4 6 1 1 4 6 5 4 6 3 1 
1435 6 5 5 5 5 5 3 5 6 5 5 5 6 6 5 3 4 1 6 2 2 2 1 2 4 2 6 5 6 4 6 1 1 4 6 5 4 4 6 
1435 6 5 5 5 5 5 3 5 6 5 5 5 6 6 5 3 4 1 6 2 2 2 1 2 4 2 6 5 6 4 6 1 1 4 6 5 4 6 4 
1435 6 5 5 5 5 5 3 5 6 5 5 5 6 6 5 3 4 1 6 2 2 2 1 2 4 2 6 5 6 4 6 1 1 4 6 5 4 6 1 
1435 6 5 5 5 5 5 3 5 6 5 5 5 6 6 5 3 4 1 6 2 2 2 1 2 4 2 6 5 6 4 6 1 1 4 6 5 4 6 4 
1435 6 5 5 5 5 5 3 5 6 5 5 5 6 6 5 3 4 1 6 2 2 2 1 2 4 2 6 5 6 4 6 1 1 4 6 5 4 6 4 
1435 6 5 5 5 5 5 3 5 6 5 5 5 6 6 5 3 4 1 6 2 2 2 1 2 4 2 6 5 6 4 6 1 1 4 6 5 2 6 
1435 6 5 5 5 5 5 3 5 6 5 5 5 6 6 5 3 4 1 6 2 2 2 1 2 4 2 6 5 6 4 6 1 1 4 6 5 4 6 1 
1435 6 5 5 5 5 5 3 5 6 5 5 5 6 6 5 3 4 1 6 2 2 2 1 2 4 2 6 5 6 4 6 1 1 4 6 5 4 6 1 
1435 6 5 5 5 5 5 3 5 6 5 5 5 6 6 5 3 4 1 6 2 2 2 1 2 4 2 6 5 6 4 6 1 1 4 6 5 4 6 1 
1435 6 5 5 5 5 5 3 5 6 5 5 5 6 6 5 3 4 1 6 2 2 2 1 2 4 2 6 5 6 4 6 1 1 4 6 5 4 6 1 
1435 6 5 5 5 5 5 3 5 6 5 5 5 6 6 5 3 4 1 6 2 2 2 1 2 4 2 6 5 6 4 6 1 1 4 6 5 4 6 4 
1435 6 5 5 5 5 5 3 5 6 5 5 5 6 6 5 3 4 1 6 2 2 2 1 2 4 2 6 5 6 4 6 1 1 4 6 5 4 6 4 
1425 6 5 5 5 5 5 3 5 6 5 5 5 6 6 5 3 4 1 6 2 2 2 1 2 4 2 6 5 6 4 6 1 1 4 6 5 4 4 2 3 
1400 6 5 5 5 5 5 3 5 6 5 5 5 6 6 5 3 4 1 6 2 2 2 1 2 4 2 6 5 6 4 6 1 1 4 6 5 4 4 3 1 
1395 6 5 5 5 5 5 3 5 6 5 5 5 6 6 5 3 4 1 6 2 2 2 1 2 4 2 6 5 6 4 6 1 1 4 6 5 4 5 
1395 6 5 5 5 5 5 3 5 6 5 5 5 6 6 5 3 4 1 6 2 2 2 1 2 4 2 6 5 6 4 6 1 1 4 6 5 4 2 
1395 6 5 5 5 5 5 3 5 6 5 5 5 6 6 5 3 4 1 6 2 2 2 1 2 4 2 6 5 6 4 6 1 1 4 6 5 4 2 
1395 6 5 5 5 5 5 3 5 6 5 5 5 6 6 5 3 4 1 6 2 2 2 1 2 4 2 6 5 6 4 6 1 1 4 6 5 4 2 
1395 6 5 5 5 5 5 3 5 6 5 5 5 6 6 5 3 4 1 6 2 2 2 1 2 4 2 6 5 6 4 6 1 1 4 6 5 4 5 
1395 6 5 5 5 5 5 3 5 6 5 5 5 6 6 5 3 4 1 6 2 2 2 1 2 4 2 6 5 6 4 6 1 1 4 6 5 4 5 
1395 6 5 5 5 5 5 3 5 6 5 5 5 6 6 5 3 4 1 6 2 2 2 1 2 4 2 6 5 6 4 6 1 1 4 6 5 5 4 
1385 6 5 5 5 5 5 3 5 6 5 5 5 6 6 5 3 4 1 6 2 2 2 1 2 4 2 6 5 6 4 6 1 1 4 6 5 6 
1370 6 5 5 5 5 5 3 5 6 5 5 5 6 6 5 3 4 1 6 2 2 2 1 2 4 2 6 5 6 4 6 1 1 4 6 5 4 1 
1370 6 5 5 5 5 5 3 5 6 5 5 5 6 6 5 3 4 1 6 2 2 2 1 2 4 2 6 5 6 4 6 1 1 4 6 5 4 1 
1370 6 5 5 5 5 5 3 5 6 5 5 5 6 6 5 3 4 1 6 2 2 2 1 2 4 2 6 5 6 4 6 1 1 4 6 5 4 1 
1370 6 5 5 5 5 5 3 5 6 5 5 5 6 6 5 3 4 1 6 2 2 2 1 2 4 2 6 5 6 4 6 1 1 4 6 5 4 1 
1350 6 5 5 5 5 5 3 5 6 5 5 5 6 6 5 3 4 1 6 2 2 2 1 2 4 2 6 5 6 4 6 1 1 4 6 5 4 3 
1350 6 5 5 5 5 5 3 5 6 5 5 5 6 6 5 3 4 1 6 2 2 2 1 2 4 2 6 5 6 4 6 1 1 4 6 5 4 3 
