795 6 5 5 5 3 4 6 6 2 1 5 4 2 6 6 4 6 1 2 2 1 1 2 2 1 4 
785 6 5 5 5 3 4 6 6 2 1 5 4 2 6 6 4 6 1 2 2 1 1 2 6 
770 6 5 5 5 3 4 6 6 2 1 5 4 2 6 6 4 6 1 2 2 2 2 5 
745 6 5 5 5 3 4 6 6 2 1 5 4 2 6 6 4 6 1 2 2 1 2 5 
720 6 5 5 5 3 4 6 6 2 1 5 4 2 6 6 4 6 1 2 2 1 1 5 
720 6 5 5 5 3 4 6 6 2 1 5 4 2 6 6 4 6 1 2 2 1 1 1 4 
720 6 5 5 5 3 4 6 6 2 1 5 4 2 6 6 4 6 1 2 2 1 1 5 
710 6 5 5 5 3 4 6 6 2 1 5 4 2 6 6 4 6 1 2 2 1 6 
710 6 5 5 5 3 4 6 6 2 1 5 4 2 6 6 4 6 1 2 2 1 6 
695 6 5 5 5 3 4 6 6 2 1 5 4 2 6 6 4 6 1 2 2 1 5 
695 6 5 5 5 3 4 6 6 2 1 5 4 2 6 6 4 6 1 2 2 1 1 4 
695 6 5 5 5 3 4 6 6 2 1 5 4 2 6 6 4 6 1 2 2 1 5 
695 6 5 5 5 3 4 6 6 2 1 5 4 2 6 6 4 6 1 2 2 2 4 
675 6 5 5 5 3 4 6 6 2 1 5 4 2 6 1 6 4 4 3 1 6 2 5 
675 6 5 5 5 3 4 6 6 2 1 5 4 2 6 6 4 6 1 2 2 1 1 3 
675 6 5 5 5 3 4 6 6 2 1 5 4 2 6 6 4 4 3 5 5 1 1 6 
675 6 5 5 5 3 4 6 6 2 1 5 4 2 6 6 4 6 1 2 2 1 1 3 
670 6 5 5 5 3 4 6 6 2 1 5 4 2 6 6 4 6 1 2 2 1 4 
670 6 5 5 5 3 4 6 6 2 1 5 4 2 6 6 4 6 1 2 2 5 
650 6 5 5 5 3 4 6 6 2 1 5 4 2 6 6 4 6 1 2 2 1 3 
650 6 5 5 5 3 4 6 6 2 1 5 4 2 6 6 4 6 1 2 2 1 3 
645 6 5 5 5 3 4 6 6 2 1 5 4 2 6 6 4 6 1 2 2 4 
645 6 5 5 5 3 4 6 6 2 1 5 4 2 6 6 4 6 1 2 2 4 
645 6 5 5 5 3 4 6 6 2 1 5 4 2 6 6 4 6 1 2 2 4 
630 6 5 5 5 3 4 6 6 2 1 5 4 2 6 1 5 4 6 3 3 1 1 6 
625 6 5 5 5 3 4 6 6 2 1 5 4 2 6 6 4 6 1 2 2 3 
625 6 5 5 5 3 4 6 6 2 1 5 4 2 6 6 4 6 1 2 2 3 
625 6 5 5 5 3 4 6 6 2 1 5 4 2 6 6 4 6 1 2 2 3 
605 6 5 5 5 3 4 6 6 2 1 5 4 2 6 6 4 5 2 1 5 
605 6 5 5 5 3 4 6 6 2 1 5 4 2 6 6 6 5 3 5 1 3 
595 6 5 5 5 3 4 6 6 2 1 5 4 2 6 6 6 5 5 4 
595 6 5 5 5 3 4 6 6 2 1 5 4 2 6 6 5 3 5 3 1 1 1 3 
590 6 5 5 5 3 4 6 6 2 1 5 4 2 6 6 3 5 2 1 5 3 
565 6 5 5 5 3 4 6 6 2 1 5 4 2 6 6 6 1 6 3 
560 6 5 5 5 3 4 6 6 2 1 5 4 2 6 6 5 1 5 1 3 
550 6 5 5 5 3 4 6 6 2 1 5 4 2 6 6 4 4 1 6 3 
480 6 5 5 5 3 4 6 6 2 1 5 4 2 6 6 4 2 
460 6 5 5 5 3 4 6 6 2 1 5 4 2 3 6 6 2 
455 6 5 5 5 3 4 6 6 2 1 5 4 2 6 6 4 1 
415 6 5 5 5 3 4 6 6 2 1 5 4 2 6 4 2 
410 6 5 5 5 3 4 6 6 2 1 5 4 2 6 3 3 3 5 3 
395 6 5 5 5 3 4 6 6 2 1 5 4 2 6 3 5 
390 6 5 5 5 3 4 6 6 2 1 5 4 2 6 2 
370 6 5 5 5 3 4 6 6 2 1 5 4 2 6 3 1 
370 6 5 5 5 3 4 6 6 2 1 5 4 2 6 3 1 
370 6 5 5 5 3 4 6 6 6 3 5 4 2 6 3 4 3 
325 6 5 5 5 3 4 6 6 2 1 5 4 2 5 
255 6 5 5 5 3 4 6 6 2 1 5 4 3 4 
