105 5 4 5 5 5 6 6 5 
105 5 4 5 5 5 5 6 6 
100 5 4 5 5 5 5 4 5 5 
95 5 4 5 5 5 5 3 2 6 
90 5 4 5 5 5 5 6 5 
90 5 4 5 5 5 6 2 5 
90 5 4 5 5 5 5 4 6 4 
65 5 4 5 5 5 5 6 4 
65 5 4 5 5 5 5 6 4 
65 5 4 5 5 5 5 6 1 
65 5 4 5 5 5 5 6 4 
65 5 4 5 5 5 5 6 4 
65 5 4 5 5 5 5 6 1 
60 5 4 5 5 5 5 3 1 2 3 6 
50 5 4 5 5 5 5 3 6 3 
45 5 4 5 5 5 5 6 3 
45 5 4 5 5 5 5 6 3 
25 5 4 5 5 5 5 2 
25 5 4 5 5 5 5 2 
25 5 4 5 5 5 5 2 
25 5 4 5 5 5 5 2 
0 5 4 5 5 5 5 1 
-25 5 4 5 5 5 2 
-50 5 4 5 5 5 1 
-70 5 4 5 5 5 3 
-70 5 4 5 5 5 3 
-70 5 4 5 5 5 3 
-125 5 4 5 2 
-160 6 5 4 5 5 5 5 5 5 6 3 4 4 
-160 6 5 4 5 5 5 5 5 5 6 4 5 
-160 6 5 4 5 5 5 5 5 5 6 4 
-160 6 5 4 5 5 5 5 5 5 6 4 
-170 3 5 4 5 5 5 5 5 5 6 4 
-170 3 5 4 5 5 5 5 5 5 6 6 
-200 5 5 4 5 5 5 5 5 5 6 4 5 3 5 
-200 5 5 4 5 5 5 5 5 5 6 2 
-200 1 5 4 5 5 5 5 5 5 6 4 2 
-200 5 5 4 5 5 5 5 5 5 6 6 
-200 5 5 4 5 5 5 5 5 5 6 3 
-200 5 5 4 5 5 5 5 5 5 6 4 5 
-200 4 5 4 5 5 5 5 5 5 6 2 
-200 4 5 4 5 5 5 5 5 5 6 4 
-200 5 5 4 5 5 5 5 5 5 6 3 
-205 5 5 4 5 5 5 5 5 2 
-205 5 5 4 5 5 5 5 5 5 3 
-205 5 5 4 5 5 5 5 5 4 
-550 3 5 4 5 5 5 5 5 
-580 4 5 4 5 5 5 5 5 
