545 6 5 5 5 3 4 6 6 2 1 5 4 2 6 6 4 6 1 4 3 
445 6 5 5 5 3 4 6 6 2 1 5 4 2 3 5 5 6 
415 6 5 5 5 3 4 6 6 2 1 5 4 2 6 1 2 
390 6 5 5 5 3 4 6 6 2 1 5 4 2 6 5 
370 6 5 5 5 3 4 6 6 2 1 5 4 2 6 3 1 
330 6 5 5 5 3 4 6 6 2 1 5 4 2 3 2 
330 6 5 5 5 3 4 6 6 5 4 5 5 1 3 2 
325 6 5 5 5 3 4 6 6 2 1 5 4 2 2 
325 6 5 5 5 3 4 6 6 2 1 5 4 2 2 
315 6 5 5 5 3 4 6 6 2 1 5 4 4 6 
315 6 5 5 5 3 4 6 6 2 1 5 4 4 6 
315 6 5 5 5 3 4 6 6 2 1 1 1 5 6 
300 6 5 5 5 3 4 6 6 2 1 5 4 2 1 
300 6 5 5 5 3 4 6 6 2 1 1 2 1 5 
300 6 5 5 5 3 4 6 6 2 1 1 2 2 1 
300 6 5 5 5 3 4 6 6 2 1 5 1 1 5 
300 6 5 5 5 3 4 6 6 2 1 5 4 2 4 
300 6 5 5 5 3 4 6 6 2 1 1 5 1 5 
300 6 5 5 5 3 4 6 6 2 1 5 4 2 4 
300 6 5 5 5 3 4 6 6 2 1 5 4 2 4 
300 6 5 5 5 3 4 6 6 2 1 5 4 2 4 
300 6 5 5 5 3 4 6 6 2 1 5 4 4 2 
295 6 5 5 5 3 4 6 6 2 1 5 4 3 6 
295 6 5 5 5 3 4 6 6 5 4 1 1 4 3 6 
295 6 5 5 5 3 4 6 6 2 1 5 1 3 6 
295 6 5 5 5 3 4 6 6 2 1 5 4 3 6 
280 6 5 5 5 3 4 6 6 2 1 6 6 
280 6 5 5 5 3 4 6 6 2 1 6 6 
275 6 5 5 5 3 4 6 6 2 1 5 4 5 
275 6 5 5 5 3 4 6 6 2 1 5 4 1 1 
275 6 5 5 5 3 4 6 6 2 1 2 5 4 
275 6 5 5 5 3 4 6 6 2 1 6 3 2 3 
275 6 5 5 5 3 4 6 6 2 5 5 2 
270 6 5 5 5 3 4 6 6 2 1 5 3 6 
265 6 5 5 5 3 4 6 6 2 2 1 6 
265 6 5 5 5 3 4 6 6 2 1 5 6 
265 6 5 5 5 3 4 6 6 2 1 5 6 
260 6 5 5 5 3 4 6 6 4 4 3 1 3 5 2 
255 6 5 5 5 3 4 6 6 2 1 1 3 2 1 
255 6 5 5 5 3 4 6 6 2 1 1 3 5 1 
255 6 5 5 5 3 4 6 6 2 1 2 3 2 
255 6 5 5 5 3 4 6 6 2 1 1 3 4 5 
255 6 5 5 5 3 4 6 6 2 1 5 4 3 4 
255 6 5 5 5 3 4 6 6 5 1 1 4 3 2 
245 6 5 5 5 3 4 6 6 2 5 6 3 
245 6 5 5 5 3 4 6 6 3 4 6 4 1 1 
245 6 5 5 5 3 4 6 6 2 1 1 6 3 
240 6 5 5 5 3 4 6 6 2 3 4 3 3 2 4 
