270 5 4 5 5 5 6 4 5 2 2 1 4 3 2 
250 5 4 5 5 5 6 4 5 5 5 4 3 1 1 3 2 
140 5 4 5 5 5 5 5 4 4 6 
130 5 4 5 5 5 6 4 2 6 
130 5 4 5 5 5 6 4 2 6 
130 5 4 5 5 5 6 4 2 6 
125 5 4 5 5 5 4 4 5 5 5 
120 5 4 5 5 5 6 6 6 
115 5 4 5 5 5 6 4 2 5 
115 5 4 5 5 5 6 4 2 2 
115 5 4 5 5 5 5 4 6 2 
115 5 4 5 5 5 6 4 2 2 
115 5 4 5 5 5 6 4 2 2 
105 5 4 5 5 5 5 6 6 
105 5 4 5 5 5 6 2 6 
100 5 4 5 5 5 4 4 5 5 4 
95 5 4 5 5 5 6 4 3 5 4 
95 5 4 5 5 5 6 2 3 5 
95 5 4 5 5 5 6 2 3 5 
90 5 4 5 5 5 6 4 4 4 1 
90 5 4 5 5 5 6 4 2 1 
90 5 4 5 5 5 6 4 2 4 
90 5 4 5 5 5 6 5 5 
90 5 4 5 5 5 6 4 1 5 
80 5 4 5 5 5 6 4 6 
80 5 4 5 5 5 5 4 4 5 3 
80 5 4 5 5 5 6 4 6 
80 5 4 5 5 5 6 4 6 
80 5 4 5 5 5 6 4 6 
75 5 4 5 5 5 5 5 1 4 
70 5 4 5 5 5 6 4 5 3 
70 5 4 5 5 5 6 4 2 3 
60 5 4 5 5 5 6 6 3 
60 5 4 5 5 5 6 6 3 
60 5 4 5 5 5 6 6 3 
25 5 4 5 5 5 5 2 
25 5 4 5 5 5 4 4 2 
15 5 4 5 5 5 6 1 
15 5 4 5 5 5 6 1 
15 5 4 5 5 5 6 1 
0 5 4 5 5 5 5 1 
-10 5 4 5 5 5 6 3 1 3 3 
-10 5 4 5 5 5 6 3 4 4 2 
-10 5 4 5 5 5 6 3 1 3 
-20 5 4 5 5 5 5 3 
-25 5 4 5 5 5 2 
-60 5 4 5 5 6 
-75 5 4 5 5 2 
