1370 5 6 5 5 5 5 5 2 6 2 5 2 5 
1370 5 6 5 5 5 5 5 2 6 2 5 
1370 5 6 5 5 5 5 5 2 6 2 2 5 5 
1330 5 6 5 5 5 5 5 2 6 4 2 2 
1325 5 6 5 5 5 5 5 2 6 2 2 3 
1325 5 6 5 5 5 5 5 2 6 2 5 3 
1315 5 6 5 5 5 5 5 2 6 3 4 3 4 
1300 5 6 5 5 5 5 5 2 6 2 2 4 3 
1265 5 6 5 5 5 5 5 2 6 2 1 
1265 5 6 5 5 5 5 5 2 6 5 
1235 5 6 5 5 5 5 5 2 6 2 2 3 4 2 4 6 6 4 2 2 4 
1225 5 6 5 5 5 5 5 2 6 6 4 1 5 2 1 5 6 5 
1205 5 6 5 5 5 5 5 2 6 2 2 
1205 5 6 5 5 5 5 5 2 6 2 
1205 5 6 5 5 5 5 5 2 6 2 2 
1205 5 6 5 5 5 5 5 2 6 
1205 5 6 5 5 5 5 5 2 6 
1205 5 6 5 5 5 5 5 2 6 2 2 1 2 
1205 5 6 5 5 5 5 5 2 6 2 2 
1205 5 6 5 5 5 5 5 2 6 2 2 
1205 5 6 5 5 5 5 5 2 6 2 2 1 
1205 5 6 5 5 5 5 5 2 6 
1205 5 6 5 5 5 5 5 2 6 2 2 
1205 5 6 5 5 5 5 5 2 6 2 2 
1205 5 6 5 5 5 5 5 2 6 2 2 
1205 5 6 5 5 5 5 5 2 6 2 
1205 5 6 5 5 5 5 5 2 6 2 2 
1205 5 6 5 5 5 5 5 2 6 2 
1200 5 6 5 5 5 5 5 2 6 2 2 5 
1200 5 6 5 5 5 5 5 2 6 2 2 6 2 5 
1200 5 6 5 5 5 5 5 2 6 2 2 
1200 5 6 5 5 5 5 5 2 6 2 2 6 
1200 5 6 5 5 5 5 5 2 6 3 
1200 5 6 5 5 5 5 5 2 6 2 5 
1200 5 6 5 5 5 5 5 2 6 5 
1195 5 6 5 5 5 5 5 2 6 6 6 
1170 5 6 5 5 5 5 5 2 6 4 2 2 
1170 5 6 5 5 5 5 5 2 1 6 1 
1170 5 6 5 5 5 5 5 2 6 1 2 6 
1155 5 6 5 5 5 5 5 2 6 2 1 4 4 
1130 5 6 5 5 5 5 5 2 6 4 1 2 1 
955 5 6 5 5 5 5 5 2 6 2 
790 5 6 5 5 5 5 5 2 6 2 6 1 4 
750 5 6 5 5 5 5 5 2 6 2 4 1 6 
215 5 6 5 5 5 5 5 2 6 2 2 
210 5 6 5 5 5 5 5 2 6 2 2 6 5 
195 5 6 5 5 5 5 5 2 6 6 
195 5 6 5 5 5 5 5 2 6 4 
