140 5 4 5 5 5 4 4 5 5 6 
140 5 4 5 5 5 5 5 4 4 6 
125 5 4 5 5 5 5 5 4 4 2 
120 5 4 5 5 5 6 6 6 
120 5 4 5 5 5 6 6 6 
120 5 4 5 5 5 6 6 6 
115 5 4 5 5 5 6 4 2 5 
105 5 4 5 5 5 6 6 2 
105 5 4 5 5 5 6 6 5 
105 5 4 5 5 5 6 6 2 
105 5 4 5 5 5 6 6 5 
105 5 4 5 5 5 5 4 3 5 2 
100 5 4 5 5 5 5 4 5 2 
100 5 4 5 5 5 5 4 2 2 
95 5 4 5 5 5 6 3 4 2 1 
95 5 4 5 5 5 4 5 3 6 1 
95 5 4 5 5 5 6 4 3 5 1 
95 5 4 5 5 5 6 3 1 1 5 
95 5 4 5 5 5 6 3 4 4 5 
90 5 4 5 5 5 6 2 5 
90 5 4 5 5 5 5 6 5 
90 5 4 5 5 5 5 5 6 
80 5 4 5 5 5 3 5 4 2 1 
80 5 4 5 5 5 6 6 1 
80 5 4 5 5 5 6 6 4 
75 5 4 5 5 5 6 4 3 3 5 
70 5 4 5 5 5 6 3 5 1 
65 5 4 5 5 5 5 6 1 
65 5 4 5 5 5 5 6 4 
65 5 4 5 5 5 5 6 4 
60 5 4 5 5 5 6 6 3 
60 5 4 5 5 5 6 6 3 
50 5 4 5 5 5 4 1 4 4 4 6 
25 5 4 5 5 5 4 5 1 
25 5 4 5 5 5 5 2 
25 5 4 5 5 5 5 4 1 
15 5 4 5 5 5 6 1 
15 5 4 5 5 5 6 1 
15 5 4 5 5 5 6 1 
15 5 4 5 5 5 6 1 
0 5 4 5 5 5 6 3 3 
0 5 4 5 5 5 6 3 3 
-20 5 4 5 5 5 5 3 
-25 5 4 5 5 5 2 
-25 5 4 5 5 5 2 
-50 5 4 5 5 5 1 
-50 5 4 5 5 5 1 
-50 5 4 5 5 5 1 
