1540 6 5 5 5 5 5 3 5 6 5 5 5 6 6 5 3 4 1 6 2 2 2 1 2 4 2 6 5 6 4 6 1 1 4 6 5 4 6 6 6 
1540 6 5 5 5 5 5 3 5 6 5 5 5 6 6 5 3 4 1 6 2 2 2 1 2 4 2 6 5 6 4 6 1 1 4 6 5 4 6 6 6 
1540 6 5 5 5 5 5 3 5 6 5 5 5 6 6 5 3 4 1 6 2 2 2 1 2 4 2 6 5 6 4 6 1 1 4 6 5 4 6 6 6 
1525 6 5 5 5 5 5 3 5 6 5 5 5 6 6 5 3 4 1 6 2 2 2 1 2 4 2 6 5 6 4 6 1 1 4 6 5 4 6 6 5 
1500 6 5 5 5 5 5 3 5 6 5 5 5 6 6 5 3 4 1 6 2 2 2 1 2 4 2 6 5 6 4 6 1 1 4 6 5 4 6 6 4 
1500 6 5 5 5 5 5 3 5 6 5 5 5 6 6 5 3 4 1 6 2 2 2 1 2 4 2 6 5 6 4 6 1 1 4 6 5 4 6 6 1 
1480 6 5 5 5 5 5 3 5 6 5 5 5 6 6 5 3 4 1 6 2 2 2 1 2 4 2 6 5 6 4 6 1 1 4 6 5 4 6 6 3 
1480 6 5 5 5 5 5 3 5 6 5 5 5 6 6 5 3 4 1 6 2 2 2 1 2 4 2 6 5 6 4 6 1 1 4 6 5 4 6 6 3 
1480 6 5 5 5 5 5 3 5 6 5 5 5 6 6 5 3 4 1 6 2 2 2 1 2 4 2 6 5 6 4 6 1 1 4 6 5 4 6 6 3 
1480 6 5 5 5 5 5 3 5 6 5 5 5 6 6 5 3 4 1 6 2 2 2 1 2 4 2 6 5 6 4 6 1 1 4 6 5 4 6 6 3 
1480 6 5 5 5 5 5 3 5 6 5 5 5 6 6 5 3 4 1 6 2 2 2 1 2 4 2 6 5 6 4 6 1 1 4 6 5 4 6 6 3 
1480 6 5 5 5 5 5 3 5 6 5 5 5 6 6 5 3 4 1 6 2 2 2 1 2 4 2 6 5 6 4 6 1 1 4 6 5 4 6 6 3 
1470 6 5 5 5 5 5 3 5 6 5 5 5 6 6 5 3 4 1 6 2 2 2 1 2 4 2 6 5 6 4 6 1 1 4 3 4 5 3 6 2 6 
1470 6 5 5 5 5 5 3 5 6 5 5 5 6 6 5 3 4 1 6 2 2 2 1 2 4 2 6 5 6 4 6 1 1 4 3 4 5 3 6 2 6 
1465 6 5 5 5 5 5 3 5 6 5 5 5 6 6 5 3 4 1 6 2 2 2 1 2 4 2 6 5 6 4 6 1 1 4 6 5 4 6 3 5 
1460 6 5 5 5 5 5 3 5 6 5 5 5 6 6 5 3 4 1 6 2 2 2 1 2 4 2 6 5 6 4 6 1 1 4 6 5 4 6 5 
1460 6 5 5 5 5 5 3 5 6 5 5 5 6 6 5 3 4 1 6 2 2 2 1 2 4 2 6 5 6 4 6 1 1 4 6 5 4 6 2 
1460 6 5 5 5 5 5 3 5 6 5 5 5 6 6 5 3 4 1 6 2 2 2 1 2 4 2 6 5 6 4 6 1 1 4 6 5 4 6 5 
1460 6 5 5 5 5 5 3 5 6 5 5 5 6 6 5 3 4 1 6 2 2 2 1 2 4 2 6 5 6 4 6 1 1 4 6 5 4 6 2 
1455 6 5 5 5 5 5 3 5 6 5 5 5 6 6 5 3 4 1 6 2 2 2 1 2 4 2 6 5 6 4 6 1 1 4 3 4 5 3 6 2 5 
1455 6 5 5 5 5 5 3 5 6 5 5 5 6 6 5 3 4 1 6 2 2 2 1 2 4 2 6 5 6 4 6 1 1 4 3 4 5 3 6 2 5 
1450 6 5 5 5 5 5 3 5 6 5 5 5 6 6 5 3 4 1 6 2 2 2 1 2 4 2 6 5 6 4 6 1 1 4 6 5 4 4 5 3 4 4 
1435 6 5 5 5 5 5 3 5 6 5 5 5 6 6 5 3 4 1 6 2 2 2 1 2 4 2 6 5 6 4 6 1 1 4 6 5 4 6 1 
1435 6 5 5 5 5 5 3 5 6 5 5 5 6 6 5 3 4 1 6 2 2 2 1 2 4 2 6 5 6 4 6 1 1 4 6 5 4 6 1 
1435 6 5 5 5 5 5 3 5 6 5 5 5 6 6 5 3 4 1 6 2 2 2 1 2 4 2 6 5 6 4 6 1 1 4 6 5 4 6 4 
1435 6 5 5 5 5 5 3 5 6 5 5 5 6 6 5 3 4 1 6 2 2 2 1 2 4 2 6 5 6 4 6 1 1 4 6 5 4 6 1 
1435 6 5 5 5 5 5 3 5 6 5 5 5 6 6 5 3 4 1 6 2 2 2 1 2 4 2 6 5 6 4 6 1 1 4 6 5 4 6 4 
1435 6 5 5 5 5 5 3 5 6 5 5 5 6 6 5 3 4 1 6 2 2 2 1 2 4 2 6 5 6 4 6 1 1 4 6 5 4 6 4 
1430 6 5 5 5 5 5 3 5 6 5 5 5 6 6 5 3 4 1 6 2 2 2 1 2 4 2 6 5 6 4 6 1 1 4 3 4 5 3 6 2 4 
1430 6 5 5 5 5 5 3 5 6 5 5 5 6 6 5 3 4 1 6 2 2 2 1 2 4 2 6 5 6 4 6 1 1 4 3 4 5 3 6 2 4 
1430 6 5 5 5 5 5 3 5 6 5 5 5 6 6 5 3 4 1 6 2 2 2 1 2 4 2 6 5 6 4 6 1 1 4 3 4 5 3 6 2 1 
1430 6 5 5 5 5 5 3 5 6 5 5 5 6 6 5 3 4 1 6 2 2 2 1 2 4 2 6 5 6 4 6 1 1 4 3 4 5 3 6 5 1 
1420 6 5 5 5 5 5 3 5 6 5 5 5 6 6 5 3 4 1 6 2 2 2 1 2 4 2 6 5 6 4 6 1 1 4 3 4 5 3 6 6 
1410 6 5 5 5 5 5 3 5 6 5 5 5 6 6 5 3 4 1 6 2 2 2 1 2 4 2 6 5 6 4 6 1 1 4 3 4 5 3 6 3 2 
1395 6 5 5 5 5 5 3 5 6 5 5 5 6 6 5 3 4 1 6 2 2 2 1 2 4 2 6 5 6 4 6 1 1 4 6 5 4 2 
1395 6 5 5 5 5 5 3 5 6 5 5 5 6 6 5 3 4 1 6 2 2 2 1 2 4 2 6 5 6 4 6 1 1 4 6 5 4 2 
1380 6 5 5 5 5 5 3 5 6 5 5 5 6 6 5 3 4 1 6 2 2 2 1 2 4 2 6 5 6 4 6 1 1 4 3 4 5 3 6 1 
1380 6 5 5 5 5 5 3 5 6 5 5 5 6 6 5 3 4 1 6 2 2 2 1 2 4 2 6 5 6 4 6 1 1 4 3 4 5 3 6 1 
1370 6 5 5 5 5 5 3 5 6 5 5 5 6 6 5 3 4 1 6 2 2 2 1 2 4 2 6 5 6 4 6 1 1 4 6 5 4 1 
1370 6 5 5 5 5 5 3 5 6 5 5 5 6 6 5 3 4 1 6 2 2 2 1 2 4 2 6 5 6 4 6 1 1 4 6 5 4 1 
1370 6 5 5 5 5 5 3 5 6 5 5 5 6 6 5 3 4 1 6 2 2 2 1 2 4 2 6 5 6 4 6 1 1 4 6 5 4 1 
1370 6 5 5 5 5 5 3 5 6 5 5 5 6 6 5 3 4 1 6 2 2 2 1 2 4 2 6 5 6 4 6 1 1 4 6 5 4 1 
1370 6 5 5 5 5 5 3 5 6 5 5 5 6 6 5 3 4 1 6 2 2 2 1 2 4 2 6 5 6 4 6 1 1 4 6 5 4 1 
1365 6 5 5 5 5 5 3 5 6 5 5 5 6 6 5 3 4 1 6 2 2 2 1 2 4 2 6 5 6 4 6 1 1 4 3 4 5 3 5 1 
1355 6 5 5 5 5 5 3 5 6 5 5 5 6 6 5 3 4 1 6 2 2 2 1 2 4 2 6 5 6 4 6 1 1 4 3 6 5 3 3 1 4 1 
1350 6 5 5 5 5 5 3 5 6 5 5 5 6 6 5 3 4 1 6 2 2 2 1 2 4 2 6 5 6 4 6 1 1 4 6 5 4 3 
1350 6 5 5 5 5 5 3 5 6 5 5 5 6 6 5 3 4 1 6 2 2 2 1 2 4 2 6 5 6 4 6 1 1 4 6 5 4 3 
1345 6 5 5 5 5 5 3 5 6 5 5 5 6 6 5 3 4 1 6 2 2 2 1 2 4 2 6 5 6 4 6 1 1 4 3 4 5 3 5 3 
1340 6 5 5 5 5 5 3 5 6 5 5 5 6 6 5 3 4 1 6 2 2 2 1 2 4 2 6 5 6 4 6 1 1 4 3 4 5 3 2 
1340 6 5 5 5 5 5 3 5 6 5 5 5 6 6 5 3 4 1 6 2 2 2 1 2 4 2 6 5 6 4 6 1 1 4 3 4 5 3 2 
1315 6 5 5 5 5 5 3 5 6 5 5 5 6 6 5 3 4 1 6 2 2 2 1 2 4 2 6 5 6 4 6 1 1 4 3 4 5 3 4 
1315 6 5 5 5 5 5 3 5 6 5 5 5 6 6 5 3 4 1 6 2 2 2 1 2 4 2 6 5 6 4 6 1 1 4 3 4 5 3 1 
1315 6 5 5 5 5 5 3 5 6 5 5 5 6 6 5 3 4 1 6 2 2 2 1 2 4 2 6 5 6 4 6 1 1 4 3 4 5 3 4 
1315 6 5 5 5 5 5 3 5 6 5 5 5 6 6 5 3 4 1 6 2 2 2 1 2 4 2 6 5 6 4 6 1 1 4 3 4 5 3 4 
1315 6 5 5 5 5 5 3 5 6 5 5 5 6 6 5 3 4 1 6 2 2 2 1 2 4 2 6 5 6 4 6 1 1 4 3 4 5 3 4 
1310 6 5 5 5 5 5 3 5 6 5 5 5 6 6 5 3 4 1 6 2 2 2 1 2 4 2 6 5 6 4 6 1 1 4 3 4 5 4 
1305 6 5 5 5 5 5 3 5 6 5 5 5 6 6 5 3 4 1 6 2 2 2 1 2 4 2 6 5 6 4 6 1 1 4 3 4 3 6 
1305 6 5 5 5 5 5 3 5 6 5 5 5 6 6 5 3 4 1 6 2 2 2 1 2 4 2 6 5 6 4 6 1 1 4 3 6 3 1 
1295 6 5 5 5 5 5 3 5 6 5 5 5 6 6 5 3 4 1 6 2 2 2 1 2 4 2 6 5 6 4 6 1 1 4 3 4 5 3 3 
1295 6 5 5 5 5 5 3 5 6 5 5 5 6 6 5 3 4 1 6 2 2 2 1 2 4 2 6 5 6 4 6 1 1 4 3 4 5 3 3 
1295 6 5 5 5 5 5 3 5 6 5 5 5 6 6 5 3 4 1 6 2 2 2 1 2 4 2 6 5 6 4 6 1 1 4 3 4 5 3 3 
1255 6 5 5 5 5 5 3 5 6 5 5 5 6 6 5 3 4 1 6 2 2 2 1 2 4 2 6 5 6 4 6 1 1 4 3 5 6 
1255 6 5 5 5 5 5 3 5 6 5 5 5 6 6 5 3 4 1 6 2 2 2 1 2 4 2 6 5 6 4 6 1 1 4 3 5 3 4 
1255 6 5 5 5 5 5 3 5 6 5 5 5 6 6 5 3 4 1 6 2 2 2 1 2 4 2 6 5 6 4 6 1 1 4 3 5 1 3 2 
