10 6 5 5 5 3 4 6 6 2 1 5 4 2 6 6 4 6 1 4 
10 6 5 5 5 3 4 6 6 2 1 5 4 2 6 6 4 6 1 4 
10 6 5 5 5 3 4 6 6 2 1 5 4 2 6 6 4 6 1 4 
10 6 5 5 5 3 4 6 6 2 1 5 4 2 6 6 4 6 1 4 
10 6 5 5 5 3 4 6 6 2 1 5 4 2 6 6 4 6 1 
10 6 5 5 5 3 4 6 6 2 1 5 4 2 6 6 4 6 1 4 
10 6 5 5 5 3 4 6 6 2 1 5 4 2 6 6 4 6 1 4 
10 6 5 5 5 3 4 6 6 2 1 5 4 2 6 6 4 6 1 4 
10 6 5 5 5 3 4 6 6 2 1 5 4 2 6 6 4 6 
10 6 5 5 5 3 4 6 6 2 1 5 4 2 6 6 4 6 1 
10 6 5 5 5 3 4 6 6 2 1 5 4 2 6 6 4 6 1 4 
10 6 5 5 5 3 4 6 6 2 1 5 4 2 6 6 4 6 1 4 
10 6 5 5 5 3 4 6 6 2 1 5 4 2 6 6 4 6 1 4 
10 6 5 5 5 3 4 6 6 2 1 5 4 2 6 6 4 6 1 4 
10 6 5 5 5 3 4 6 6 2 1 5 4 2 6 6 4 6 
10 6 5 5 5 3 4 6 6 2 1 5 4 2 6 6 4 6 1 4 
10 6 5 5 5 3 4 6 6 2 1 5 4 2 6 6 4 6 1 4 
10 6 5 5 5 3 4 6 6 2 1 5 4 2 6 6 4 6 1 
10 6 5 5 5 3 4 6 6 2 1 5 4 2 6 6 4 6 1 4 
10 6 5 5 5 3 4 6 6 2 1 5 4 2 6 6 4 6 
10 6 5 5 5 3 4 6 6 2 1 5 4 2 6 6 4 6 1 4 
10 6 5 5 5 3 4 6 6 2 1 5 4 2 6 6 4 6 1 4 
10 6 5 5 5 3 4 6 6 2 1 5 4 2 6 6 4 6 1 4 
10 6 5 5 5 3 4 6 6 2 1 5 4 2 6 6 4 6 
10 6 5 5 5 3 4 6 6 2 1 5 4 2 6 6 4 6 
10 6 5 5 5 3 4 6 6 2 1 5 4 2 3 5 
10 6 5 5 5 3 4 6 6 2 1 5 4 2 6 
10 6 5 5 5 3 4 6 6 2 1 5 4 2 6 
10 6 5 5 5 3 4 6 6 2 1 5 4 2 6 
10 6 5 5 5 3 4 6 6 2 1 5 4 
10 6 5 5 5 3 4 6 6 5 4 5 5 1 3 
10 6 5 5 5 3 4 6 6 2 1 5 4 2 
10 6 5 5 5 3 4 6 6 2 1 5 4 2 
10 6 5 5 5 3 4 6 6 2 1 5 4 
10 6 5 5 5 3 4 6 6 2 1 5 4 
10 6 5 5 5 3 4 6 6 2 1 1 1 5 
10 6 5 5 5 3 4 6 6 2 1 5 4 
10 6 5 5 5 3 4 6 6 2 1 5 4 2 
10 6 5 5 5 3 4 6 6 2 1 5 
10 6 5 5 5 3 4 6 6 2 1 5 
10 6 5 5 5 3 4 6 6 2 1 1 
10 6 5 5 5 3 4 6 6 2 1 5 4 
10 6 5 5 5 3 4 6 6 2 1 5 
10 6 5 5 5 3 4 6 6 2 1 1 
10 6 5 5 5 3 4 6 6 2 1 1 2 1 
10 6 5 5 5 3 4 6 6 2 1 5 
10 6 5 5 5 3 4 6 6 2 1 5 4 3 
10 6 5 5 5 3 4 6 6 2 1 5 1 
