-20 5 6 5 5 5 5 5 2 6 2 2 1 2 5 6 6 5 2 
-20 5 6 5 5 5 5 5 2 6 2 2 1 2 5 6 6 5 6 6 6 
-35 5 6 5 5 5 5 5 2 6 2 2 1 2 5 6 1 
-35 5 6 5 5 5 5 5 2 6 2 2 1 2 5 6 6 5 6 1 
-35 5 6 5 5 5 5 5 2 6 2 2 1 2 5 6 6 5 4 
-35 5 6 5 5 5 5 5 2 6 2 2 1 2 5 6 6 5 5 
-60 5 6 5 5 5 5 5 2 6 2 2 1 2 5 6 6 5 6 6 4 
-60 5 6 5 5 5 5 5 2 6 2 2 1 2 5 6 6 5 6 6 2 5 
-60 5 6 5 5 5 5 5 2 6 2 2 1 2 5 6 6 2 
-60 5 6 5 5 5 5 5 2 6 2 2 1 2 5 6 6 5 6 5 
-60 5 6 5 5 5 5 5 2 6 2 2 1 2 5 6 6 5 6 6 
-60 5 6 5 5 5 5 5 2 6 2 2 1 2 5 6 6 5 6 6 
-60 5 6 5 5 5 5 5 2 6 2 2 1 2 5 6 6 5 6 6 4 
-60 5 6 5 5 5 5 5 2 6 2 2 1 2 5 6 6 6 
-60 5 6 5 5 5 5 5 2 6 2 2 1 2 5 6 6 5 1 
-60 5 6 5 5 5 5 5 2 6 2 2 1 2 5 6 6 5 6 1 
-60 5 6 5 5 5 5 5 2 6 2 2 1 2 5 6 6 5 6 6 1 
-60 5 6 5 5 5 5 5 2 6 2 2 1 2 5 6 6 5 6 6 3 
-60 5 6 5 5 5 5 5 2 6 2 2 1 2 5 6 6 5 6 2 
-60 5 6 5 5 5 5 5 2 6 2 2 1 2 5 6 6 5 6 6 3 
-60 5 6 5 5 5 5 5 2 6 2 2 1 2 5 6 6 5 3 
-60 5 6 5 5 5 5 5 2 6 2 2 1 2 5 6 6 
-60 5 6 5 5 5 5 5 2 6 2 2 1 2 5 6 6 5 6 6 
-80 5 6 5 5 5 5 5 2 6 2 2 1 2 5 6 6 5 6 6 
-85 5 6 5 5 5 5 5 2 6 2 2 1 2 5 6 
-85 5 6 5 5 5 5 5 2 6 2 2 1 2 5 6 6 5 
-85 5 6 5 5 5 5 5 2 6 2 2 1 2 5 6 6 5 
-85 5 6 5 5 5 5 5 2 6 2 2 1 2 5 6 6 5 
-85 5 6 5 5 5 5 5 2 6 2 2 1 2 5 6 
-85 5 6 5 5 5 5 5 2 6 2 2 1 2 5 6 6 5 
-85 5 6 5 5 5 5 5 2 6 2 2 1 2 5 6 
-85 5 6 5 5 5 5 5 2 6 2 2 1 2 5 6 6 5 
-85 5 6 5 5 5 5 5 2 6 2 2 1 2 5 6 6 5 
-85 5 6 5 5 5 5 5 2 6 2 2 1 2 5 6 6 5 
-85 5 6 5 5 5 5 5 2 6 2 2 1 2 5 6 6 
-85 5 6 5 5 5 5 5 2 6 2 2 1 2 5 6 6 
-85 5 6 5 5 5 5 5 2 6 2 2 1 2 5 6 
-85 5 6 5 5 5 5 5 2 6 2 2 1 2 5 6 
-85 5 6 5 5 5 5 5 2 6 2 2 1 2 5 6 
-85 5 6 5 5 5 5 5 2 6 2 2 1 2 5 6 
-85 5 6 5 5 5 5 5 2 6 2 2 1 2 5 6 
-85 5 6 5 5 5 5 5 2 6 2 2 1 2 5 6 6 5 
-85 5 6 5 5 5 5 5 2 6 2 2 1 2 5 6 6 
-85 5 6 5 5 5 5 5 2 6 2 2 1 2 5 6 6 5 
-85 5 6 5 5 5 5 5 2 6 2 2 1 2 5 6 6 5 
-85 5 6 5 5 5 5 5 2 6 2 2 1 2 5 6 6 
-85 5 6 5 5 5 5 5 2 6 2 2 1 2 5 6 6 5 
-85 5 6 5 5 5 5 5 2 6 2 2 1 2 5 6 6 
