185 5 6 5 5 3 4 6 4 6 3 1 3 5 2 
125 5 6 5 5 3 4 6 4 1 6 
120 5 6 5 5 3 4 5 4 2 5 
110 5 6 5 5 3 4 6 2 2 
110 5 6 5 5 3 4 5 6 2 
100 5 6 5 5 3 6 6 5 
100 5 6 5 5 3 4 3 5 2 5 
100 5 6 5 5 3 6 5 6 
100 5 6 5 5 3 4 3 5 2 5 
100 5 6 5 5 3 6 2 6 
100 5 6 5 5 3 4 6 1 6 
95 5 6 5 5 3 4 3 4 4 3 4 6 
95 5 6 5 5 3 5 5 4 5 
90 5 6 5 5 3 4 3 4 5 6 
90 5 6 5 5 3 6 3 5 2 
90 5 6 5 5 3 6 3 1 4 1 1 
90 5 6 5 5 3 4 5 1 3 6 
85 5 6 5 5 3 6 5 5 
85 5 6 5 5 3 6 2 5 
85 5 6 5 5 3 4 6 4 4 1 
85 5 6 5 5 3 4 6 5 4 
80 5 6 5 5 3 4 3 5 3 1 5 
80 5 6 5 5 3 4 6 3 6 
75 5 6 5 5 3 4 3 4 4 4 2 
75 5 6 5 5 3 4 4 2 3 5 
75 5 6 5 5 3 4 3 5 2 4 
75 5 6 5 5 3 4 4 5 3 5 
75 5 6 5 5 3 4 3 5 5 1 
75 5 6 5 5 3 4 3 5 5 1 
70 5 6 5 5 3 4 4 2 5 
70 5 6 5 5 3 4 5 1 5 
70 5 6 5 5 3 4 3 4 3 6 4 
70 5 6 5 5 3 4 5 5 1 
70 5 6 5 5 3 6 3 3 4 4 1 
70 2 6 5 5 4 4 3 4 5 4 
65 5 6 5 5 3 4 3 4 6 4 
65 5 6 5 5 3 4 6 4 1 3 
65 5 6 5 5 3 4 3 6 5 
65 5 6 5 5 3 4 3 6 2 
65 5 6 5 5 3 4 3 6 2 
65 5 6 5 5 3 4 3 5 6 
65 5 6 5 5 3 4 3 6 5 
65 5 6 5 5 3 4 6 3 2 
65 5 6 5 5 3 4 3 5 6 
60 5 6 5 5 3 6 5 4 
60 5 6 5 5 3 6 2 1 
60 5 6 5 5 3 6 5 4 
60 5 6 5 5 3 5 6 1 
60 5 6 5 5 3 4 6 1 1 
60 5 6 5 5 3 4 4 6 4 
55 5 6 5 5 3 4 3 5 4 1 3 
55 5 6 5 5 3 6 6 3 
55 5 6 5 5 3 6 6 3 
50 5 6 5 5 3 4 5 4 1 3 
50 5 6 5 5 3 4 4 3 2 4 
50 5 6 5 5 3 4 3 4 2 4 
40 5 6 5 5 3 4 3 6 1 
40 5 6 5 5 3 4 3 6 4 
40 5 6 5 5 3 4 6 1 3 
0 5 6 5 5 3 4 5 3 
0 5 6 5 5 3 4 3 2 
0 5 6 5 5 3 4 3 2 
0 5 6 5 5 3 4 3 2 
0 5 6 5 5 3 4 3 2 
0 5 6 5 5 3 4 3 4 1 
0 5 6 5 5 3 4 3 2 
0 5 6 5 5 3 4 3 2 
0 5 6 5 5 3 4 3 2 
0 5 6 5 5 3 4 5 3 
0 5 6 5 5 3 4 3 2 
0 5 6 5 5 3 4 3 2 
0 5 6 5 5 3 4 3 2 
0 5 6 5 5 3 4 3 2 
-5 5 6 5 5 3 4 4 4 
-5 5 6 5 5 3 4 2 
-5 5 6 5 5 3 5 1 
-5 5 6 5 5 3 5 1 
-5 5 6 5 5 3 4 4 4 
-5 5 6 5 5 3 4 2 
-5 5 6 5 5 3 5 4 
-5 5 6 5 5 3 4 2 
-5 5 6 5 5 3 4 2 
-5 5 6 5 5 3 4 2 
-5 5 6 5 5 3 4 4 4 
-5 5 6 5 5 3 4 2 
-15 2 6 5 5 6 3 
-25 5 6 5 5 3 4 3 1 
-25 5 6 5 5 3 4 3 1 
-25 5 6 5 5 3 4 3 1 
-25 5 6 5 5 3 4 3 1 
-25 5 6 5 5 3 4 3 1 
-25 5 6 5 5 3 4 3 1 
-30 5 6 5 5 3 4 1 
-30 5 6 5 5 3 4 1 
-30 5 6 5 5 3 2 
-30 5 6 5 5 3 4 1 
-30 5 6 5 5 3 4 1 
-30 5 6 5 5 3 2 
-30 5 6 5 5 3 4 1 
-30 5 6 5 5 3 4 1 
-30 5 6 5 5 3 2 
-30 5 6 5 5 3 2 
-30 5 6 5 5 3 2 
-30 5 6 5 5 3 4 1 
-30 5 6 5 5 3 4 1 
-30 5 6 5 5 3 2 
-30 5 6 5 5 3 2 
-30 5 6 5 5 3 2 
-30 5 6 5 5 3 4 1 
-30 5 6 5 5 3 4 1 
-30 5 6 5 5 3 4 1 
-30 5 6 5 5 3 4 1 
-45 5 6 5 5 3 4 3 3 
-45 5 6 5 5 3 4 3 3 
-45 5 6 5 5 3 4 3 3 
-45 5 6 5 5 3 4 3 3 
-45 5 6 5 5 3 4 3 3 
-45 5 6 5 5 3 4 3 3 
-45 5 6 5 5 3 4 3 3 
-55 5 6 5 5 3 1 
-55 5 6 5 5 3 1 
-70 6 5 5 6 
-70 5 6 5 6 
-75 5 6 5 5 3 3 
-75 5 6 5 5 3 3 
-75 5 6 5 5 3 3 
-75 5 6 5 5 3 3 
-75 5 6 5 5 3 3 
-75 5 6 5 5 3 3 
-75 5 6 5 5 3 3 
-75 5 6 5 5 3 3 
-75 5 6 5 5 3 3 
-75 5 6 5 5 3 3 
-100 5 4 5 5 1 
-100 5 1 5 5 1 
-100 1 1 4 5 5 1 
-110 6 5 5 4 
-110 4 5 5 6 
-110 1 2 5 6 
-110 3 5 3 5 3 5 1 
-120 6 5 6 
-120 2 6 6 
-125 2 1 5 2 
-125 2 1 5 2 
-135 6 5 2 
-135 5 6 2 
-135 5 6 2 
-135 6 5 2 
-135 3 3 1 6 6 
-135 6 5 2 
-140 4 3 4 3 5 2 
-150 5 1 5 1 
-155 3 1 2 6 
-155 5 4 3 6 
-155 4 3 2 6 
-155 3 2 4 6 
-160 4 2 6 
-160 1 2 6 
-160 2 6 1 
-160 2 1 6 
-160 2 6 4 
-160 5 1 6 
-160 2 6 4 
-160 1 5 6 
-160 5 4 6 
-160 1 1 6 1 
-160 2 4 6 
-165 3 6 6 
-165 6 3 6 
-165 6 3 6 
-165 2 3 3 5 1 
-170 2 3 1 5 
-170 3 2 4 5 
-170 5 1 5 3 
-170 6 6 
-170 1 2 3 2 
-170 1 5 3 2 
-170 3 2 3 3 6 
-170 3 4 4 4 2 
-170 3 4 2 2 
-170 4 1 3 4 5 
-175 1 5 2 
-175 5 3 3 6 
-175 1 1 1 2 
-175 5 4 2 
-175 2 1 2 
-175 5 4 2 
-175 1 4 3 3 6 
-175 2 3 3 6 
-180 5 6 3 
-180 3 6 2 
-180 5 6 3 
-180 3 4 4 6 
-180 3 5 6 
-185 3 5 3 3 2 
-185 6 2 
-190 3 3 5 2 
-190 2 3 3 2 
-195 5 3 5 
-195 3 4 1 2 
-195 5 3 2 
-195 5 3 5 
-195 1 1 3 2 
-195 4 1 1 3 1 
-195 3 2 5 
-195 2 3 1 1 
-195 3 2 5 
-195 2 3 5 
-195 2 3 2 
-200 1 1 5 
-200 1 1 2 
-200 2 4 1 
-200 4 2 4 
-200 2 1 4 
-200 5 4 4 
-200 4 5 4 
-200 4 2 1 
-200 5 2 
-200 5 5 
-200 5 2 
-200 2 2 
-200 1 5 1 
-200 4 1 5 
-200 1 2 1 
-200 5 2 
-200 5 2 
-200 1 1 1 1 
-200 5 2 
-200 2 5 
-200 4 4 2 
-200 2 5 
-200 5 1 4 
-200 5 2 
-205 4 3 6 
-210 1 6 
-210 6 1 
-210 1 6 
-210 3 5 3 3 4 
-210 6 4 
-210 6 4 
-210 6 1 
-210 1 6 
-215 2 1 3 3 
-215 4 1 3 3 4 
-215 1 2 3 3 
-215 2 3 1 3 
-215 3 3 4 5 
-215 3 4 2 3 
-215 5 4 3 3 
-215 5 3 3 1 
-215 3 4 5 3 
-215 2 4 3 3 
-215 3 1 1 3 1 
-215 4 3 1 3 1 
-225 3 6 3 
-230 3 3 3 5 3 
