390 5 6 5 5 5 5 5 2 3 1 3 4 2 1 1 6 5 2 
295 5 6 5 5 5 5 5 2 6 2 6 
290 5 6 5 5 5 5 5 2 5 2 5 1 
285 5 6 5 5 5 5 5 2 6 3 2 5 
280 5 6 5 5 5 5 5 2 4 1 2 6 
280 5 6 5 5 5 5 5 2 6 4 2 1 
130 5 6 5 5 5 5 5 6 6 
120 5 6 5 5 5 5 5 2 6 5 1 6 5 1 6 6 2 6 5 
120 5 6 5 5 5 5 5 2 6 5 1 6 5 1 6 6 2 6 
120 5 6 5 5 5 5 5 2 6 5 1 6 5 1 6 6 2 
120 5 6 5 5 5 5 5 2 6 5 1 6 5 1 6 6 2 6 
120 5 6 5 5 5 5 5 2 6 5 1 6 5 1 6 6 2 6 
120 5 6 5 5 5 5 5 2 6 5 1 6 5 1 6 6 2 6 5 
120 5 6 5 5 5 5 5 2 6 5 1 6 5 1 6 6 2 6 5 6 
120 5 6 5 5 5 5 5 2 6 5 1 6 5 1 6 6 2 6 
120 5 6 5 5 5 5 5 2 6 5 1 6 5 1 6 6 2 6 
120 5 6 5 5 5 5 5 2 6 5 1 6 5 1 6 6 2 6 5 6 
120 5 6 5 5 5 5 5 2 6 5 1 6 5 1 6 6 2 6 5 6 
120 5 6 5 5 5 5 5 2 6 5 1 6 5 1 6 6 2 6 5 6 
120 5 6 5 5 5 5 5 2 6 5 1 6 5 1 6 6 2 6 5 6 
120 5 6 5 5 5 5 5 2 6 5 1 6 5 1 6 6 2 6 
100 5 6 5 5 5 5 5 2 6 5 1 6 5 1 6 6 2 6 5 
100 5 6 5 5 5 5 5 2 6 5 1 6 5 1 6 6 2 6 5 6 
100 5 6 5 5 5 5 5 2 6 5 1 6 5 1 6 6 2 6 
100 5 6 5 5 5 5 5 2 6 5 1 6 5 1 6 6 2 6 
100 5 6 5 5 5 5 5 2 6 5 1 6 5 1 6 6 2 6 5 
100 5 6 5 5 5 5 5 2 6 5 1 6 5 1 6 6 2 6 5 
100 5 6 5 5 5 5 5 2 6 5 1 6 5 1 6 6 2 6 
100 5 6 5 5 5 5 5 2 6 5 1 6 5 1 6 6 2 6 
100 5 6 5 5 5 5 5 2 6 2 5 2 4 3 6 6 6 6 5 1 1 1 2 6 6 5 2 2 5 6 1 3 5 1 
100 5 6 5 5 5 5 5 2 6 2 5 2 4 3 6 6 6 6 5 1 1 1 2 6 6 5 2 2 
100 5 6 5 5 5 5 5 2 6 2 5 2 4 3 6 6 6 6 5 1 1 1 2 6 6 5 2 2 5 6 1 3 5 1 5 1 6 
-15 5 6 5 5 5 5 5 2 6 5 1 6 5 1 6 6 2 6 5 6 
-30 5 6 5 5 5 5 5 2 6 5 1 6 5 1 6 6 2 6 5 
-30 5 6 5 5 5 5 5 2 6 5 1 6 5 1 6 6 2 6 
-30 5 6 5 5 5 5 5 2 6 5 1 6 5 1 6 6 2 6 5 6 
-30 5 6 5 5 5 5 5 2 6 5 1 6 5 1 6 6 2 6 5 
-30 5 6 5 5 5 5 5 2 6 5 1 6 5 1 6 6 2 6 
-30 5 6 5 5 5 5 5 2 6 5 1 6 5 1 6 6 2 6 5 
-30 5 6 5 5 5 5 5 2 6 5 1 6 5 1 6 6 2 6 
-30 5 6 5 5 5 5 5 2 6 5 1 6 5 1 6 6 2 6 
-30 5 6 5 5 5 5 5 2 6 5 1 6 5 1 6 6 2 
-30 5 6 5 5 5 5 5 2 6 5 1 6 5 1 6 6 2 6 
-30 5 6 5 5 5 5 5 2 6 5 1 6 5 1 6 6 
-35 5 6 5 5 2 
-135 5 6 5 5 5 5 5 2 6 5 1 6 5 1 6 6 2 6 5 1 
-175 5 6 5 5 5 5 5 2 6 6 4 1 5 2 1 5 5 4 4 1 2 
-175 5 6 5 5 5 5 5 2 6 5 1 6 5 1 6 6 2 6 
