325 4 2 5 5 5 5 5 3 4 3 2 4 2 1 2 6 
310 4 2 5 5 5 5 5 3 4 3 2 4 2 2 4 5 
300 4 2 5 5 5 5 5 3 4 3 2 1 5 2 6 
300 4 2 5 5 5 5 5 3 4 3 2 4 2 6 2 
290 4 2 5 5 5 5 5 3 4 3 2 1 5 3 2 5 
290 4 2 5 5 5 5 5 3 4 3 2 4 2 3 4 5 4 
285 4 2 5 5 5 5 5 3 4 3 2 1 5 2 2 
285 4 2 5 5 5 5 5 3 4 3 2 1 5 2 2 
285 4 2 5 5 5 5 5 3 4 3 2 1 5 2 2 
285 4 2 5 5 5 5 5 3 4 3 2 1 5 2 2 
285 4 2 5 5 5 5 5 3 4 3 2 1 5 4 1 1 1 
285 4 2 5 5 5 5 5 3 4 3 2 4 2 2 5 1 
285 4 2 5 5 5 5 5 3 4 3 2 4 2 2 5 6 
285 4 2 5 5 5 5 5 3 4 3 2 4 2 2 5 
285 4 2 5 5 5 5 5 3 4 3 2 1 5 2 2 
285 4 2 5 5 5 5 5 3 4 3 2 4 2 2 5 6 1 
285 4 2 5 5 5 5 5 3 4 3 2 4 2 2 5 
285 4 2 5 5 5 5 5 3 4 3 2 4 2 2 5 
285 4 2 5 5 5 5 5 3 4 3 2 4 2 2 5 6 3 
285 4 2 5 5 5 5 5 3 4 3 2 4 2 2 5 
285 4 2 5 5 5 5 5 3 4 3 2 4 2 2 2 
285 4 2 5 5 5 5 5 3 4 3 2 4 2 2 2 
285 4 2 5 5 5 5 5 3 4 3 2 4 2 2 1 1 
285 4 2 5 5 5 5 5 3 4 3 2 4 2 2 5 6 
280 4 2 5 5 5 5 5 3 4 3 2 4 3 6 4 5 
270 4 2 5 5 5 5 5 3 4 3 2 4 2 2 3 1 3 
270 4 2 5 5 5 5 5 3 4 3 2 4 2 1 3 4 3 1 3 
-105 4 2 5 5 5 5 5 3 4 3 2 1 5 3 3 2 
-110 4 2 5 5 5 5 5 3 4 3 2 1 5 2 5 
-110 4 2 5 5 5 5 5 3 4 3 2 1 5 2 5 
-110 4 2 5 5 5 5 5 3 4 3 2 1 5 2 2 
-125 4 2 5 5 5 5 5 3 4 3 2 4 2 2 5 6 1 6 2 
-140 4 2 5 5 5 5 5 3 4 3 2 1 5 2 1 3 
-170 4 2 5 5 5 5 5 3 4 3 2 4 2 2 5 6 1 2 
-200 4 2 5 5 5 5 5 3 4 3 2 4 2 2 5 6 1 4 4 
-210 4 2 5 5 5 5 5 3 4 3 2 1 5 2 
-210 4 2 5 5 5 5 5 3 4 3 2 1 5 2 
-210 4 2 5 5 5 5 5 3 4 3 2 1 5 2 
-210 4 2 5 5 5 5 5 3 4 3 2 1 5 2 2 
-210 4 2 5 5 5 5 5 3 4 3 2 1 5 2 
-210 4 2 5 5 5 5 5 3 4 3 2 1 5 2 2 
-210 4 2 5 5 5 5 5 3 4 3 2 1 5 2 2 
-210 4 2 5 5 5 5 5 3 4 3 2 1 5 
-210 4 2 5 5 5 5 5 3 4 3 2 1 5 2 2 
-210 4 2 5 5 5 5 5 3 4 3 2 1 5 2 
-210 4 2 5 5 5 5 5 3 4 3 2 1 5 2 2 
-210 4 2 5 5 5 5 5 3 4 3 2 4 2 2 5 6 4 6 6 
-215 4 2 5 5 5 5 5 3 4 3 2 1 5 2 2 6 
