1505 4 1 6 5 5 5 5 5 6 1 6 5 6 5 6 5 4 2 1 2 2 2 2 3 1 3 6 6 4 4 1 6 2 4 6 3 5 6 4 6 5 
1505 4 1 6 5 5 5 5 5 6 1 6 5 6 5 6 5 4 2 1 2 2 2 2 3 1 3 6 6 4 4 1 6 2 4 6 6 6 6 6 
1480 4 1 6 5 5 5 5 5 6 1 6 5 6 5 6 5 4 2 1 2 2 2 2 3 1 3 6 6 4 4 1 6 2 4 6 5 4 6 6 4 3 4 
1465 4 1 6 5 5 5 5 5 6 1 6 5 6 5 6 5 4 2 1 2 2 2 2 3 1 3 6 6 4 4 1 6 2 4 6 5 5 3 5 6 
1455 4 1 6 5 5 5 5 5 6 1 6 5 6 5 6 5 4 2 1 2 2 2 2 3 1 3 6 6 4 4 1 6 2 4 6 5 4 6 3 6 
1440 4 1 6 5 5 5 5 5 6 1 6 5 6 5 6 5 4 2 1 2 2 2 2 3 1 3 6 6 4 4 1 6 2 4 6 3 5 3 6 6 3 
1435 4 1 6 5 5 5 5 5 6 1 6 5 6 5 6 5 4 2 1 2 2 2 2 3 1 3 6 6 4 4 1 6 2 4 6 5 4 6 2 
1435 4 1 6 5 5 5 5 5 6 1 6 5 6 5 6 5 4 2 1 2 2 2 2 3 1 3 6 6 4 4 1 6 2 4 6 5 4 6 2 
1435 4 1 6 5 5 5 5 5 6 1 6 5 6 5 6 5 4 2 1 2 2 2 2 3 1 3 6 6 4 4 1 6 2 4 6 5 4 6 5 
1435 4 1 6 5 5 5 5 5 6 1 6 5 6 5 6 5 4 2 1 2 2 2 2 3 1 3 6 6 4 4 1 6 2 4 6 5 4 6 5 
1435 4 1 6 5 5 5 5 5 6 1 6 5 6 5 6 5 4 2 1 2 2 2 2 3 1 3 6 6 4 4 1 6 2 4 6 5 4 6 2 
1420 4 1 6 5 5 5 5 5 6 1 6 5 6 5 6 5 4 2 1 2 2 2 2 3 1 3 6 6 4 4 1 6 2 4 6 5 4 4 5 4 
1420 4 1 6 5 5 5 5 5 6 1 6 5 6 5 6 5 4 2 1 2 2 2 2 3 1 3 6 6 4 4 1 6 2 4 6 5 4 4 5 4 
1410 4 1 6 5 5 5 5 5 6 1 6 5 6 5 6 5 4 2 1 2 2 2 2 3 1 3 6 6 4 4 1 6 2 4 6 5 4 6 1 
1410 4 1 6 5 5 5 5 5 6 1 6 5 6 5 6 5 4 2 1 2 2 2 2 3 1 3 6 6 4 4 1 6 2 4 6 5 5 6 
1405 4 1 6 5 5 5 5 5 6 1 6 5 6 5 6 5 4 2 1 2 2 2 2 3 1 3 6 6 4 4 1 6 2 4 6 5 2 1 6 
1400 4 1 6 5 5 5 5 5 6 1 6 5 6 5 6 5 4 2 1 2 2 2 2 3 1 3 6 6 4 4 1 6 2 4 6 5 2 5 3 
1395 4 1 6 5 5 5 5 5 6 1 6 5 6 5 6 5 4 2 1 2 2 2 2 3 1 3 6 6 4 4 1 6 2 4 6 5 4 6 3 3 
1395 4 1 6 5 5 5 5 5 6 1 6 5 6 5 6 5 4 2 1 2 2 2 2 3 1 3 6 6 4 4 1 6 2 4 6 5 1 2 3 4 2 2 
1390 4 1 6 5 5 5 5 5 6 1 6 5 6 5 6 5 4 2 1 2 2 2 2 3 1 3 6 6 4 4 1 6 2 4 6 5 1 2 5 1 
1385 4 1 6 5 5 5 5 5 6 1 6 5 6 5 6 5 4 2 1 2 2 2 2 3 1 3 6 6 4 4 1 6 2 4 6 5 1 6 
1370 4 1 6 5 5 5 5 5 6 1 6 5 6 5 6 5 4 2 1 2 2 2 2 3 1 3 6 6 4 4 1 6 2 4 6 5 4 2 
1370 4 1 6 5 5 5 5 5 6 1 6 5 6 5 6 5 4 2 1 2 2 2 2 3 1 3 6 6 4 4 1 6 2 4 6 5 4 2 
1370 4 1 6 5 5 5 5 5 6 1 6 5 6 5 6 5 4 2 1 2 2 2 2 3 1 3 6 6 4 4 1 6 2 4 6 5 5 4 
1370 4 1 6 5 5 5 5 5 6 1 6 5 6 5 6 5 4 2 1 2 2 2 2 3 1 3 6 6 4 4 1 6 2 4 6 5 4 5 
1370 4 1 6 5 5 5 5 5 6 1 6 5 6 5 6 5 4 2 1 2 2 2 2 3 1 3 6 6 4 4 1 6 2 4 6 5 4 2 
1370 4 1 6 5 5 5 5 5 6 1 6 5 6 5 6 5 4 2 1 2 2 2 2 3 1 3 6 6 4 4 1 6 2 4 6 5 4 5 
1370 4 1 6 5 5 5 5 5 6 1 6 5 6 5 6 5 4 2 1 2 2 2 2 3 1 3 6 6 4 4 1 6 2 4 6 5 4 4 4 
1370 4 1 6 5 5 5 5 5 6 1 6 5 6 5 6 5 4 2 1 2 2 2 2 3 1 3 6 6 4 4 1 6 2 4 6 5 4 2 
1370 4 1 6 5 5 5 5 5 6 1 6 5 6 5 6 5 4 2 1 2 2 2 2 3 1 3 6 6 4 4 1 6 2 4 6 5 4 5 
1360 4 1 6 5 5 5 5 5 6 1 6 5 6 5 6 5 4 2 1 2 2 2 2 3 1 3 6 6 4 4 1 6 2 4 6 5 6 
1360 4 1 6 5 5 5 5 5 6 1 6 5 6 5 6 5 4 2 1 2 2 2 2 3 1 3 6 6 4 4 1 6 2 4 6 5 3 2 6 
1360 4 1 6 5 5 5 5 5 6 1 6 5 6 5 6 5 4 2 1 2 2 2 2 3 1 3 6 6 4 4 1 6 2 4 6 5 3 1 2 6 
1360 4 1 6 5 5 5 5 5 6 1 6 5 6 5 6 5 4 2 1 2 2 2 2 3 1 3 6 6 4 4 1 6 2 4 6 5 6 
1345 4 1 6 5 5 5 5 5 6 1 6 5 6 5 6 5 4 2 1 2 2 2 2 3 1 3 6 6 4 4 1 6 2 4 6 5 4 1 
1345 4 1 6 5 5 5 5 5 6 1 6 5 6 5 6 5 4 2 1 2 2 2 2 3 1 3 6 6 4 4 1 6 2 4 6 5 4 1 
1335 4 1 6 5 5 5 5 5 6 1 6 5 6 5 6 5 4 2 1 2 2 2 2 3 1 3 6 6 4 4 1 6 2 4 6 6 1 
1325 4 1 6 5 5 5 5 5 6 1 6 5 6 5 6 5 4 2 1 2 2 2 2 3 1 3 6 6 4 4 1 6 2 4 6 5 4 3 
1325 4 1 6 5 5 5 5 5 6 1 6 5 6 5 6 5 4 2 1 2 2 2 2 3 1 3 6 6 4 4 1 6 2 4 6 5 4 3 
1325 4 1 6 5 5 5 5 5 6 1 6 5 6 5 6 5 4 2 1 2 2 2 2 3 1 3 6 6 4 4 1 6 2 4 6 5 4 3 
1325 4 1 6 5 5 5 5 5 6 1 6 5 6 5 6 5 4 2 1 2 2 2 2 3 1 3 6 6 4 4 1 6 2 4 6 5 4 3 
1300 4 1 6 5 5 5 5 5 6 1 6 5 6 5 6 5 4 2 1 2 2 2 2 3 1 3 6 6 4 4 1 6 2 4 6 3 2 
1295 4 1 6 5 5 5 5 5 6 1 6 5 6 5 6 5 4 2 1 2 2 2 2 3 1 3 6 6 4 4 1 6 2 4 6 2 
1275 4 1 6 5 5 5 5 5 6 1 6 5 6 5 6 5 4 2 1 2 2 2 2 3 1 3 6 6 4 4 1 6 2 4 3 4 6 
1270 4 1 6 5 5 5 5 5 6 1 6 5 6 5 6 5 4 2 1 2 2 2 2 3 1 3 6 6 4 4 1 6 2 4 6 1 
1270 4 1 6 5 5 5 5 5 6 1 6 5 6 5 6 5 4 2 1 2 2 2 2 3 1 3 6 6 4 4 1 6 2 4 6 1 
1270 4 1 6 5 5 5 5 5 6 1 6 5 6 5 6 5 4 2 1 2 2 2 2 3 1 3 6 6 4 4 1 6 2 4 6 4 
1250 4 1 6 5 5 5 5 5 6 1 6 5 6 5 6 5 4 2 1 2 2 2 2 3 1 3 6 6 4 4 1 6 1 4 6 3 1 
1240 4 1 6 5 5 5 5 5 6 1 6 5 6 5 6 5 4 2 1 2 2 2 2 3 1 3 6 6 4 4 1 6 2 4 3 4 3 1 
1235 4 1 6 5 5 5 5 5 6 1 6 5 6 5 6 5 4 2 1 2 2 2 2 3 1 3 6 6 4 4 1 6 2 4 3 2 
1230 4 1 6 5 5 5 5 5 6 1 6 5 6 5 6 5 4 2 1 2 2 2 2 3 1 3 6 6 4 4 1 6 2 4 5 
1230 4 1 6 5 5 5 5 5 6 1 6 5 6 5 6 5 4 2 1 2 2 2 2 3 1 3 6 6 4 4 1 6 2 4 2 
1230 4 1 6 5 5 5 5 5 6 1 6 5 6 5 6 5 4 2 1 2 2 2 2 3 1 3 6 6 4 4 1 6 2 4 2 
1205 4 1 6 5 5 5 5 5 6 1 6 5 6 5 6 5 4 2 1 2 2 2 2 3 1 3 6 6 4 4 1 6 2 4 1 
1205 4 1 6 5 5 5 5 5 6 1 6 5 6 5 6 5 4 2 1 2 2 2 2 3 1 3 6 6 4 4 1 6 4 4 2 
1205 4 1 6 5 5 5 5 5 6 1 6 5 6 5 6 5 4 2 1 2 2 2 2 3 1 3 6 6 4 4 1 6 2 4 4 
1195 4 1 6 5 5 5 5 5 6 1 6 5 6 5 6 5 4 2 1 2 2 2 2 2 3 6 4 4 6 5 5 3 3 5 
1185 4 1 6 5 5 5 5 5 6 1 6 5 6 5 6 5 4 2 1 2 2 2 2 2 3 6 4 4 6 4 5 5 1 
1180 4 1 6 5 5 5 5 5 6 1 6 5 6 5 6 5 4 2 1 2 2 2 2 3 1 3 6 6 4 4 1 6 4 5 
1170 4 1 6 5 5 5 5 5 6 1 6 5 6 5 6 5 4 2 1 2 2 2 2 3 1 3 6 6 4 4 1 6 6 
1070 4 1 6 5 5 5 5 5 6 1 6 5 6 5 6 5 4 2 1 2 2 2 2 3 1 3 6 6 4 4 1 3 1 
1065 4 1 6 5 5 5 5 5 6 1 6 5 6 5 6 5 4 2 1 2 2 2 2 3 1 3 6 6 4 4 1 4 
1065 4 1 6 5 5 5 5 5 6 1 6 5 6 5 6 5 4 2 1 2 2 2 2 3 1 3 6 6 4 4 1 4 
1060 4 1 6 5 5 5 5 5 6 1 6 5 6 5 6 5 4 2 1 2 2 2 2 2 3 6 4 4 6 6 1 1 3 
