280 5 4 5 5 5 5 5 5 6 4 5 6 
275 5 4 5 5 5 5 5 4 2 5 4 5 2 2 
250 5 4 5 5 5 5 5 4 2 1 1 2 5 5 
140 5 4 5 5 5 5 5 4 4 6 
140 5 4 5 5 5 5 5 4 1 6 
140 5 4 5 5 5 5 5 4 4 6 
140 5 4 5 5 5 5 5 4 4 6 
125 5 4 5 5 5 5 5 4 4 2 
125 5 4 5 5 5 5 5 4 4 5 
125 5 4 5 5 5 5 5 4 1 2 
125 5 4 5 5 5 5 5 4 4 2 
125 5 4 5 5 5 5 5 4 3 3 6 
125 5 4 5 5 5 5 5 4 3 3 6 
125 5 4 5 5 5 5 5 4 4 5 
125 5 4 5 5 5 5 5 4 4 2 
125 5 4 5 5 5 5 5 4 4 2 
120 5 4 5 5 5 5 5 3 1 6 
120 5 4 5 5 5 5 5 4 3 6 
120 5 4 5 5 5 5 5 4 3 6 
115 5 4 5 5 5 5 5 4 6 
115 5 4 5 5 5 5 5 4 6 
115 5 4 5 5 5 5 5 4 6 
110 5 4 5 5 5 5 5 3 4 3 5 
110 5 4 5 5 5 5 5 4 3 3 5 
105 5 4 5 5 5 5 5 3 5 1 
100 5 4 5 5 5 5 5 4 4 4 
100 5 4 5 5 5 5 5 4 4 4 
100 5 4 5 5 5 5 5 4 1 1 
100 5 4 5 5 5 5 5 4 4 1 
100 5 4 5 5 5 5 5 4 5 
100 5 4 5 5 5 5 5 4 1 1 
100 5 4 5 5 5 5 5 4 4 4 
100 5 4 5 5 5 5 5 4 1 1 
100 5 4 5 5 5 5 5 4 1 4 
100 5 4 5 5 5 5 5 4 5 
100 5 4 5 5 5 5 5 4 4 4 
100 5 4 5 5 5 5 5 4 4 1 
100 5 4 5 5 5 5 5 4 5 
100 5 4 5 5 5 5 5 4 1 1 
90 5 4 5 5 5 5 5 6 
90 5 4 5 5 5 5 5 6 
80 5 4 5 5 5 6 6 1 
80 5 4 5 5 5 5 5 5 3 
80 5 4 5 5 5 5 5 2 3 
80 5 4 5 5 5 5 5 4 4 3 
75 5 4 5 5 5 5 5 1 1 
70 5 4 5 5 5 5 4 6 3 
70 5 4 5 5 3 4 5 6 1 4 
