1030 6 5 5 5 3 4 6 6 2 1 5 4 2 6 6 4 6 1 2 2 1 1 2 1 2 3 1 6 5 4 6 
1030 6 5 5 5 3 4 6 6 2 1 5 4 2 6 6 4 6 1 2 2 1 1 2 1 2 3 1 6 5 1 6 
1030 6 5 5 5 3 4 6 6 2 1 5 4 2 6 6 4 6 1 2 2 1 1 2 1 2 3 1 6 5 4 6 
1030 6 5 5 5 3 4 6 6 2 1 5 4 2 6 6 4 6 1 2 2 1 1 2 1 2 3 1 6 5 4 6 
1030 6 5 5 5 3 4 6 6 2 1 5 4 2 6 6 4 6 1 2 2 1 1 2 1 2 3 1 6 5 4 6 
1015 6 5 5 5 3 4 6 6 2 1 5 4 2 6 6 4 6 1 2 2 1 1 2 1 2 3 1 6 5 1 2 
1005 6 5 5 5 3 4 6 6 2 1 5 4 2 6 6 4 6 1 2 2 1 1 2 1 2 3 1 6 5 6 
1005 6 5 5 5 3 4 6 6 2 1 5 4 2 6 6 4 6 1 2 2 1 1 2 1 2 3 1 6 5 6 
1005 6 5 5 5 3 4 6 6 2 1 5 4 2 6 6 4 6 1 2 2 1 1 2 1 2 3 1 6 5 6 
990 6 5 5 5 3 4 6 6 2 1 5 4 2 6 6 4 6 1 2 2 1 1 2 1 2 3 1 6 5 4 1 
990 6 5 5 5 3 4 6 6 2 1 5 4 2 6 6 4 6 1 2 2 1 1 2 1 2 3 1 6 5 4 1 
990 6 5 5 5 3 4 6 6 2 1 5 4 2 6 6 4 6 1 2 2 1 1 2 1 2 3 1 6 5 4 1 
990 6 5 5 5 3 4 6 6 2 1 5 4 2 6 6 4 6 1 2 2 1 1 2 1 2 3 1 6 5 2 
990 6 5 5 5 3 4 6 6 2 1 5 4 2 6 6 4 6 1 2 2 1 1 2 1 2 3 1 6 5 4 4 1 
990 6 5 5 5 3 4 6 6 2 1 5 4 2 6 6 4 6 1 2 2 1 1 2 1 2 3 1 6 5 4 1 
990 6 5 5 5 3 4 6 6 2 1 5 4 2 6 6 4 6 1 2 2 1 1 2 1 2 3 1 6 5 4 1 
990 6 5 5 5 3 4 6 6 2 1 5 4 2 6 6 4 6 1 2 2 1 1 2 1 2 3 1 6 5 4 1 
990 6 5 5 5 3 4 6 6 2 1 5 4 2 6 6 4 6 1 2 2 1 1 2 1 2 3 1 6 5 4 1 
990 6 5 5 5 3 4 6 6 2 1 5 4 2 6 6 4 6 1 2 2 1 1 2 1 2 3 1 6 5 4 1 
990 6 5 5 5 3 4 6 6 2 1 5 4 2 6 6 4 6 1 2 2 1 1 2 1 2 3 1 6 5 4 1 
990 6 5 5 5 3 4 6 6 2 1 5 4 2 6 6 4 6 1 2 2 1 1 2 1 2 3 1 6 5 5 
990 6 5 5 5 3 4 6 6 2 1 5 4 2 6 6 4 6 1 2 2 1 1 2 1 2 3 1 6 5 4 1 
990 6 5 5 5 3 4 6 6 2 1 5 4 2 6 6 4 6 1 2 2 1 1 2 1 2 3 1 6 5 2 
970 6 5 5 5 3 4 6 6 2 1 5 4 2 6 6 4 6 1 2 2 1 1 2 1 2 3 1 6 5 4 3 
970 6 5 5 5 3 4 6 6 2 1 5 4 2 6 6 4 6 1 2 2 1 1 2 1 2 3 1 6 5 4 3 
820 6 5 5 5 3 4 6 6 2 1 5 4 2 6 6 4 6 1 2 2 1 1 1 2 1 1 1 
785 6 5 5 5 3 4 6 6 2 1 5 4 2 6 6 4 6 1 2 2 1 1 2 6 
775 6 5 5 5 3 4 6 6 2 1 5 4 2 6 6 4 6 1 2 2 1 1 2 2 3 
775 6 5 5 5 3 4 6 6 2 1 5 4 2 6 6 4 6 1 2 2 1 1 2 2 3 
760 6 5 5 5 3 4 6 6 2 1 5 4 2 6 6 4 6 1 2 2 1 1 1 6 
745 6 5 5 5 3 4 6 6 2 1 5 4 2 6 6 4 6 1 2 2 1 1 1 5 
745 6 5 5 5 3 4 6 6 2 1 5 4 2 6 6 4 6 1 2 2 1 1 2 4 
745 6 5 5 5 3 4 6 6 2 1 5 4 2 6 6 4 6 1 2 2 1 1 2 4 
735 6 5 5 5 3 4 6 6 2 1 5 4 2 6 6 4 6 1 2 2 1 1 6 
720 6 5 5 5 3 4 6 6 2 1 5 4 2 6 6 4 6 1 2 2 1 1 5 
720 6 5 5 5 3 4 6 6 2 1 5 4 2 6 6 4 6 1 2 2 1 1 1 4 
720 6 5 5 5 3 4 6 6 2 1 5 4 2 6 6 4 6 1 2 2 1 1 5 
720 6 5 5 5 3 4 6 6 2 1 5 4 2 6 6 4 6 1 2 2 1 1 5 
720 6 5 5 5 3 4 6 6 2 1 5 4 2 6 6 4 6 1 2 2 1 1 5 
710 6 5 5 5 3 4 6 6 2 1 5 4 2 6 6 4 6 1 2 2 1 6 
710 6 5 5 5 3 4 6 6 2 1 5 4 2 6 6 4 6 1 2 2 1 6 
695 6 5 5 5 3 4 6 6 2 1 5 4 2 6 6 4 6 1 2 2 1 1 4 
695 6 5 5 5 3 4 6 6 2 1 5 4 2 6 6 4 6 1 2 2 1 5 
685 6 5 5 5 3 4 6 6 2 1 5 4 2 6 6 4 6 1 2 2 6 
670 6 5 5 5 3 4 6 6 2 1 5 4 2 6 6 4 6 1 2 2 5 
670 6 5 5 5 3 4 6 6 2 1 5 4 2 6 6 4 6 1 2 2 5 
645 6 5 5 5 3 4 6 6 2 1 5 4 2 6 6 4 6 1 2 2 4 
625 6 5 5 5 3 4 6 6 2 1 5 4 2 6 6 4 6 1 2 2 3 
