1385 5 6 5 5 5 5 5 2 6 2 5 2 4 3 6 6 6 6 5 1 1 1 2 6 6 5 2 2 5 6 1 3 5 3 
1055 5 6 5 5 5 5 5 2 6 2 5 3 6 2 3 3 5 1 5 1 5 
670 5 6 5 5 5 5 5 1 6 2 3 3 1 4 5 3 1 3 3 4 3 6 3 2 2 
555 5 6 5 5 5 5 5 2 6 2 4 2 6 2 3 5 6 4 1 5 
550 5 6 5 5 5 5 5 2 6 2 5 2 4 5 3 2 5 2 1 6 1 1 
325 5 6 5 5 5 5 5 2 5 4 
325 5 6 5 5 5 5 3 2 
290 5 6 5 5 5 5 5 2 6 2 2 3 5 1 
285 5 6 5 5 5 5 5 2 6 2 6 4 1 4 2 3 
250 5 6 5 5 5 5 5 2 6 2 3 3 3 
245 5 6 5 5 5 5 5 2 6 2 5 4 4 3 3 
240 5 6 5 5 5 5 5 2 6 5 1 6 5 1 3 
240 5 6 5 5 5 5 5 2 6 2 5 1 2 5 
220 5 6 5 5 5 5 5 2 6 6 4 1 5 2 1 5 5 4 4 1 2 4 6 
185 5 6 5 5 5 5 5 2 6 3 4 5 4 1 5 5 4 
125 5 6 5 5 5 5 5 2 6 2 5 2 5 1 
125 5 6 5 5 5 5 5 2 6 2 5 5 
125 5 6 5 5 5 5 5 2 3 1 3 4 
115 5 6 5 5 5 5 5 2 6 2 6 6 
115 5 6 5 5 5 5 5 2 6 2 1 1 
100 5 6 5 5 5 5 5 2 6 2 5 2 1 4 
100 5 6 5 5 5 5 5 2 6 2 5 2 1 5 
100 5 6 5 5 5 5 5 2 6 2 4 6 
100 5 6 5 5 5 5 5 2 6 2 5 2 4 2 
80 5 6 5 5 5 5 5 2 3 2 
30 5 6 5 5 5 5 5 2 6 2 5 2 
30 5 6 5 5 5 5 5 2 6 
30 5 6 5 5 5 5 5 2 6 2 
30 5 6 5 5 5 5 5 2 6 2 5 2 
30 5 6 5 5 5 5 5 2 6 2 5 2 
30 5 6 5 5 5 5 5 2 6 2 
30 5 6 5 5 5 5 5 2 6 2 5 
30 5 6 5 5 5 5 5 2 6 2 5 2 
30 5 6 5 5 5 5 5 2 6 2 5 2 
30 5 6 5 5 5 5 5 2 6 2 2 5 
30 5 6 5 5 5 5 5 2 6 2 5 
30 5 6 5 5 5 5 5 2 6 2 
30 5 6 5 5 5 5 5 2 6 
30 5 6 5 5 5 5 5 2 6 2 2 
30 5 6 5 5 5 5 5 2 6 2 5 
30 5 6 5 5 5 5 5 2 6 2 2 
10 5 6 5 5 5 5 5 2 6 2 4 1 
-30 5 6 5 5 5 5 5 2 6 2 2 2 
-45 5 6 5 5 5 5 5 2 6 1 2 
-60 5 6 5 5 5 5 5 2 6 2 2 3 4 2 4 6 6 4 2 4 5 5 3 
-75 5 6 5 5 5 5 5 2 2 
-150 5 6 5 5 5 5 5 2 1 3 3 4 
-285 5 6 5 5 5 5 5 2 6 2 5 
