120 5 4 5 5 5 6 6 6 
105 5 4 5 5 5 6 6 2 
105 5 4 5 5 5 6 6 2 
105 5 4 5 5 5 6 6 2 
105 5 4 5 5 5 6 6 5 
100 5 4 5 5 5 5 4 5 2 
90 5 4 5 5 5 5 6 5 
90 5 4 5 5 5 5 6 5 
90 5 4 5 5 5 5 6 5 
90 5 4 5 5 5 5 6 2 
90 5 4 5 5 5 5 6 2 
80 5 4 5 5 5 6 4 6 
70 5 4 5 5 5 6 3 5 4 
65 5 4 5 5 5 5 6 1 
65 5 4 5 5 5 5 6 1 
55 5 4 5 5 5 3 5 4 2 4 
45 5 4 5 5 5 5 6 3 
45 5 4 5 5 5 6 3 1 1 6 
25 5 4 5 5 5 5 4 1 
25 5 4 5 5 5 6 3 4 3 2 
25 5 4 5 5 5 5 4 1 
15 5 4 5 5 5 6 1 
0 5 4 5 5 5 6 3 3 
0 5 4 5 5 5 5 1 
-5 5 4 5 5 3 6 2 
-20 5 4 5 5 5 3 2 
-20 5 4 5 5 5 5 3 1 2 3 
-25 5 4 5 5 5 2 
-25 5 4 5 5 5 2 
-25 5 4 5 5 5 5 3 4 
-50 5 4 5 5 5 4 
-50 5 4 5 5 5 1 
-50 5 4 5 5 5 1 
-50 5 4 5 5 5 1 
-60 5 4 5 5 6 
-65 5 4 5 5 5 3 3 
-65 5 4 5 5 5 3 3 
-75 5 4 5 5 2 
-75 5 4 5 5 2 
-95 5 4 5 5 3 1 
-100 5 4 5 5 4 
-100 5 4 5 5 1 
-140 5 4 5 5 5 6 6 4 6 4 
-150 5 4 5 1 
-200 5 4 5 5 5 3 1 3 
-205 5 4 5 5 5 3 3 3 
-210 5 4 5 5 5 2 5 6 
-580 5 4 5 5 6 
