90 5 4 5 5 5 5 6 2 
50 5 4 5 5 5 5 5 1 3 
30 5 4 5 5 5 5 5 3 6 
-25 5 4 5 5 5 5 3 2 
-110 5 4 5 5 5 5 5 5 6 6 
-110 5 4 5 5 5 5 5 5 6 6 
-165 5 4 5 5 5 5 5 5 6 4 2 
-175 5 4 5 5 5 5 5 5 4 1 
-175 5 4 5 5 5 5 5 5 6 4 2 4 
-175 5 4 5 5 5 5 5 5 6 3 2 
-175 5 4 5 5 5 5 5 5 6 4 1 
-175 5 4 5 5 5 5 5 5 6 4 5 3 5 1 
-185 5 4 5 5 5 5 5 5 6 4 
-200 5 4 5 5 5 5 5 5 6 1 3 4 
-205 5 4 5 5 5 5 5 5 6 3 6 
-205 5 4 5 5 5 5 5 5 6 3 3 
-205 5 4 5 5 5 5 5 5 6 3 3 
-205 5 4 5 5 5 5 5 5 6 3 1 4 
-205 5 4 5 5 5 5 5 5 6 3 4 
-205 5 4 5 5 5 5 5 5 6 3 6 
-205 5 4 5 5 5 5 5 5 6 3 1 4 3 
-205 5 4 5 5 5 5 5 5 6 3 1 4 5 
-205 5 4 5 5 5 5 5 5 6 3 1 4 4 
-205 5 4 5 5 5 5 5 5 6 3 1 4 3 
-205 5 4 5 5 5 5 5 5 6 3 1 5 
-205 5 4 5 5 5 5 5 5 6 3 4 
-205 5 4 5 5 5 5 5 5 6 3 1 4 2 
-205 5 4 5 5 5 5 5 5 6 3 1 3 
-205 5 4 5 5 5 5 5 5 6 3 5 
-205 5 4 5 5 5 5 5 5 6 3 3 
-205 5 4 5 5 5 5 5 5 6 3 1 5 
-205 5 4 5 5 5 5 5 5 6 3 1 6 
-205 5 4 5 5 5 5 5 5 6 4 2 
-205 5 4 5 5 5 5 5 5 6 4 5 4 
-205 5 4 5 5 5 5 5 5 6 4 3 
-205 5 4 5 5 5 5 5 5 6 4 5 3 
-205 5 4 5 5 5 5 5 5 6 3 4 4 2 
-205 5 4 5 5 5 5 5 5 2 
-205 5 4 5 5 5 5 5 5 6 3 6 
-205 5 4 5 5 5 5 5 5 6 3 1 4 
-205 5 4 5 5 5 5 5 5 6 3 1 3 
-205 5 4 5 5 5 5 5 5 6 3 4 
-205 5 4 5 5 5 5 5 5 6 3 1 4 
-205 5 4 5 5 5 5 5 5 6 3 1 1 
-205 5 4 5 5 5 5 5 5 6 3 1 4 6 
-220 5 4 5 5 5 5 5 5 6 3 3 2 
-230 5 4 5 5 5 5 5 5 4 5 
-230 5 4 5 5 5 5 5 5 6 4 1 5 
