115 5 4 5 5 5 6 4 2 5 
105 5 4 5 5 5 6 6 2 
100 5 4 5 5 5 5 5 4 2 
100 5 4 5 5 5 5 5 2 4 
90 5 4 5 5 5 5 6 5 
90 5 4 5 5 5 6 5 2 
80 5 4 5 5 5 6 6 1 
80 5 4 5 5 5 6 6 1 
75 5 4 5 5 5 5 4 2 1 
70 5 4 5 5 5 6 4 2 3 
70 5 4 5 5 5 6 4 3 5 4 
65 5 4 5 5 5 6 2 4 
55 5 4 5 5 5 5 4 3 5 5 
50 5 4 5 5 5 5 4 4 1 3 
45 5 4 5 5 5 6 3 1 4 2 
45 5 4 5 5 5 6 3 4 4 6 
25 5 4 5 5 5 6 3 1 3 2 
0 5 4 5 5 5 5 1 
-25 5 4 5 5 5 2 
-45 5 4 5 5 5 3 1 
-50 5 4 5 5 5 4 4 5 5 2 
-50 5 4 5 5 5 4 4 5 5 2 
-50 5 4 5 5 5 4 4 5 5 6 
-50 5 4 5 5 5 4 4 5 5 1 
-50 5 4 5 5 5 4 4 5 5 1 
-50 5 4 5 5 5 4 4 5 5 4 
-50 5 4 5 5 5 4 4 5 5 5 
-50 5 4 5 5 5 4 4 5 5 6 
-50 5 4 5 5 5 4 4 5 5 4 
-50 5 4 5 5 5 1 
-50 5 4 5 5 5 4 4 5 5 6 
-55 5 4 5 5 5 4 4 1 
-55 5 4 5 5 5 4 4 6 
-55 5 4 5 5 5 4 4 5 
-55 5 4 5 5 5 4 4 6 
-55 5 4 5 5 5 4 4 5 5 
-55 5 4 5 5 5 4 4 6 
-55 5 4 5 5 5 4 4 6 
-55 5 4 5 5 5 4 4 5 1 
-55 5 4 5 5 5 4 4 6 
-55 5 4 5 5 5 4 4 5 1 
-55 5 4 5 5 5 4 4 5 4 
-55 5 4 5 5 5 4 4 2 
-55 5 4 5 5 5 4 4 3 
-55 5 4 5 5 5 4 4 4 
-55 5 4 5 5 5 4 4 5 3 
-55 5 4 5 5 5 4 5 2 
-65 5 4 5 5 5 3 3 
