300 5 6 5 5 5 5 4 3 2 1 6 6 2 
260 5 6 5 5 5 5 4 4 6 2 5 3 4 
220 5 6 5 5 5 5 1 1 5 3 4 4 2 2 
130 5 6 5 5 5 5 2 6 
130 5 6 5 5 5 5 2 6 
120 5 6 5 5 5 5 3 5 5 
115 5 6 5 5 5 5 2 2 
115 5 6 5 5 5 5 5 2 
115 5 6 5 5 5 5 2 5 
105 5 6 5 5 5 6 1 5 
105 5 6 5 5 5 5 1 6 
95 5 6 5 5 5 5 1 3 5 
95 5 6 5 5 5 3 2 4 5 
95 5 6 5 5 5 6 6 
95 5 6 5 5 5 5 3 5 1 
90 5 6 5 5 5 5 1 5 
90 5 6 5 5 5 5 1 2 
90 5 6 5 5 5 5 2 1 
90 5 6 5 5 5 5 5 4 
90 5 6 5 5 5 5 4 2 
90 5 6 5 5 5 5 1 2 
90 5 6 5 5 5 5 1 2 
90 5 6 5 5 5 5 5 4 
90 5 6 5 5 5 5 5 1 
90 5 6 5 5 5 5 2 4 
85 5 6 5 5 5 5 3 6 
85 5 6 5 5 3 5 1 6 1 
85 5 6 5 5 3 6 2 5 
85 5 6 5 5 5 5 3 6 
80 5 6 5 5 5 5 6 
80 5 6 5 5 5 5 6 
80 5 6 5 5 5 6 2 
80 5 6 5 5 5 5 6 
80 5 6 5 5 5 6 5 
80 5 6 5 5 5 6 5 
80 5 6 5 5 5 5 6 
75 5 6 5 5 5 3 5 3 5 
70 5 6 5 5 3 5 2 2 
70 5 6 5 5 5 4 3 4 4 1 
60 5 6 5 5 3 6 1 5 
55 5 6 5 5 6 5 4 
40 5 6 5 5 5 3 6 3 
35 5 6 5 5 6 5 3 
15 5 6 5 5 5 2 
15 5 6 5 5 5 2 
15 5 6 5 5 5 2 
5 5 6 5 5 6 1 
-10 5 6 5 5 5 1 
-10 5 6 5 5 5 1 
-10 5 6 5 5 5 1 
-10 5 6 5 5 5 1 
-30 5 6 5 5 3 2 
-30 5 6 5 5 5 3 
-35 5 6 5 5 2 
-35 5 6 5 5 2 
-35 5 6 5 5 2 
-35 5 6 5 5 2 
-35 5 6 5 5 2 
-35 5 6 5 5 2 
-55 5 6 5 5 3 1 
-60 5 6 5 5 1 
-60 5 6 5 5 4 5 
-60 5 6 5 5 1 
-60 5 6 5 5 4 
-60 5 6 5 5 4 
-60 5 6 5 5 4 
-60 5 6 5 5 1 
-70 5 6 5 6 
-85 5 6 5 2 
-90 3 4 3 4 5 5 2 
-110 5 6 5 1 
-110 5 6 5 1 
-110 6 5 5 1 
-110 5 6 5 1 
-110 5 6 5 4 
-120 5 6 6 
-120 5 6 6 
-120 5 6 6 
-120 5 6 6 
-120 5 6 6 
-120 4 4 6 6 
-120 4 1 6 6 
-135 3 4 3 6 6 
-135 5 6 2 
-150 4 1 1 5 1 
-160 4 1 1 6 
-160 5 6 4 
-160 5 6 1 
-160 5 6 1 
-160 5 6 1 
-160 5 6 1 
-160 5 6 1 
-160 4 4 6 4 
-160 5 6 1 
-165 3 5 3 5 1 
-170 5 4 3 5 
-170 5 3 1 2 
-170 4 3 2 2 
-170 5 1 5 3 
-170 3 3 4 3 6 1 
-175 4 2 2 
-180 5 6 3 
-180 5 6 3 
-180 5 6 3 
-180 5 6 3 
-180 5 6 3 
-180 6 3 2 
-180 3 4 1 6 
-185 3 3 1 1 5 3 
-185 3 3 4 4 5 3 
-195 5 3 2 
-195 1 1 3 2 
-195 5 3 1 4 
-200 4 4 2 
-200 5 2 
-200 5 1 4 
-200 5 1 4 
-200 1 2 4 
-200 5 4 4 
-200 5 1 4 
-200 5 2 
-200 5 5 
-200 5 5 
-200 2 1 1 
-210 6 4 
-210 6 1 
-215 5 3 1 3 
-230 5 3 3 3 3 
