110 6 5 5 3 4 4 5 2 4 6 
110 6 5 5 3 4 4 5 2 1 6 
110 6 5 5 3 4 4 5 3 3 6 6 
110 6 5 5 3 4 4 5 2 1 6 
110 6 5 5 3 4 4 5 2 4 6 
100 6 5 5 3 4 4 5 6 6 
95 6 5 5 3 4 4 5 2 1 5 
95 6 5 5 3 4 4 5 2 4 2 
95 6 5 5 3 4 4 5 2 4 5 
95 6 5 5 3 4 4 5 2 4 2 
95 6 5 5 3 4 4 5 2 4 5 
95 6 5 5 3 4 4 5 2 1 5 
95 6 5 5 3 4 4 5 2 1 2 
95 6 5 5 3 4 4 5 2 4 2 
85 6 5 5 3 4 4 5 1 6 4 
85 6 5 5 3 4 4 5 2 6 
75 6 5 5 3 4 4 5 2 3 5 
70 6 5 5 3 4 4 5 2 4 1 
70 6 5 5 3 4 4 5 2 4 1 
70 6 5 5 3 4 4 5 2 2 
70 6 5 5 3 4 4 5 2 2 
70 6 5 5 3 4 4 5 2 2 
70 6 5 5 3 4 4 5 2 4 1 
70 6 5 5 3 4 4 5 2 4 4 
70 6 5 5 3 4 4 5 2 4 1 
60 6 5 5 3 4 4 5 6 4 
55 6 5 5 3 4 4 5 3 3 1 2 
50 6 5 5 3 4 4 5 2 3 1 
50 6 5 5 3 4 4 5 2 4 3 
50 6 5 5 3 4 4 5 1 4 3 4 2 
50 6 5 5 3 4 4 5 2 4 3 
50 6 5 5 3 4 4 5 4 5 3 
50 6 5 5 3 4 4 5 2 4 3 
-70 6 5 5 6 
-110 5 1 5 6 
-110 1 1 1 5 6 
-110 5 1 5 6 
-120 6 5 6 
-120 6 5 6 
-125 3 5 3 5 6 
-135 1 4 6 2 
-155 1 5 3 6 
-155 5 3 4 6 
-160 4 5 6 
-160 1 5 6 
-160 6 5 1 
-170 6 6 
-170 1 2 3 5 
-175 2 1 2 
-175 2 4 2 
-180 6 5 3 
-180 3 2 6 
-185 6 2 
-185 6 2 
-195 1 3 5 4 
-195 4 3 2 4 
-195 2 3 2 
-200 1 1 4 1 
-200 2 1 4 
-200 4 4 5 
-205 3 6 4 
-210 6 4 
-210 1 6 
-210 2 3 3 3 4 
