330 5 4 5 5 5 6 4 5 2 2 1 4 1 1 6 
315 5 4 5 5 5 6 4 5 2 2 5 1 1 1 1 
315 5 4 5 5 5 6 4 5 2 2 1 4 2 5 
315 5 4 5 5 5 6 4 5 2 2 1 4 1 1 5 
315 5 4 5 5 5 6 4 5 2 2 1 4 1 4 2 
315 5 4 5 5 5 6 4 5 2 2 1 4 1 4 5 
310 5 4 5 5 5 6 4 5 2 2 1 4 3 4 6 
310 5 4 5 5 5 6 4 5 2 2 1 4 3 1 6 
305 5 4 5 5 5 6 4 5 2 2 1 6 2 
290 5 4 5 5 5 6 4 5 2 2 1 4 1 4 4 
290 5 4 5 5 5 6 4 5 2 2 1 4 1 5 
290 5 4 5 5 5 6 4 5 2 2 1 4 1 5 
290 5 4 5 5 5 6 4 5 2 2 1 4 4 5 
290 5 4 5 5 5 6 4 5 2 2 1 4 3 3 6 
290 5 4 5 5 5 6 4 5 2 2 1 4 4 5 
290 5 4 5 5 5 6 4 5 2 2 1 2 5 
285 5 4 5 5 5 6 4 5 2 2 1 4 3 6 
275 5 4 5 5 5 6 4 5 2 2 1 3 4 3 2 
270 5 4 5 5 5 6 4 5 2 2 1 4 1 4 3 
270 5 4 5 5 5 6 4 5 2 2 1 4 2 3 
270 5 4 5 5 5 6 4 5 2 2 1 4 1 4 3 
255 5 4 5 5 5 6 4 5 2 2 1 3 5 3 3 6 
255 5 4 5 5 5 6 4 5 2 2 1 3 5 3 3 6 1 4 
255 5 4 5 5 5 6 4 5 2 2 1 3 5 3 3 6 1 4 
255 5 4 5 5 5 6 4 5 2 2 1 3 5 3 3 6 1 
255 5 4 5 5 5 6 4 5 2 2 1 3 5 3 3 6 1 
255 5 4 5 5 5 6 4 5 2 2 1 3 5 3 3 6 1 
255 5 4 5 5 5 6 4 5 2 2 1 3 5 3 3 6 
255 5 4 5 5 5 6 4 5 2 2 1 3 5 3 3 6 
255 5 4 5 5 5 6 4 5 2 2 1 3 5 3 3 6 
255 5 4 5 5 5 6 4 5 2 2 1 3 5 3 3 6 
255 5 4 5 5 5 6 4 5 2 2 1 3 5 3 3 6 1 
255 5 4 5 5 5 6 4 5 2 2 1 3 5 3 3 6 1 
255 5 4 5 5 5 6 4 5 2 2 1 3 5 3 3 6 1 
255 5 4 5 5 5 6 4 5 2 2 1 3 5 3 3 6 1 
255 5 4 5 5 5 6 4 5 2 2 1 3 5 3 3 6 1 4 
255 5 4 5 5 5 6 4 5 2 2 1 3 5 3 3 6 
255 5 4 5 5 5 6 4 5 2 2 1 3 5 3 3 6 
255 5 4 5 5 5 6 4 5 2 2 1 3 5 3 3 6 1 4 
255 5 4 5 5 5 6 4 5 2 2 1 3 5 3 3 6 1 
255 5 4 5 5 5 6 4 5 2 2 1 3 5 3 3 6 1 4 
255 5 4 5 5 5 6 4 5 2 2 1 3 5 3 3 6 1 
255 5 4 5 5 5 6 4 5 2 2 1 3 5 3 3 6 1 4 
255 5 4 5 5 5 6 4 5 2 2 1 3 5 3 3 6 1 4 
255 5 4 5 5 5 6 4 5 2 2 1 3 5 3 3 6 1 
255 5 4 5 5 5 6 4 5 2 2 1 3 6 1 
255 5 4 5 5 5 6 4 5 2 2 1 3 5 3 3 6 1 4 
250 5 4 5 5 5 6 4 5 2 2 1 4 3 4 3 2 
