275 2 4 5 5 5 6 4 4 6 6 5 5 3 4 
130 2 4 5 5 5 6 4 4 4 6 
125 2 4 5 5 5 6 4 4 4 6 1 5 2 
125 2 4 5 5 5 6 4 4 4 6 1 5 3 
125 2 4 5 5 5 6 4 4 4 6 1 
125 2 4 5 5 5 6 4 4 4 6 1 4 
125 2 4 5 5 5 6 4 4 4 6 5 
125 2 4 5 5 5 6 4 4 4 6 3 
125 2 4 5 5 5 6 4 4 4 6 1 4 
125 2 4 5 5 5 6 4 4 4 6 1 6 
125 2 4 5 5 5 6 4 4 4 6 1 1 
125 2 4 5 5 5 6 4 4 4 6 1 6 
125 2 4 5 5 5 6 4 4 4 6 2 
125 2 4 5 5 5 6 4 4 4 6 1 5 5 
125 2 4 5 5 5 6 4 4 4 6 1 5 2 
125 2 4 5 5 5 6 4 4 4 6 5 
125 2 4 5 5 5 6 4 4 4 6 4 
125 2 4 5 5 5 6 4 4 4 6 1 1 
125 2 4 5 5 5 6 4 4 4 6 1 5 
125 2 4 5 5 5 6 4 4 4 6 6 
125 2 4 5 5 5 6 4 4 4 6 1 5 6 
125 2 4 5 5 5 6 4 4 4 6 3 
125 2 4 5 5 5 6 4 4 4 6 1 5 2 
125 2 4 5 5 5 6 4 4 4 6 2 
125 2 4 5 5 5 6 4 4 4 6 1 3 
125 2 4 5 5 5 6 4 4 4 6 1 5 
125 2 4 5 5 5 6 4 4 4 6 1 
125 2 4 5 5 5 6 4 4 4 6 6 
125 2 4 5 5 5 6 4 4 4 6 1 5 3 
125 2 4 5 5 5 6 4 4 4 6 5 
125 2 4 5 5 5 6 4 4 4 6 1 6 
125 2 4 5 5 5 6 4 4 4 6 1 6 
125 2 4 5 5 5 6 4 4 4 6 1 5 1 
125 2 4 5 5 5 6 4 4 4 6 1 5 1 
125 2 4 5 5 5 6 4 4 4 6 1 5 
125 2 4 5 5 5 6 4 4 4 6 1 5 4 
125 2 4 5 5 5 6 4 4 4 6 1 
125 2 4 5 5 5 6 4 4 4 6 1 1 
125 2 4 5 5 5 6 4 4 4 6 1 1 
125 2 4 5 5 5 6 4 4 4 6 2 
125 2 4 5 5 5 6 4 4 4 6 1 
125 2 4 5 5 5 6 4 4 4 6 1 2 
125 2 4 5 5 5 6 4 4 4 6 1 5 
125 2 4 5 5 5 6 4 4 4 6 1 
125 2 4 5 5 5 6 4 4 4 6 1 5 2 
125 2 4 5 5 5 6 4 4 4 6 1 6 
125 2 4 5 5 5 6 4 4 4 6 4 
125 2 4 5 5 5 6 4 4 4 6 3 
125 2 4 5 5 5 6 4 4 4 6 1 3 
125 2 4 5 5 5 6 4 4 4 6 1 5 5 
125 2 4 5 5 5 6 4 4 4 6 1 5 1 
125 2 4 5 5 5 6 4 4 4 6 1 3 
125 2 4 5 5 5 6 4 4 4 6 1 5 
125 2 4 5 5 5 6 4 4 4 6 1 2 
125 2 4 5 5 5 6 4 4 4 6 4 
125 2 4 5 5 5 6 4 4 4 6 5 
125 2 4 5 5 5 6 4 4 4 6 1 4 
125 2 4 5 5 5 6 4 4 4 6 1 6 
125 2 4 5 5 5 6 4 4 4 6 1 5 6 
125 2 4 5 5 5 6 4 4 4 6 1 5 2 
125 2 4 5 5 5 6 4 4 4 6 1 4 
125 2 4 5 5 5 6 4 4 4 6 1 5 5 
125 2 4 5 5 5 6 4 4 4 6 1 5 2 
125 2 4 5 5 5 6 4 4 4 6 2 
125 2 4 5 5 5 6 4 4 4 6 1 5 3 
125 2 4 5 5 5 6 4 4 4 6 1 5 1 
125 2 4 5 5 5 6 4 4 4 6 4 
125 2 4 5 5 5 6 4 4 4 6 1 5 
125 2 4 5 5 5 6 4 4 4 6 1 3 
125 2 4 5 5 5 6 4 4 4 6 1 5 2 
125 2 4 5 5 5 6 4 4 4 6 3 
125 2 4 5 5 5 6 4 4 4 6 2 
125 2 4 5 5 5 6 4 4 4 6 6 
125 2 4 5 5 5 6 4 4 4 6 1 
125 2 4 5 5 5 6 4 4 4 6 1 
125 2 4 5 5 5 6 4 4 4 6 5 
125 2 4 5 5 5 6 4 4 4 6 1 5 
125 2 4 5 5 5 6 4 4 4 6 1 6 
125 2 4 5 5 5 6 4 4 4 6 1 5 5 
125 2 4 5 5 5 6 4 4 4 6 1 5 4 
125 2 4 5 5 5 6 4 4 4 6 1 2 
125 2 4 5 5 5 6 4 4 4 6 1 5 5 
125 2 4 5 5 5 6 4 4 4 6 1 5 6 
125 2 4 5 5 5 6 4 4 4 6 1 5 6 
125 2 4 5 5 5 6 4 4 4 6 6 
125 2 4 5 5 5 6 4 4 4 6 1 5 
125 2 4 5 5 5 6 4 4 4 6 1 
125 2 4 5 5 5 6 4 4 4 6 1 3 
125 2 4 5 5 5 6 4 4 4 6 1 5 6 
125 2 4 5 5 5 6 4 4 4 6 1 5 
125 2 4 5 5 5 6 4 4 4 6 1 6 
125 2 4 5 5 5 6 4 4 4 6 1 5 2 
125 2 4 5 5 5 6 4 4 4 6 1 5 2 
125 2 4 5 5 5 6 4 4 4 6 6 
125 2 4 5 5 5 6 4 4 4 6 6 
125 2 4 5 5 5 6 4 4 4 6 1 5 3 
125 2 4 5 5 5 6 4 4 4 6 1 5 5 
125 2 4 5 5 5 6 4 4 4 6 4 
125 2 4 5 5 5 6 4 4 4 6 1 5 5 
125 2 4 5 5 5 6 4 4 4 6 1 2 
125 2 4 5 5 5 6 4 4 4 6 1 6 
125 2 4 5 5 5 6 4 4 4 6 1 5 
125 2 4 5 5 5 6 4 4 4 6 5 
125 2 4 5 5 5 6 4 4 4 6 5 
125 2 4 5 5 5 6 4 4 4 6 2 
125 2 4 5 5 5 6 4 4 4 6 3 
125 2 4 5 5 5 6 4 4 4 6 1 5 2 
125 2 4 5 5 5 6 4 4 4 6 3 
125 2 4 5 5 5 6 4 4 4 6 2 
125 2 4 5 5 5 6 4 4 4 6 1 5 5 
125 2 4 5 5 5 6 4 4 4 6 1 4 
125 2 4 5 5 5 6 4 4 4 6 2 
125 2 4 5 5 5 6 4 4 4 6 1 5 6 
125 2 4 5 5 5 6 4 4 4 6 2 
125 2 4 5 5 5 6 4 4 4 6 1 5 
125 2 4 5 5 5 6 4 4 4 6 6 
125 2 4 5 5 5 6 4 4 4 6 1 1 
125 2 4 5 5 5 6 4 4 4 6 1 5 4 
125 2 4 5 5 5 6 4 4 4 6 1 1 
125 2 4 5 5 5 6 4 4 4 6 2 
125 2 4 5 5 5 6 4 4 4 6 1 5 3 
125 2 4 5 5 5 6 4 4 4 6 1 1 
125 2 4 5 5 5 6 4 4 4 6 6 
125 2 4 5 5 5 6 4 4 4 6 1 6 
125 2 4 5 5 5 6 4 4 4 6 1 5 
125 2 4 5 5 5 6 4 4 4 6 1 5 4 
125 2 4 5 5 5 6 4 4 4 6 1 5 4 
125 2 4 5 5 5 6 4 4 4 6 6 
125 2 4 5 5 5 6 4 4 4 6 4 
125 2 4 5 5 5 6 4 4 4 6 1 5 5 
125 2 4 5 5 5 6 4 4 4 6 2 
125 2 4 5 5 5 6 4 4 4 6 1 2 
125 2 4 5 5 5 6 4 4 4 6 4 
125 2 4 5 5 5 6 4 4 4 6 1 5 
125 2 4 5 5 5 6 4 4 4 6 1 4 
125 2 4 5 5 5 6 4 4 4 6 5 
125 2 4 5 5 5 6 4 4 4 6 1 5 
125 2 4 5 5 5 6 4 4 4 6 1 5 1 
125 2 4 5 5 5 6 4 4 4 6 2 
125 2 4 5 5 5 6 4 4 4 6 1 5 3 
125 2 4 5 5 5 6 4 4 4 6 2 
125 2 4 5 5 5 6 4 4 4 6 1 5 6 
125 2 4 5 5 5 6 4 4 4 6 4 
125 2 4 5 5 5 6 4 4 4 6 1 5 
125 2 4 5 5 5 6 4 4 4 6 1 
125 2 4 5 5 5 6 4 4 4 6 1 5 1 
125 2 4 5 5 5 6 4 4 4 6 1 5 2 
125 2 4 5 5 5 6 4 4 4 6 1 5 2 
125 2 4 5 5 5 6 4 4 4 6 1 
125 2 4 5 5 5 6 4 4 4 6 1 1 
125 2 4 5 5 5 6 4 4 4 6 1 5 2 
125 2 4 5 5 5 6 4 4 4 6 1 4 
125 2 4 5 5 5 6 4 4 4 6 4 
115 2 4 5 5 5 6 4 4 1 5 
115 2 4 5 5 5 6 4 4 1 2 
115 2 4 5 5 5 6 4 2 2 
115 2 4 5 5 5 4 6 2 5 
110 2 4 5 5 5 6 2 3 6 
110 2 4 5 5 5 6 2 3 6 
105 2 4 5 5 5 6 2 6 
105 2 4 5 5 5 6 2 6 
105 2 4 5 5 5 6 2 6 
105 2 4 5 5 5 6 6 5 
105 2 4 5 5 5 6 2 6 
105 2 4 5 5 5 3 5 5 2 4 
105 2 4 5 5 5 6 6 2 
105 2 4 5 5 5 6 2 6 
100 2 4 5 5 5 4 5 4 5 4 
95 2 4 5 5 5 6 2 3 2 
95 2 4 5 5 5 6 4 4 3 2 
95 2 4 5 5 5 6 4 3 2 4 
95 2 4 5 5 5 3 5 5 6 
95 2 4 5 5 5 6 2 3 5 
95 2 4 5 5 5 6 2 3 2 
95 1 2 5 5 3 5 6 5 2 
90 2 4 5 5 5 6 5 2 
90 2 4 5 5 5 6 4 1 2 
90 2 4 5 5 5 6 2 2 
90 2 4 5 5 5 6 4 2 4 
90 2 4 5 5 5 6 2 2 
90 2 4 5 5 5 6 4 2 1 
90 2 4 5 5 5 6 2 2 
90 2 4 5 5 5 6 5 5 
90 2 4 5 5 5 6 4 2 4 
90 2 4 5 5 5 6 2 5 
90 2 4 5 5 5 6 2 2 
90 2 4 5 5 5 6 2 5 
90 2 4 5 5 5 6 2 2 
90 2 4 5 5 5 5 6 2 
90 2 4 5 5 5 6 2 5 
90 2 4 5 5 5 6 2 5 
80 2 4 5 5 5 6 4 6 
80 2 4 5 5 5 6 6 1 
80 2 4 5 5 5 3 5 2 2 
80 2 4 5 5 5 5 5 2 3 
80 3 3 2 5 5 5 3 4 3 6 3 6 
80 2 4 5 5 5 6 6 4 
80 2 4 5 5 5 6 4 6 
80 2 4 5 5 5 5 5 2 3 
80 2 4 5 5 5 6 4 6 
80 2 4 5 5 5 6 4 6 
80 2 4 5 5 5 6 6 4 
80 2 4 5 5 5 6 4 6 
75 2 4 5 5 5 4 5 5 4 
70 2 4 5 5 5 6 2 3 4 
65 2 4 5 5 5 6 2 4 
65 2 4 5 5 5 6 2 4 
65 2 4 5 5 5 6 2 1 
65 2 4 5 5 5 6 2 4 
65 2 4 5 5 5 6 5 4 
65 2 4 5 5 5 6 5 1 
65 2 4 5 5 5 6 2 1 
65 2 4 5 5 5 6 5 1 
65 2 4 5 5 5 6 2 1 
65 2 4 5 5 5 6 2 1 
65 2 4 5 5 5 6 2 4 
65 2 4 5 5 5 6 2 4 
65 2 4 5 5 5 6 2 1 
65 2 4 5 5 5 6 2 4 
60 2 4 5 5 5 6 6 3 
60 2 4 5 5 5 6 6 3 
50 2 4 5 5 5 3 5 3 3 1 4 3 3 
50 2 4 5 5 5 3 4 6 1 3 
50 2 4 5 5 5 6 4 3 1 3 
50 2 4 5 5 5 6 2 3 3 
45 2 4 5 5 5 4 1 6 3 
25 2 4 5 5 5 4 4 2 
25 2 4 5 5 5 4 1 4 1 
25 2 4 5 5 5 5 2 
15 2 4 5 5 5 6 1 
15 2 4 5 5 5 6 1 
15 2 4 5 5 5 6 1 
15 2 4 5 5 5 6 1 
15 2 4 5 5 5 6 1 
5 2 4 5 5 5 3 5 4 
5 2 4 5 5 5 3 5 1 
0 2 4 5 5 5 5 1 
0 2 4 5 5 5 5 1 
0 2 4 5 5 5 3 5 4 5 5 
-5 2 4 5 5 5 6 3 
-5 2 4 5 5 5 6 3 
-5 2 4 5 5 5 6 3 
-5 2 4 5 5 5 3 6 
-5 2 4 5 5 5 3 6 
-5 2 4 5 5 5 3 6 
-5 2 4 5 5 5 6 3 
-5 2 4 5 5 5 6 3 
-5 2 4 5 5 5 6 3 
-5 2 4 5 5 5 6 3 
-10 2 4 5 5 5 6 3 5 
-10 2 4 5 5 5 3 6 2 3 
-10 2 4 5 5 5 6 3 6 
-10 2 4 5 5 5 6 3 2 
-10 2 4 5 5 5 6 3 1 2 
-10 2 4 5 5 5 3 6 3 6 
-10 2 4 5 5 5 6 3 6 
-10 2 4 5 5 5 6 3 3 2 
-10 2 4 5 5 5 6 3 1 
-10 2 4 5 5 5 6 3 3 
-20 2 4 5 5 5 5 3 
-20 2 4 5 5 5 5 3 
-20 2 4 5 5 5 3 2 
-25 2 4 5 5 5 2 
-25 2 4 5 5 5 2 
-25 2 4 5 5 5 2 
-25 2 4 5 5 5 2 
-45 2 4 5 5 5 3 1 
-45 2 4 5 5 5 3 1 
-50 2 4 5 5 5 1 
-50 2 4 5 5 5 1 
-50 2 4 5 5 5 1 
-50 2 4 5 5 5 1 
-50 2 4 5 5 5 1 
-50 2 4 5 5 5 1 
-60 2 4 5 5 6 
-60 2 4 5 5 6 
-60 2 4 5 5 6 
-60 2 4 5 5 6 
-60 2 4 5 5 6 
-65 2 4 5 5 5 3 3 
-65 2 4 5 5 5 3 3 
-65 2 4 5 5 5 3 3 
-70 2 4 5 5 3 2 
-75 2 4 5 5 2 
-75 2 4 5 5 2 
-75 2 4 5 5 2 
-75 2 4 5 5 2 
-100 2 4 5 5 4 
-100 2 4 5 5 4 
-100 2 4 5 5 1 
-100 2 4 5 5 4 
-100 2 4 5 5 4 
-110 2 4 5 6 
-110 2 4 5 6 
-110 2 4 5 6 
-115 2 4 5 5 3 3 
-125 2 4 5 2 
-125 2 4 5 2 
-125 2 4 5 2 
-150 2 4 5 1 
