330 5 4 5 5 5 6 4 5 2 2 1 4 1 4 6 
330 5 4 5 5 5 6 4 5 2 2 1 4 4 1 6 
315 5 4 5 5 5 6 4 5 2 2 1 5 3 3 6 
315 5 4 5 5 5 6 4 5 2 2 1 2 4 2 
310 5 4 5 5 5 6 4 5 2 2 1 3 5 6 
305 5 4 5 5 5 6 4 5 2 2 1 4 1 6 
305 5 4 5 5 5 6 4 5 2 2 1 6 2 
300 5 4 5 5 5 6 4 5 5 6 4 1 3 6 
290 5 4 5 5 5 6 4 5 2 2 1 1 2 4 
290 5 4 5 5 5 6 4 5 2 2 1 5 1 4 
290 5 4 5 5 5 6 4 5 2 2 1 2 1 1 
290 5 4 5 5 5 6 4 5 2 2 1 5 2 
285 5 4 5 5 5 6 4 5 2 2 1 4 3 6 
285 5 4 5 5 5 6 4 5 2 2 1 4 3 6 
285 5 4 5 5 5 6 4 5 2 2 1 4 3 6 
280 5 4 5 5 5 6 4 5 2 2 1 4 6 
280 5 4 5 5 5 6 4 5 2 2 1 4 6 
270 5 4 5 5 5 6 4 5 2 2 1 4 3 5 
270 5 4 5 5 5 6 4 5 5 5 4 3 1 5 
270 5 4 5 5 5 6 4 5 2 2 1 4 3 2 
270 5 4 5 5 5 6 4 5 2 2 1 4 3 5 
270 5 4 5 5 5 6 4 5 2 2 1 4 3 4 1 
270 5 4 5 5 5 6 4 5 2 2 1 4 3 5 
270 5 4 5 5 5 6 4 5 2 2 1 4 3 2 
270 5 4 5 5 5 6 4 5 2 2 1 4 3 2 
270 5 4 5 5 5 6 4 5 2 2 1 4 1 3 4 
250 5 4 5 5 5 6 4 5 2 2 1 4 3 3 4 2 
120 5 4 5 5 5 6 4 3 2 2 
120 5 4 5 5 5 6 4 3 5 2 
120 5 4 5 5 5 6 6 6 
115 5 4 5 5 5 6 4 2 5 
110 5 4 5 5 5 5 5 4 3 3 5 
110 5 4 5 5 5 6 3 2 6 
105 5 4 5 5 5 6 6 5 
95 5 4 5 5 5 6 2 3 5 
95 5 4 5 5 5 6 3 2 2 
90 5 4 5 5 5 6 4 2 4 
90 5 4 5 5 5 6 4 2 1 
90 5 4 5 5 5 6 5 5 
90 5 4 5 5 5 6 4 2 4 
80 5 4 5 5 5 6 4 6 
80 5 4 5 5 5 6 6 1 
65 5 4 5 5 5 6 2 4 
65 5 4 5 5 5 6 2 4 
65 5 4 5 5 5 6 2 4 
0 5 4 5 5 5 5 1 
-55 5 4 5 5 5 4 4 5 5 1 
-55 5 4 5 5 5 4 4 5 5 2 
