330 5 4 5 5 5 6 4 5 2 2 1 4 1 4 6 
330 5 4 5 5 5 6 4 5 2 2 1 4 1 4 6 
330 5 4 5 5 5 6 4 5 2 2 1 4 1 4 6 
330 5 4 5 5 5 6 4 5 2 2 1 5 1 6 
330 5 4 5 5 5 6 4 5 2 2 1 2 1 6 
320 5 4 5 5 5 6 4 5 2 2 1 4 3 4 1 2 
320 5 4 5 5 5 6 4 5 2 2 1 4 3 1 1 5 
315 5 4 5 5 5 6 4 5 2 2 1 4 1 4 2 
315 5 4 5 5 5 6 4 5 2 2 1 4 1 4 2 
315 5 4 5 5 5 6 4 5 2 2 1 4 1 4 5 
315 5 4 5 5 5 6 4 5 2 2 1 4 1 4 5 
315 5 4 5 5 5 6 4 5 2 2 1 1 5 2 
315 5 4 5 5 5 6 4 5 2 2 1 4 1 4 2 
315 5 4 5 5 5 6 4 5 2 2 1 4 2 5 
315 5 4 5 5 5 6 4 5 2 2 1 5 3 3 6 
310 5 4 5 5 5 6 4 5 2 2 1 3 5 6 
310 5 4 5 5 5 6 4 5 2 2 1 4 3 6 4 
305 5 4 5 5 5 6 4 5 2 2 1 4 4 6 
305 5 4 5 5 5 6 4 5 2 2 1 6 5 
295 5 4 5 5 5 6 4 5 2 2 1 4 3 1 5 
290 5 4 5 5 5 6 4 5 2 2 1 4 1 4 4 
290 5 4 5 5 5 6 4 5 2 2 1 4 1 4 4 
290 5 4 5 5 5 6 4 5 2 2 1 4 1 5 
290 5 4 5 5 5 6 4 5 2 2 1 4 1 2 
290 5 4 5 5 5 6 4 5 2 2 1 4 1 4 1 
290 5 4 5 5 5 6 4 5 2 2 1 4 2 4 
290 5 4 5 5 5 6 4 5 2 2 1 4 1 5 
290 5 4 5 5 5 6 4 5 2 2 1 4 1 5 
290 5 4 5 5 5 6 4 5 2 2 1 4 1 4 4 
290 5 4 5 5 5 6 4 5 2 2 1 4 1 5 
290 5 4 5 5 5 6 4 5 2 2 1 4 1 5 
290 5 4 5 5 5 6 4 5 2 2 1 4 1 4 4 
290 5 4 5 5 5 6 4 5 2 2 1 4 1 2 
290 5 4 5 5 5 6 4 5 2 2 1 4 3 3 6 
290 5 4 5 5 5 6 4 5 2 2 1 4 4 2 
290 5 4 5 5 5 6 4 5 2 2 1 5 2 
290 5 4 5 5 5 6 4 5 2 2 1 2 2 
290 5 4 5 5 5 6 4 5 2 2 1 2 4 1 
285 5 4 5 5 5 6 4 5 2 2 1 4 3 3 3 2 3 4 
280 5 4 5 5 5 6 4 5 2 2 1 4 6 
280 5 4 5 5 5 6 4 5 5 6 4 1 4 1 
280 5 4 5 5 5 6 4 5 2 2 1 1 6 
275 5 4 5 5 5 6 4 5 2 2 1 4 1 3 3 1 
270 5 4 5 5 5 6 4 5 2 2 1 4 1 1 3 
270 5 4 5 5 5 6 4 5 2 2 1 3 5 4 
270 5 4 5 5 5 6 4 5 2 2 1 4 4 4 3 
270 5 4 5 5 5 6 4 5 2 2 1 4 1 4 3 
265 5 4 5 5 5 6 4 5 2 2 1 3 6 3 
