375 5 4 5 5 5 6 4 5 2 2 1 3 5 3 3 6 1 3 4 6 
335 5 4 5 5 5 6 4 5 2 2 1 4 3 2 6 
330 5 4 5 5 5 6 4 5 2 2 1 4 1 1 6 
330 5 4 5 5 5 6 4 5 2 2 1 4 5 6 
330 5 4 5 5 5 6 4 5 2 2 1 4 1 4 6 
330 5 4 5 5 5 6 4 5 2 2 1 1 1 4 6 
320 5 4 5 5 5 6 4 5 2 2 1 6 6 
315 5 4 5 5 5 6 4 5 2 2 1 4 5 2 
315 5 4 5 5 5 6 4 5 2 2 1 4 1 1 5 
315 5 4 5 5 5 6 4 5 2 2 5 1 1 5 
315 5 4 5 5 5 6 4 5 2 2 1 4 5 2 
315 5 4 5 5 5 6 4 5 2 2 1 3 3 4 4 6 
305 5 4 5 5 5 6 4 5 2 2 1 4 4 6 
305 5 4 5 5 5 6 4 5 2 2 1 1 1 6 
295 5 4 5 5 5 6 4 5 2 2 1 4 3 4 2 
295 5 4 5 5 5 6 4 5 2 2 1 4 3 2 1 
290 5 4 5 5 5 6 4 5 2 2 1 4 1 1 4 
290 5 4 5 5 5 6 4 5 2 2 1 4 4 5 
290 5 4 5 5 5 6 4 5 2 2 1 4 1 1 1 
290 5 4 5 5 5 6 4 5 2 2 1 4 4 4 1 
290 5 4 5 5 5 6 4 5 2 2 1 4 1 2 
290 5 4 5 5 5 6 4 5 2 2 1 4 1 2 
290 5 4 5 5 5 6 4 5 2 2 1 4 1 5 
285 5 4 5 5 5 6 4 5 2 2 1 4 1 1 4 5 
285 5 4 5 5 5 6 4 5 2 2 1 4 1 1 4 3 
280 5 4 5 5 5 6 4 5 2 2 1 4 6 
280 5 4 5 5 5 6 4 5 2 2 1 3 4 3 3 5 
270 5 4 5 5 5 6 4 5 2 2 1 4 1 1 3 
270 5 4 5 5 5 6 4 5 2 2 1 4 1 1 3 
260 5 4 5 5 5 6 4 5 2 2 1 6 3 
-110 5 4 5 5 5 6 4 5 2 2 1 4 1 1 4 6 2 
-110 5 4 5 5 5 6 4 5 2 2 1 4 4 1 5 5 
-160 5 4 5 5 5 6 4 5 2 2 1 4 2 1 2 5 
-165 5 4 5 5 5 6 4 5 2 2 1 4 1 1 6 3 2 5 
-185 5 4 5 5 5 6 4 5 2 2 1 4 1 4 4 2 5 
-185 5 4 5 5 5 6 4 5 2 2 1 3 5 3 3 6 4 2 3 
-195 5 4 5 5 5 6 4 5 2 2 1 4 1 1 6 5 4 
-195 5 4 5 5 5 6 4 5 2 2 1 4 6 2 5 
-205 5 4 5 5 5 6 4 5 2 2 1 3 5 3 3 4 2 3 
-205 5 4 5 5 5 6 4 5 2 2 1 4 1 1 3 6 3 
-210 5 4 5 5 5 6 4 5 2 2 1 4 2 5 3 
-210 5 4 5 5 5 6 4 5 2 2 1 4 1 2 5 6 
-235 5 4 5 5 5 6 4 5 2 2 1 4 1 1 5 2 
-235 5 4 5 5 5 6 4 5 2 2 1 4 1 1 6 2 
-235 5 4 5 5 5 6 4 5 2 2 1 4 1 6 1 
-235 5 4 5 5 5 6 4 5 2 2 1 4 1 6 1 
-235 5 4 5 5 5 6 4 5 2 2 1 4 1 1 5 2 
-235 5 4 5 5 5 6 4 5 2 2 1 4 6 4 
