65 4 1 6 5 5 6 3 3 1 5 6 
-70 4 1 6 5 6 
-85 4 1 6 5 2 
-85 4 1 6 5 2 
-100 1 2 5 5 4 
-100 4 1 1 5 5 4 
-110 4 1 6 5 3 4 4 5 6 3 
-110 4 1 6 5 3 4 4 5 6 
-110 4 1 6 5 3 4 4 2 
-110 4 1 6 5 3 4 4 5 6 5 
-110 4 1 6 5 3 4 4 1 
-110 4 1 6 5 3 4 4 5 6 6 
-110 4 1 6 5 3 4 4 5 2 
-110 4 1 6 5 3 4 4 5 6 6 
-110 4 1 6 5 3 4 4 5 6 4 
-110 4 1 6 5 3 4 4 5 6 
-110 4 1 6 5 3 4 4 5 
-110 4 1 6 5 3 4 4 5 6 5 
-110 4 1 6 5 3 4 4 3 
-110 4 1 6 5 3 4 4 5 2 
-110 4 1 6 5 3 4 4 2 
-110 4 1 6 5 3 4 4 5 
-110 4 1 6 5 3 4 4 5 6 5 
-110 4 1 6 5 3 4 4 5 5 
-110 4 1 6 5 3 4 4 5 6 1 
-110 4 1 6 5 3 4 4 5 6 5 
-110 4 1 6 5 3 4 4 2 
-110 4 1 6 5 3 4 4 5 4 
-110 4 1 6 5 3 4 4 5 6 2 
-110 4 1 6 5 3 4 4 3 
-110 4 1 6 5 3 4 4 5 1 
-110 4 1 6 5 3 4 4 6 
-110 4 1 6 5 3 4 4 1 
-110 4 1 6 5 3 4 4 1 
-110 4 1 6 5 3 4 4 5 5 
-110 4 1 6 5 3 4 4 5 2 
-110 4 1 6 5 4 
-110 4 1 6 5 1 
-110 4 1 6 5 3 4 4 5 2 
-110 4 1 6 5 3 4 4 5 3 
-110 4 1 6 5 3 4 4 5 6 1 
-120 2 6 6 
-120 4 1 6 6 
-125 4 1 6 5 3 3 
-135 4 1 6 2 
-160 5 6 1 
-160 2 6 4 
-160 6 5 1 
-170 5 1 3 2 
-180 2 6 3 
-180 4 1 3 6 
-180 4 1 6 3 
-180 5 3 6 
-180 4 1 6 3 
-180 4 1 6 3 
-195 4 1 4 3 4 
-195 2 3 4 1 
-195 4 1 1 3 4 
-200 4 1 2 
-200 4 1 4 1 
-200 4 1 1 4 
-210 6 1 
-210 4 6 
-215 3 4 3 2 
