630 5 6 5 5 5 5 5 2 3 1 3 4 2 1 1 6 5 4 5 1 1 5 6 
625 5 6 5 5 5 5 5 2 3 1 3 4 2 1 1 6 6 5 1 4 3 6 5 
620 5 6 5 5 5 5 5 2 3 1 3 4 2 1 1 6 5 5 6 5 6 
610 5 6 5 5 5 5 5 2 3 1 3 4 2 1 1 6 5 5 3 5 6 5 
605 5 6 5 5 5 5 5 2 3 1 3 4 2 1 1 6 5 4 6 1 4 2 1 3 
605 5 6 5 5 5 5 5 2 3 1 3 4 2 1 1 6 1 6 4 4 5 2 1 3 
605 5 6 5 5 5 5 5 2 3 1 3 4 2 1 1 6 6 3 6 6 6 
585 5 6 5 5 5 5 5 2 3 1 3 4 2 1 1 6 5 6 6 6 
585 5 6 5 5 5 5 5 2 3 1 3 4 2 1 1 6 5 6 6 6 1 
585 5 6 5 5 5 5 5 2 3 1 3 4 2 1 1 6 5 6 6 6 
585 5 6 5 5 5 5 5 2 3 1 3 4 2 1 1 6 5 6 6 6 1 
585 5 6 5 5 5 5 5 2 3 1 3 4 2 1 1 6 5 6 6 6 1 1 
585 5 6 5 5 5 5 5 2 3 1 3 4 2 1 1 6 5 6 6 6 1 
585 5 6 5 5 5 5 5 2 3 1 3 4 2 1 1 6 5 6 6 6 1 
585 5 6 5 5 5 5 5 2 3 1 3 4 2 1 1 6 5 6 6 6 1 1 
585 5 6 5 5 5 5 5 2 3 1 3 4 2 1 1 6 5 6 6 6 
585 5 6 5 5 5 5 5 2 3 1 3 4 2 1 1 6 5 6 6 6 1 
585 5 6 5 5 5 5 5 2 3 1 3 4 2 1 1 6 5 6 6 6 1 1 
585 5 6 5 5 5 5 5 2 3 1 3 4 2 1 1 6 5 6 6 6 1 1 
585 5 6 5 5 5 5 5 2 3 1 3 4 2 1 1 6 5 6 6 6 
585 5 6 5 5 5 5 5 2 3 1 3 4 2 1 1 6 5 6 6 6 
585 5 6 5 5 5 5 5 2 3 1 3 4 2 1 1 6 5 6 6 6 1 
585 5 6 5 5 5 5 5 2 3 1 3 4 2 1 1 6 5 6 6 6 1 
585 5 6 5 5 5 5 5 2 3 1 3 4 2 1 1 6 5 6 6 6 1 1 
585 5 6 5 5 5 5 5 2 3 1 3 4 2 1 1 6 5 6 6 6 1 1 
585 5 6 5 5 5 5 5 2 3 1 3 4 2 1 1 6 5 6 6 6 1 
585 5 6 5 5 5 5 5 2 3 1 3 4 2 1 1 6 5 6 6 6 1 1 
585 5 6 5 5 5 5 5 2 3 1 3 4 2 1 1 6 5 6 6 6 1 1 
585 5 6 5 5 5 5 5 2 3 1 3 4 2 1 1 6 5 6 6 6 
585 5 6 5 5 5 5 5 2 3 1 3 4 2 1 1 6 5 6 6 6 1 
585 5 6 5 5 5 5 5 2 3 1 3 4 2 1 1 6 5 6 6 6 1 
585 5 6 5 5 5 5 5 2 3 1 3 4 2 1 1 6 5 6 6 6 
580 5 6 5 5 5 5 5 2 3 1 3 4 2 1 1 6 5 5 4 6 5 5 
565 5 6 5 5 5 5 5 2 3 1 3 4 2 1 1 6 6 5 4 2 3 3 4 
525 5 6 5 5 5 5 5 2 3 1 3 4 2 1 1 6 1 4 4 5 5 3 3 5 
465 5 6 5 5 5 5 5 2 3 1 3 4 2 1 1 6 1 5 2 
455 5 6 5 5 5 5 5 2 3 1 3 4 2 1 1 6 6 2 
440 5 6 5 5 5 5 5 2 3 1 3 4 2 1 1 6 5 2 5 5 1 
430 5 6 5 5 5 5 5 2 3 1 3 4 2 1 1 6 6 1 
415 5 6 5 5 5 5 5 2 3 1 3 4 2 1 1 6 3 6 3 
415 5 6 5 5 5 5 5 2 3 1 3 4 2 1 1 6 4 2 
390 5 6 5 5 5 5 5 2 3 1 3 4 2 1 1 6 1 1 
390 5 6 5 5 5 5 5 2 3 1 3 4 2 1 1 6 4 1 
325 5 6 5 5 5 5 5 2 3 1 3 4 2 1 1 2 
300 5 6 5 5 5 5 5 2 3 1 3 4 2 1 2 
300 5 6 5 5 5 5 5 2 3 1 3 4 2 1 1 4 
255 5 6 5 5 5 5 5 2 3 1 3 4 2 1 3 
-20 5 6 5 5 5 5 5 2 3 1 3 4 2 1 1 6 5 5 6 5 2 4 3 3 4 6 
