630 5 6 5 5 5 5 5 2 3 1 3 4 2 1 1 6 5 5 6 1 2 5 
595 5 6 5 5 5 5 5 2 3 1 3 4 2 1 1 3 5 5 5 5 6 2 5 
440 5 6 5 5 5 5 5 2 3 1 3 4 2 1 1 6 1 4 2 
375 5 6 5 5 5 5 5 2 3 1 3 4 2 1 1 6 2 5 6 4 1 6 1 
320 5 6 5 5 5 5 5 2 6 5 1 6 5 1 6 6 
305 5 6 5 5 5 5 5 2 4 6 2 2 
300 5 6 5 5 5 5 5 2 2 3 6 6 
270 5 6 5 5 5 5 5 2 5 2 5 3 
260 5 6 5 5 5 5 5 2 6 4 2 3 
260 5 6 5 5 5 5 5 2 6 3 2 4 
90 5 6 5 5 5 5 1 2 
20 5 6 5 5 5 5 5 2 3 1 3 4 2 1 1 6 5 
-5 5 6 5 5 5 5 5 2 3 1 3 4 2 1 1 4 3 
-40 5 6 5 5 5 5 5 2 6 2 5 2 4 3 6 6 6 6 5 1 1 1 2 6 6 5 2 2 5 6 1 3 
-40 5 6 5 5 5 5 5 2 6 2 5 2 4 3 6 6 6 6 5 1 1 1 2 6 6 5 2 2 5 6 1 3 5 1 
-45 5 6 5 5 5 5 5 2 3 1 3 4 2 1 1 6 2 
-45 5 6 5 5 5 5 5 2 3 1 3 4 2 1 1 2 6 
-100 5 6 5 5 5 5 5 2 3 1 3 4 2 1 1 6 5 1 3 
-100 5 6 5 5 5 5 5 2 3 1 3 4 2 1 1 1 5 
-100 5 6 5 5 5 5 5 2 6 5 1 6 5 1 6 1 4 
-100 5 6 5 5 5 5 5 2 6 5 1 6 5 1 6 4 5 
-115 5 6 5 5 5 5 5 2 3 1 3 4 2 1 1 6 4 6 
-120 5 6 5 5 5 5 5 2 3 1 3 4 2 1 1 3 3 
-120 5 6 5 5 5 5 5 2 6 5 1 6 5 1 6 6 2 3 3 
-120 5 6 5 5 5 5 5 2 3 1 3 4 2 1 1 3 5 
-120 5 6 5 5 5 5 5 2 3 1 3 4 2 1 1 3 2 
-120 5 6 5 5 5 5 5 2 3 1 3 4 2 1 1 3 5 
-135 5 6 5 5 5 5 5 2 3 1 3 4 2 1 1 6 
-165 5 6 5 5 5 5 5 2 3 1 3 4 2 1 1 6 
-185 5 6 5 5 5 5 5 2 3 1 3 4 2 1 1 6 
-185 5 6 5 5 5 5 5 2 3 1 3 4 2 1 1 6 
-185 5 6 5 5 5 5 5 2 3 1 3 4 2 1 1 
-185 5 6 5 5 5 5 5 2 3 1 3 4 2 1 1 
-185 5 6 5 5 5 5 5 2 3 1 3 4 2 1 1 
-185 5 6 5 5 5 5 5 2 6 5 1 6 5 1 6 6 2 6 5 
-185 5 6 5 5 5 5 5 2 6 5 1 6 5 1 6 6 2 
-185 5 6 5 5 5 5 5 2 6 5 1 6 5 1 6 6 2 
-185 5 6 5 5 5 5 5 2 3 1 3 4 2 1 1 6 5 
-185 5 6 5 5 5 5 5 2 6 5 1 6 5 1 6 6 2 6 
-185 5 6 5 5 5 5 5 2 6 5 1 6 5 1 6 6 2 6 
-185 5 6 5 5 5 5 5 2 6 5 1 6 5 1 6 6 2 6 
-185 5 6 5 5 5 5 5 2 6 2 5 2 4 3 6 6 6 6 5 1 1 1 2 6 6 
-185 5 6 5 5 5 5 5 2 6 5 1 6 5 1 6 6 2 6 
-190 5 6 5 5 5 5 5 2 3 1 3 4 2 1 1 5 
-190 5 6 5 5 5 5 5 2 6 5 1 6 5 1 6 6 2 
-190 5 6 5 5 5 5 5 2 6 5 1 6 5 1 6 5 
-190 5 6 5 5 5 5 5 2 6 5 1 6 5 1 6 6 2 5 
-375 5 6 5 5 5 5 5 2 3 1 3 4 2 1 1 
