95 6 5 5 5 5 6 6 
95 6 5 5 5 5 6 6 
95 6 5 5 5 5 6 6 
95 6 5 5 5 5 6 6 
95 6 5 5 5 5 6 6 
95 6 5 5 5 5 6 6 
95 6 5 5 5 5 6 6 
95 6 5 5 5 5 6 6 
80 6 5 5 5 5 6 2 
80 6 5 5 5 5 6 5 
80 6 5 5 5 5 6 2 
80 6 5 5 5 5 6 2 
80 6 5 5 5 5 6 2 
80 6 5 5 5 5 6 5 
80 6 5 5 5 5 6 5 
80 6 5 5 5 5 6 5 
80 6 5 5 5 6 5 5 
80 6 5 5 5 6 5 2 
80 6 5 5 5 6 2 2 
80 6 5 5 5 5 6 2 
80 6 5 5 5 5 6 2 
80 6 5 5 5 5 6 5 
80 6 5 5 5 5 6 2 
65 6 5 5 5 5 5 4 1 1 
60 6 5 5 5 5 4 6 3 
60 6 5 5 5 6 3 5 1 
55 6 5 5 5 5 6 4 
55 6 5 5 5 5 6 4 
55 6 5 5 5 5 6 4 
55 6 5 5 5 5 6 4 
55 6 5 5 5 5 6 1 
55 6 5 5 5 5 6 1 
55 6 5 5 5 5 6 1 
55 6 5 5 5 5 6 4 
45 6 5 5 5 5 4 3 2 6 
45 6 5 5 5 3 5 2 4 5 
35 6 5 5 5 5 6 3 
35 6 5 5 5 5 6 3 
35 6 5 5 5 5 6 3 
35 6 5 5 5 5 6 3 
35 6 5 5 5 5 6 3 
35 6 5 5 5 5 6 3 
35 6 5 5 5 5 6 3 
25 6 5 5 5 3 5 5 3 6 
15 6 5 5 5 5 2 
15 6 5 5 5 5 4 1 
15 6 5 5 5 5 4 1 
15 6 5 5 5 5 4 1 
15 6 5 5 5 5 2 
-10 6 5 5 5 5 1 
-10 6 5 5 5 5 1 
-10 6 5 5 5 5 1 
-10 6 5 5 5 5 1 
-10 6 5 5 5 5 1 
-30 6 5 5 5 5 3 
-35 6 5 5 5 2 
-35 6 5 5 5 2 
-35 6 5 5 5 2 
-35 6 5 5 5 2 
-35 6 5 5 5 2 
-35 6 5 5 5 2 
-55 6 5 5 5 3 1 
-55 6 5 5 5 3 1 
-55 4 3 3 3 6 5 6 4 
-60 6 5 5 5 1 
-60 6 5 5 5 4 
-60 5 6 5 5 1 
-60 6 5 5 5 4 
-60 4 5 5 5 6 
-60 6 5 5 5 1 
-60 6 5 5 5 1 
-65 6 5 5 5 4 3 4 3 
-75 6 5 5 5 3 3 
-85 6 5 5 2 
-85 1 1 6 5 2 
-85 6 5 5 2 
-85 4 3 3 6 5 6 
-100 2 1 5 5 4 
-110 6 5 5 4 
-110 6 5 5 4 
-125 4 5 5 2 
-125 6 5 5 3 3 
-135 6 5 2 
-135 6 5 2 
-135 6 5 2 
-160 6 5 1 
-160 6 5 1 
-160 6 5 4 
-160 6 5 4 
-160 6 5 1 
-160 6 5 1 
-160 6 5 4 
-170 6 6 
-170 2 3 4 5 
-170 2 3 1 2 
-170 5 3 1 2 
-180 6 5 3 
-180 6 5 3 
-180 6 5 3 
-180 5 6 3 
-180 6 5 3 
-180 6 5 3 
-185 6 2 
-185 6 2 
-185 6 2 
-195 5 3 2 
-195 3 2 5 
-195 3 5 2 
-195 2 3 2 
-195 2 4 3 4 
-200 5 5 
-200 2 1 1 
-200 1 1 1 1 
-200 5 2 
-200 4 5 1 
-200 2 2 
-200 5 2 
-205 6 3 4 
-205 3 6 1 
-205 6 3 1 
-205 6 3 1 
-210 6 1 
-210 6 1 
-210 4 6 
-210 6 4 
-210 6 1 
-215 3 1 1 1 3 
-225 3 6 3 
