130 4 5 5 5 5 3 5 5 2 5 
120 4 5 5 5 5 3 5 5 4 6 
105 4 5 5 5 5 3 5 5 4 2 
105 4 5 5 5 5 3 5 4 5 5 
105 4 5 5 5 5 3 5 5 2 1 
105 4 5 5 5 5 3 5 5 5 4 
95 4 5 5 5 5 3 6 4 4 5 
95 4 5 5 5 5 3 5 6 2 
95 4 5 5 5 5 3 5 6 5 
95 4 5 5 5 5 3 5 5 6 
95 4 5 5 5 5 3 5 6 5 
85 4 5 5 5 5 3 5 2 3 2 
85 4 5 5 5 5 3 5 2 3 5 
85 4 5 5 5 5 3 6 4 6 
80 4 5 5 5 5 3 5 5 1 4 
80 4 5 5 5 5 3 5 1 1 2 
80 4 5 5 5 5 3 5 5 1 1 
80 4 5 5 5 5 3 5 1 4 5 5 
80 4 5 5 5 5 6 6 1 
60 4 5 5 5 5 3 5 3 4 5 5 
60 4 5 5 5 5 3 5 5 4 3 4 
30 4 5 5 5 5 3 4 6 3 3 
-20 4 5 5 5 5 3 2 
-20 4 5 5 5 5 3 2 
-65 4 5 5 5 5 3 3 
-65 4 5 5 5 5 3 3 
-100 4 5 5 5 1 
-100 4 5 5 5 4 
-100 4 5 5 5 4 
-110 4 5 5 6 
-120 4 5 5 5 3 5 6 4 3 2 5 
-125 4 5 5 2 
-125 4 5 5 2 
-125 5 1 5 2 
-125 1 5 5 5 3 4 1 
-125 4 5 5 2 
-155 4 4 3 1 6 
-160 4 5 6 
-170 3 2 4 2 
-170 3 2 4 5 
-170 4 3 1 4 5 
-175 4 5 2 
-175 4 5 2 
-175 3 4 3 1 6 
-195 5 1 3 4 
-200 4 5 4 
-200 4 5 1 
-215 4 4 3 3 4 
