125 6 5 5 3 6 4 1 4 5 6 
115 6 5 5 3 6 4 1 6 6 
100 6 5 5 3 6 4 1 6 2 
100 6 5 5 3 6 4 1 6 5 
100 6 5 5 3 6 4 1 6 2 
100 6 5 5 3 6 4 1 6 2 
100 6 5 5 3 6 4 1 6 5 
90 6 5 5 3 6 4 6 6 
85 6 5 5 3 6 4 4 2 2 
85 6 5 5 3 6 4 5 5 1 
80 6 5 5 3 6 4 3 2 6 
75 6 5 5 3 6 4 1 6 4 
75 6 5 5 3 6 4 1 6 4 
75 6 5 5 3 6 4 1 6 4 
75 6 5 5 3 6 4 1 6 4 
60 6 5 5 3 6 4 1 5 1 
60 6 5 5 3 6 4 2 2 
60 6 5 5 3 6 4 2 5 
60 6 5 5 3 6 4 1 1 4 4 
60 6 5 5 3 6 4 1 5 1 
60 6 5 5 3 6 4 1 1 5 
55 6 5 5 3 6 4 1 6 3 
45 6 5 5 3 6 4 4 3 4 4 3 5 
40 6 5 5 3 6 4 1 4 1 3 
30 6 5 5 3 6 4 6 3 
-30 6 5 5 5 5 3 
-70 6 5 5 6 
-110 6 5 5 4 
-110 2 1 5 6 
-150 1 5 5 4 
-160 6 5 4 
-170 4 1 1 3 5 
-170 6 6 
-175 1 4 4 2 
-175 1 4 1 2 
-180 4 1 3 6 
-180 6 5 3 
-180 5 6 3 
-185 6 2 
-185 6 2 
-195 3 2 2 
-195 5 3 5 
-200 2 2 
-200 1 2 1 
-200 5 4 1 
-200 5 2 
-210 6 1 
-215 5 3 3 1 
