635 5 6 5 5 5 5 5 2 3 1 3 4 2 1 1 6 5 4 5 1 1 3 6 1 1 5 
630 5 6 5 5 5 5 5 2 3 1 3 4 2 1 1 6 5 4 5 1 1 5 6 
620 5 6 5 5 5 5 5 2 3 1 3 4 2 1 1 6 6 3 6 5 3 1 6 
615 5 6 5 5 5 5 5 2 3 1 3 4 2 1 1 6 5 4 5 1 1 5 5 
615 5 6 5 5 5 5 5 2 3 1 3 4 2 1 1 6 5 4 5 1 1 5 2 
615 5 6 5 5 5 5 5 2 3 1 3 4 2 1 1 6 5 4 5 1 1 5 2 
615 5 6 5 5 5 5 5 2 3 1 3 4 2 1 1 6 5 4 5 1 1 4 2 4 
605 5 6 5 5 5 5 5 2 3 1 3 4 2 1 1 6 5 4 5 1 5 6 
590 5 6 5 5 5 5 5 2 3 1 3 4 2 1 1 6 5 4 5 1 1 5 4 
590 5 6 5 5 5 5 5 2 3 1 3 4 2 1 1 6 5 4 5 1 1 5 1 
585 5 6 5 5 5 5 5 2 3 1 3 4 2 1 1 6 5 6 6 6 
585 5 6 5 5 5 5 5 2 3 1 3 4 2 1 1 6 5 6 6 6 1 
585 5 6 5 5 5 5 5 2 3 1 3 4 2 1 1 6 5 6 6 6 1 
585 5 6 5 5 5 5 5 2 3 1 3 4 2 1 1 6 5 6 6 6 1 2 
585 5 6 5 5 5 5 5 2 3 1 3 4 2 1 1 6 5 6 6 6 1 2 
585 5 6 5 5 5 5 5 2 3 1 3 4 2 1 1 6 5 6 6 6 1 
585 5 6 5 5 5 5 5 2 3 1 3 4 2 1 1 6 5 6 6 6 1 2 
585 5 6 5 5 5 5 5 2 3 1 3 4 2 1 1 6 5 6 6 6 1 
585 5 6 5 5 5 5 5 2 3 1 3 4 2 1 1 6 5 6 6 6 
585 5 6 5 5 5 5 5 2 3 1 3 4 2 1 1 6 5 6 6 6 1 2 
585 5 6 5 5 5 5 5 2 3 1 3 4 2 1 1 6 5 6 6 6 
585 5 6 5 5 5 5 5 2 3 1 3 4 2 1 1 6 5 6 6 6 1 
585 5 6 5 5 5 5 5 2 3 1 3 4 2 1 1 6 5 6 6 6 1 2 
585 5 6 5 5 5 5 5 2 3 1 3 4 2 1 1 6 5 6 6 6 
585 5 6 5 5 5 5 5 2 3 1 3 4 2 1 1 6 5 6 6 6 1 2 
585 5 6 5 5 5 5 5 2 3 1 3 4 2 1 1 6 5 6 6 6 1 
585 5 6 5 5 5 5 5 2 3 1 3 4 2 1 1 6 5 6 6 6 1 2 
585 5 6 5 5 5 5 5 2 3 1 3 4 2 1 1 6 5 6 6 6 1 2 
585 5 6 5 5 5 5 5 2 3 1 3 4 2 1 1 6 5 6 6 6 
585 5 6 5 5 5 5 5 2 3 1 3 4 2 1 1 6 5 6 6 6 1 
585 5 6 5 5 5 5 5 2 3 1 3 4 2 1 1 6 5 6 6 6 
585 5 6 5 5 5 5 5 2 3 1 3 4 2 1 1 6 5 6 6 6 
585 5 6 5 5 5 5 5 2 3 1 3 4 2 1 1 6 5 6 6 6 1 
585 5 6 5 5 5 5 5 2 3 1 3 4 2 1 1 6 5 6 6 6 1 2 
585 5 6 5 5 5 5 5 2 3 1 3 4 2 1 1 6 5 6 6 6 1 
585 5 6 5 5 5 5 5 2 3 1 3 4 2 1 1 6 5 6 6 6 
585 5 6 5 5 5 5 5 2 3 1 3 4 2 1 1 6 5 6 6 6 
580 5 6 5 5 5 5 5 2 3 1 3 4 2 1 1 6 5 4 5 1 6 1 4 
575 5 6 5 5 5 5 5 2 3 1 3 4 2 1 1 6 5 6 6 2 3 
575 5 6 5 5 5 5 5 2 3 1 3 4 2 1 1 6 5 4 5 1 1 5 3 3 
570 5 6 5 5 5 5 5 2 3 1 3 4 2 1 1 6 5 6 6 5 
570 5 6 5 5 5 5 5 2 3 1 3 4 2 1 1 6 5 6 6 1 4 
570 5 6 5 5 5 5 5 2 3 1 3 4 2 1 1 6 5 4 5 1 1 4 3 4 
570 5 6 5 5 5 5 5 2 3 1 3 4 2 1 1 6 5 6 6 5 
555 5 6 5 5 5 5 5 2 3 1 3 4 2 1 1 6 5 6 6 3 1 3 
465 5 6 5 5 5 5 5 2 3 1 3 4 2 1 1 6 5 5 1 
-115 5 6 5 5 5 5 5 2 3 1 3 4 2 1 1 6 5 6 6 6 
-135 5 6 5 5 5 5 5 2 3 1 3 4 2 1 1 6 5 6 6 6 1 
