725 5 6 5 5 5 5 5 2 3 1 3 4 2 1 1 6 5 6 6 6 1 2 6 
685 5 6 5 5 5 5 5 2 3 1 3 4 2 1 1 6 5 6 6 6 1 1 5 
675 5 6 5 5 5 5 5 2 3 1 3 4 2 1 1 6 5 6 6 6 1 6 
670 5 6 5 5 5 5 5 2 3 1 3 4 2 1 1 6 5 6 6 5 2 5 
660 5 6 5 5 5 5 5 2 3 1 3 4 2 1 1 6 5 4 5 1 1 5 2 2 5 
660 5 6 5 5 5 5 5 2 3 1 3 4 2 1 1 6 5 4 5 1 1 5 2 2 5 
655 5 6 5 5 5 5 5 2 3 1 3 4 2 1 1 6 5 4 5 1 1 4 2 6 
655 5 6 5 5 5 5 5 2 3 1 3 4 2 1 1 6 5 4 5 1 5 2 6 
650 5 6 5 5 5 5 5 2 3 1 3 4 2 1 1 6 5 4 5 1 1 5 1 2 6 
635 5 6 5 5 5 5 5 2 3 1 3 4 2 1 1 6 5 6 6 5 6 
635 5 6 5 5 5 5 5 2 3 1 3 4 2 1 1 6 5 4 5 1 1 3 6 1 4 
635 5 6 5 5 5 5 5 2 3 1 3 4 2 1 1 6 5 6 6 6 1 4 
630 5 6 5 5 5 5 5 2 3 1 3 4 2 1 1 6 5 4 5 1 1 5 6 
630 5 6 5 5 5 5 5 2 3 1 3 4 2 1 1 6 5 4 5 1 6 1 4 1 
630 5 6 5 5 5 5 5 2 3 1 3 4 2 1 1 6 5 4 5 1 1 5 6 
630 5 6 5 5 5 5 5 2 3 1 3 4 2 1 1 6 5 4 5 1 1 5 6 
620 5 6 5 5 5 5 5 2 3 1 3 4 2 1 1 6 5 4 5 1 1 5 3 5 
615 5 6 5 5 5 5 5 2 3 1 3 4 2 1 1 6 5 4 5 1 1 5 4 4 
610 5 6 5 5 5 5 5 2 3 1 3 4 2 1 1 6 5 6 6 1 6 
610 5 6 5 5 5 5 5 2 3 1 3 4 2 1 1 6 5 6 6 6 4 
610 5 6 5 5 5 5 5 2 3 1 3 4 2 1 1 6 5 6 6 6 4 
610 5 6 5 5 5 5 5 2 3 1 3 4 2 1 1 6 5 6 6 6 4 
605 5 6 5 5 5 5 5 2 3 1 3 4 2 1 1 6 5 4 5 1 5 6 
605 5 6 5 5 5 5 5 2 3 1 3 4 2 1 1 6 5 4 5 1 2 6 
605 5 6 5 5 5 5 5 2 3 1 3 4 2 1 1 6 5 5 6 5 5 
605 5 6 5 5 5 5 5 2 3 1 3 4 2 1 1 6 6 3 6 6 6 
600 5 6 5 5 5 5 5 2 3 1 3 4 2 1 1 6 5 6 6 3 3 3 6 
600 5 6 5 5 5 5 5 2 3 1 3 4 2 1 1 6 5 6 6 5 1 3 
600 5 6 5 5 5 5 5 2 3 1 3 4 2 1 1 6 5 4 5 1 1 3 3 2 4 
595 5 6 5 5 5 5 5 2 3 1 3 4 2 1 1 6 5 4 5 1 1 3 2 4 
595 5 6 5 5 5 5 5 2 3 1 3 4 2 1 1 6 5 4 5 1 5 3 5 
595 5 6 5 5 5 5 5 2 3 1 3 4 2 1 1 6 5 6 6 4 5 
595 5 6 5 5 5 5 5 2 3 1 3 4 2 1 1 6 5 6 6 2 4 
590 5 6 5 5 5 5 5 2 3 1 3 4 2 1 1 6 5 4 5 1 1 5 3 1 4 6 
590 5 6 5 5 5 5 5 2 3 1 3 4 2 1 1 6 5 4 5 1 1 4 1 4 
590 5 6 5 5 5 5 5 2 3 1 3 4 2 1 1 6 5 4 5 1 1 5 1 1 5 1 5 3 6 5 5 2 2 
590 5 6 5 5 5 5 5 2 3 1 3 4 2 1 1 6 5 4 5 1 1 4 5 
590 5 6 5 5 5 5 5 2 3 1 3 4 2 1 1 6 6 5 1 4 3 5 3 4 
590 5 6 5 5 5 5 5 2 3 1 3 4 2 1 1 6 5 6 6 3 6 
590 5 6 5 5 5 5 5 2 3 1 3 4 2 1 1 6 5 4 5 1 1 1 5 
570 5 6 5 5 5 5 5 2 3 1 3 4 2 1 1 6 5 6 6 1 4 
570 5 6 5 5 5 5 5 2 3 1 3 4 2 1 1 6 5 4 5 1 1 2 3 
570 5 6 5 5 5 5 5 2 3 1 3 4 2 1 1 6 5 4 5 1 1 3 1 4 
495 5 6 5 5 5 5 5 2 3 1 3 4 2 1 1 6 5 4 5 1 1 5 4 4 5 3 1 1 2 5 
470 5 6 5 5 5 5 5 2 3 1 3 4 2 1 1 6 5 5 3 1 
415 5 6 5 5 5 5 5 2 3 1 3 4 2 1 1 6 5 1 
-160 5 6 5 5 5 5 5 2 3 1 3 4 2 1 1 6 5 4 6 1 4 4 3 
-160 5 6 5 5 5 5 5 2 3 1 3 4 2 1 1 6 1 6 4 4 5 2 1 3 
