390 5 6 5 5 5 5 5 2 3 1 3 4 2 1 1 6 5 5 6 1 2 
390 5 6 5 5 5 5 5 2 3 1 3 4 2 1 1 6 5 5 6 1 
390 5 6 5 5 5 5 5 2 3 1 3 4 2 1 1 6 5 5 6 1 
390 5 6 5 5 5 5 5 2 3 1 3 4 2 1 1 6 5 5 6 1 2 
390 5 6 5 5 5 5 5 2 3 1 3 4 2 1 1 6 5 5 6 1 2 
390 5 6 5 5 5 5 5 2 3 1 3 4 2 1 1 6 5 5 6 
390 5 6 5 5 5 5 5 2 3 1 3 4 2 1 1 6 5 5 6 1 
390 5 6 5 5 5 5 5 2 3 1 3 4 2 1 1 6 5 5 6 1 
390 5 6 5 5 5 5 5 2 3 1 3 4 2 1 1 6 5 5 6 1 
390 5 6 5 5 5 5 5 2 3 1 3 4 2 1 1 6 5 5 6 1 2 
390 5 6 5 5 5 5 5 2 3 1 3 4 2 1 1 6 5 5 6 
390 5 6 5 5 5 5 5 2 3 1 3 4 2 1 1 6 5 5 6 1 
390 5 6 5 5 5 5 5 2 3 1 3 4 2 1 1 6 5 5 6 1 2 
390 5 6 5 5 5 5 5 2 3 1 3 4 2 1 1 6 5 5 6 1 
390 5 6 5 5 5 5 5 2 3 1 3 4 2 1 1 6 5 5 6 1 
390 5 6 5 5 5 5 5 2 3 1 3 4 2 1 1 6 5 5 6 
390 5 6 5 5 5 5 5 2 3 1 3 4 2 1 1 6 5 5 6 1 2 
390 5 6 5 5 5 5 5 2 3 1 3 4 2 1 1 6 5 5 6 1 2 
390 5 6 5 5 5 5 5 2 3 1 3 4 2 1 1 6 5 5 6 1 2 
390 5 6 5 5 5 5 5 2 3 1 3 4 2 1 1 6 5 5 6 
390 5 6 5 5 5 5 5 2 3 1 3 4 2 1 1 6 5 5 6 1 2 
390 5 6 5 5 5 5 5 2 3 1 3 4 2 1 1 6 5 5 6 
390 5 6 5 5 5 5 5 2 3 1 3 4 2 1 1 6 5 5 6 1 
390 5 6 5 5 5 5 5 2 3 1 3 4 2 1 1 6 5 5 6 1 
390 5 6 5 5 5 5 5 2 3 1 3 4 2 1 1 6 5 5 
345 5 6 5 5 5 5 5 2 3 1 3 4 2 1 1 6 3 2 
330 5 6 5 5 5 5 5 2 3 1 3 4 2 1 1 3 2 
325 5 6 5 5 5 5 5 2 3 1 3 4 2 1 1 5 
320 5 6 5 5 5 5 5 2 6 5 1 6 5 1 6 
320 5 6 5 5 5 5 5 2 4 6 2 6 
320 5 6 5 5 5 5 5 2 6 5 1 6 5 1 6 4 
320 5 6 5 5 5 5 5 2 6 5 1 6 5 1 
315 5 6 5 5 5 5 5 2 3 1 3 4 2 1 6 
300 5 6 5 5 5 5 5 2 3 1 3 4 2 1 1 4 
300 5 6 5 5 5 5 5 2 3 1 3 4 2 1 1 4 
300 5 6 5 5 5 5 5 2 3 1 3 4 2 1 1 4 
300 5 6 5 5 5 5 5 2 3 1 3 4 2 1 2 
275 5 6 5 5 5 5 5 2 3 1 3 4 2 1 4 
270 5 6 5 5 5 5 5 2 5 1 2 1 3 
270 5 6 5 5 5 5 5 2 6 4 6 
265 5 6 5 5 5 5 5 2 2 3 3 1 6 
260 5 6 5 5 5 5 5 2 6 3 2 4 
95 5 6 5 5 5 5 3 2 1 
-70 5 6 5 5 5 5 5 2 6 2 5 2 4 3 6 6 6 6 5 1 1 1 2 6 6 5 2 2 5 6 
-70 5 6 5 5 5 5 5 2 6 2 5 2 4 3 6 6 6 6 5 1 1 1 2 6 6 5 2 2 5 6 1 3 5 
-70 5 6 5 5 5 5 5 2 3 1 3 4 2 1 1 6 5 5 6 1 
-115 5 6 5 5 5 5 5 2 3 1 3 4 2 1 1 3 5 5 5 5 4 3 
-160 5 6 5 5 5 5 5 2 3 1 3 4 2 1 1 6 2 5 6 4 1 6 3 1 
