90 4 2 5 5 5 6 5 2 
80 4 2 5 5 5 6 6 4 
65 4 2 5 5 5 6 5 4 
65 4 2 5 5 5 6 5 1 
65 4 2 5 5 5 6 4 5 2 
60 4 2 5 5 5 6 6 3 
25 4 2 5 5 5 5 2 
0 4 2 5 5 5 3 6 3 6 
-20 4 2 5 5 5 5 3 
-25 4 2 5 5 5 2 
-25 4 2 5 5 5 2 
-25 4 2 5 5 5 2 
-30 4 2 5 5 3 6 1 
-50 4 2 5 5 5 4 
-50 4 2 5 5 5 4 
-50 4 2 5 5 5 1 
-50 4 2 5 5 5 4 
-70 4 2 5 5 3 2 
-70 4 2 5 5 3 2 
-70 4 2 5 5 3 2 
-75 2 4 5 5 2 
-75 4 2 5 5 2 
-80 6 5 5 3 2 
-95 4 2 5 5 3 1 
-95 4 2 5 5 3 1 
-100 4 2 5 5 1 
-100 4 2 5 5 1 
-100 4 2 5 5 1 
-100 4 2 5 5 4 
-100 4 2 5 5 4 
-100 4 2 5 5 4 
-100 4 2 5 5 4 
-100 1 5 5 5 1 
-115 4 2 5 5 3 3 
-125 4 2 5 2 
-150 4 2 5 1 
-150 4 2 5 1 
-160 4 5 6 
-170 4 2 5 3 
-175 4 4 1 2 
-175 4 2 2 
-175 4 2 2 
-175 5 4 2 
-200 4 2 1 
-200 1 4 1 4 
-200 4 5 1 
-215 4 2 3 3 
-215 4 1 3 3 1 
