370 5 4 5 5 5 6 4 5 2 2 1 3 5 3 3 6 1 4 1 
330 5 4 5 5 5 6 4 5 2 2 1 4 1 4 6 
330 5 4 5 5 5 6 4 5 2 2 1 4 1 4 6 
330 5 4 5 5 5 6 4 5 2 2 1 4 4 4 6 
330 5 4 5 5 5 6 4 5 2 2 1 4 1 4 6 
315 5 4 5 5 5 6 4 5 2 2 1 4 1 4 5 
315 5 4 5 5 5 6 4 5 2 2 1 4 1 4 2 
315 5 4 5 5 5 6 4 5 2 2 1 4 1 4 5 
315 5 4 5 5 5 6 4 5 2 2 1 4 1 4 2 
315 5 4 5 5 5 6 4 5 2 2 1 4 1 4 5 
315 5 4 5 5 5 6 4 5 2 2 1 4 1 4 5 
315 5 4 5 5 5 6 4 5 2 2 1 4 2 5 
315 5 4 5 5 5 6 4 5 2 2 1 1 5 2 
310 5 4 5 5 5 6 4 5 2 2 1 3 6 1 1 
310 5 4 5 5 5 6 4 5 2 2 1 4 3 1 6 
305 5 4 5 5 5 6 4 5 2 2 1 4 1 6 
305 5 4 5 5 5 6 4 5 2 2 1 4 1 6 
305 5 4 5 5 5 6 4 5 2 2 1 2 6 
305 5 4 5 5 5 6 4 5 2 2 1 4 1 6 
295 5 4 5 5 5 6 4 5 2 2 1 4 1 3 5 
295 5 4 5 5 5 6 4 5 2 2 1 4 3 4 5 
290 5 4 5 5 5 6 4 5 2 2 1 4 1 4 1 
290 5 4 5 5 5 6 4 5 2 2 1 4 1 4 4 
290 5 4 5 5 5 6 4 5 2 2 1 4 1 4 1 
290 5 4 5 5 5 6 4 5 2 2 1 4 1 2 
290 5 4 5 5 5 6 4 5 2 2 1 4 1 4 1 
290 5 4 5 5 5 6 4 5 2 2 1 4 1 4 1 
290 5 4 5 5 5 6 4 5 2 2 1 4 1 4 4 
290 5 4 5 5 5 6 4 5 2 2 1 4 1 2 
290 5 4 5 5 5 6 4 5 2 2 1 4 5 1 
290 5 4 5 5 5 6 4 5 2 2 1 3 4 3 6 
290 5 4 5 5 5 6 4 5 2 2 1 4 5 4 
285 5 4 5 5 5 6 4 5 2 2 1 4 3 6 
280 5 4 5 5 5 6 4 5 2 2 1 4 6 
280 5 4 5 5 5 6 4 5 2 2 1 4 6 
280 5 4 5 5 5 6 4 5 2 2 2 6 
280 5 4 5 5 5 6 4 5 2 2 1 4 6 
280 5 4 5 5 5 6 4 5 2 2 1 4 6 
270 5 4 5 5 5 6 4 5 2 2 1 4 1 4 3 
270 5 4 5 5 5 6 4 5 2 2 1 1 3 5 
270 5 4 5 5 5 6 4 5 2 2 1 5 3 1 
270 5 4 5 5 5 6 4 5 2 2 1 4 1 4 3 
270 5 4 5 5 5 6 4 5 2 2 1 4 1 4 3 
270 5 4 5 5 5 6 4 5 2 2 1 4 1 4 3 
270 5 4 5 5 5 6 4 5 2 2 1 3 1 5 
270 5 4 5 5 5 6 4 5 2 2 1 4 1 4 3 
270 5 4 5 5 5 6 4 5 2 2 1 4 3 4 4 
270 5 4 5 5 5 6 4 5 2 2 1 4 3 4 4 
