415 5 6 5 5 3 4 6 4 6 3 1 3 1 2 5 6 6 1 
400 5 6 5 5 3 4 6 4 6 3 1 3 5 1 5 6 1 5 1 
390 5 6 5 5 3 4 6 4 6 3 1 4 5 1 4 6 3 6 2 
380 5 6 5 5 3 4 6 4 6 3 1 2 4 4 5 5 2 
370 5 6 5 5 3 4 6 4 6 3 1 3 6 3 5 5 6 
370 5 6 5 5 3 4 6 4 6 3 1 3 3 5 6 6 5 
330 5 6 5 5 3 4 6 4 6 3 1 5 4 4 5 2 
310 5 6 5 5 3 4 6 4 6 3 1 3 5 1 5 5 
310 5 6 5 5 3 4 6 4 6 3 1 3 5 4 5 5 
310 5 6 5 5 3 4 6 4 6 3 1 3 1 5 5 5 
310 5 6 5 5 3 4 6 4 6 3 1 3 5 1 5 2 
305 5 6 5 5 3 4 6 4 6 3 1 4 2 4 5 4 
295 5 6 5 5 3 4 6 4 6 3 1 1 1 4 1 6 
285 5 6 5 5 3 4 6 4 6 3 1 4 3 5 5 4 
285 5 6 5 5 3 4 6 4 6 3 1 1 4 5 5 3 
285 5 6 5 5 3 4 6 4 6 3 1 1 6 6 
285 5 6 5 5 3 4 6 4 6 3 1 6 6 1 
280 5 6 5 5 3 4 6 4 6 3 1 3 3 5 4 6 
280 5 6 5 5 3 4 6 4 6 3 1 1 1 2 2 
280 5 6 5 5 3 4 6 4 6 3 1 2 2 2 
280 5 6 5 5 3 4 6 4 6 3 1 3 2 3 4 6 
275 5 6 5 5 3 4 6 4 6 3 1 3 4 2 6 
275 5 6 5 5 3 4 6 4 6 3 1 1 4 1 6 3 
275 5 6 5 5 3 4 6 4 6 3 1 3 5 1 6 
275 5 6 5 5 3 4 6 4 6 3 1 3 5 1 6 
275 5 6 5 5 3 4 6 4 6 3 1 3 5 1 6 
270 5 6 5 5 3 4 6 4 6 3 1 6 1 5 
270 5 6 5 5 3 4 6 4 6 3 1 6 1 5 
270 5 6 5 5 3 4 6 4 6 3 1 6 1 2 
265 5 6 5 5 3 4 6 4 6 3 1 3 6 6 
265 5 6 5 5 3 4 6 4 6 3 1 3 2 1 3 5 
265 5 6 5 5 3 4 6 4 6 3 1 3 1 5 3 5 
265 5 6 5 5 3 4 6 4 6 3 1 3 5 3 4 5 
265 5 6 5 5 3 4 6 4 6 3 1 3 5 3 1 5 
260 5 6 5 5 3 4 6 4 6 3 1 3 5 4 2 
260 5 6 5 5 3 4 6 4 6 3 1 3 2 4 2 
260 5 6 5 5 3 4 6 4 6 3 1 3 4 5 2 
260 5 6 5 5 3 4 6 4 6 3 1 3 5 1 2 
260 5 6 5 5 3 4 6 4 6 3 1 3 1 5 2 
260 5 6 5 5 3 4 6 4 6 3 1 4 5 3 2 
260 5 6 5 5 3 4 6 4 6 3 1 3 5 1 2 
255 5 6 5 5 3 4 6 4 6 3 1 1 3 3 1 6 
255 5 6 5 5 3 4 6 4 6 3 1 4 5 5 
255 5 6 5 5 3 4 6 4 6 3 1 5 1 2 
255 5 6 5 5 3 4 6 4 6 3 1 2 1 2 
255 5 6 5 5 3 4 6 4 6 3 1 5 5 1 
250 5 6 5 5 3 4 6 4 6 3 1 3 2 6 
250 5 6 5 5 3 4 6 4 6 3 1 3 5 6 
250 5 6 5 5 3 4 6 4 6 3 1 3 6 5 
250 5 6 5 5 3 4 6 4 6 3 1 3 5 6 
250 5 6 5 5 3 4 6 4 6 3 1 3 5 6 
250 5 6 5 5 3 4 6 4 6 3 1 3 5 6 
250 5 6 5 5 3 4 6 4 6 3 1 6 3 5 
250 5 6 5 5 3 4 6 4 6 3 1 3 5 6 
250 5 6 5 5 3 4 6 4 6 3 1 3 6 5 
250 5 6 5 5 3 4 6 4 6 3 1 3 5 6 
250 5 6 5 5 3 4 6 4 6 3 1 3 6 5 
250 5 6 5 5 3 4 6 4 6 3 1 3 5 6 
250 5 6 5 5 3 4 6 4 6 3 1 3 5 6 
250 5 6 5 5 3 4 6 4 6 3 1 6 3 2 
250 5 6 5 5 3 4 6 4 6 3 1 3 5 6 
250 5 6 5 5 3 4 6 4 6 3 1 3 6 5 
250 5 6 5 5 3 4 6 4 6 3 1 3 5 6 
245 5 6 5 5 3 4 6 4 6 3 1 5 6 
245 5 6 5 5 3 4 6 4 6 3 1 1 6 4 
245 5 6 5 5 3 4 6 4 6 3 1 6 2 
245 5 6 5 5 3 4 6 4 6 3 1 6 1 4 
245 5 6 5 5 3 4 6 4 6 3 1 6 2 
245 5 6 5 5 3 4 6 4 6 3 1 2 6 
245 5 6 5 5 3 4 6 4 6 3 1 3 5 3 3 2 
245 5 6 5 5 3 4 6 4 6 3 1 2 6 
240 5 6 5 5 3 4 6 4 6 3 1 3 5 3 1 4 
240 5 6 5 5 3 4 6 4 6 3 1 3 5 3 2 
240 5 6 5 5 3 4 6 4 6 3 1 3 1 4 3 1 4 
240 5 6 5 5 3 4 6 4 6 3 1 3 5 3 2 
240 5 6 5 5 3 4 6 4 6 3 1 3 1 4 3 2 
240 5 6 5 5 3 4 6 4 6 3 1 3 2 3 2 
240 5 6 5 5 3 4 6 4 6 3 1 3 5 3 5 
235 5 6 5 5 3 4 6 4 6 3 1 3 5 2 
235 5 6 5 5 3 4 6 4 6 3 1 3 2 2 
235 5 6 5 5 3 4 6 4 6 3 1 3 5 5 
235 5 6 5 5 3 4 6 4 6 3 1 4 3 2 4 
235 5 6 5 5 3 4 6 4 6 3 1 3 5 5 
235 5 6 5 5 3 4 6 4 6 3 1 3 5 2 
235 5 6 5 5 3 4 6 4 6 3 1 3 5 5 
235 5 6 5 5 3 4 6 4 6 3 1 3 2 5 
235 5 6 5 5 3 4 6 4 6 3 1 1 1 3 5 
235 5 6 5 5 3 4 6 4 6 3 1 3 5 2 
235 5 6 5 5 3 4 6 4 6 3 1 5 4 1 3 
235 5 6 5 5 3 4 6 4 6 3 1 3 5 4 4 
235 5 6 5 5 3 4 6 4 6 3 1 3 5 5 
235 5 6 5 5 3 4 6 4 6 3 1 3 2 2 
235 5 6 5 5 3 4 6 4 6 3 1 3 5 5 
235 5 6 5 5 3 4 6 4 6 3 1 3 5 1 1 
235 5 6 5 5 3 4 6 4 6 3 1 3 1 2 4 
235 5 6 5 5 3 4 6 4 6 3 1 3 5 1 1 
235 5 6 5 5 3 4 6 4 6 3 1 3 5 1 1 
235 5 6 5 5 3 4 6 4 6 3 1 3 5 4 4 
235 5 6 5 5 3 4 6 4 6 3 1 3 5 2 
235 5 6 5 5 3 4 6 4 6 3 1 3 5 5 
235 5 6 5 5 3 4 6 4 6 3 1 3 5 2 
235 5 6 5 5 3 4 6 4 6 3 1 3 4 1 1 1 
235 5 6 5 5 3 4 6 4 6 3 1 1 3 1 5 
235 5 6 5 5 3 4 6 4 6 3 1 3 5 1 1 
235 5 6 5 5 3 4 6 4 6 3 1 3 2 2 
235 5 6 5 5 3 4 6 4 6 3 1 3 2 2 
235 5 6 5 5 3 4 6 4 6 3 1 3 5 5 
235 5 6 5 5 3 4 6 4 6 3 1 3 5 4 1 
235 5 6 5 5 3 4 6 4 6 3 1 3 5 2 
235 5 6 5 5 3 4 6 4 6 3 1 3 5 5 
235 5 6 5 5 3 4 6 4 6 3 1 3 4 2 1 
235 5 6 5 5 3 4 6 4 6 3 1 4 1 3 4 4 
235 5 6 5 5 3 4 6 4 6 3 1 3 5 2 
235 5 6 5 5 3 4 6 4 6 3 1 3 5 2 
235 5 6 5 5 3 4 6 4 6 3 1 3 5 5 
235 5 6 5 5 3 4 6 4 6 3 1 3 5 5 
235 5 6 5 5 3 4 6 4 6 3 1 3 5 5 
235 5 6 5 5 3 4 6 4 6 3 1 3 5 5 
230 5 6 5 5 3 4 6 4 6 3 1 3 6 3 4 
230 5 6 5 5 3 4 6 4 6 3 1 3 6 3 1 
225 5 6 5 5 3 4 6 4 6 3 1 4 3 6 
225 5 6 5 5 3 4 6 4 6 3 1 3 4 6 
225 5 6 5 5 3 4 6 4 6 3 1 3 6 1 
225 5 6 5 5 3 4 6 4 6 3 1 3 4 6 
225 5 6 5 5 3 4 6 4 6 3 1 3 6 1 
225 5 6 5 5 3 4 6 4 6 3 1 6 3 4 
225 5 6 5 5 3 4 6 4 6 3 1 3 1 6 
225 5 6 5 5 3 4 6 4 6 3 1 3 6 1 
220 5 6 5 5 3 4 6 4 6 3 1 3 5 3 4 3 
125 5 6 5 5 3 4 6 4 1 6 
125 5 6 5 5 3 4 5 6 6 
125 5 6 5 5 3 4 5 6 6 
120 5 6 5 5 3 4 5 4 2 2 
120 5 6 5 5 3 4 4 5 2 2 
115 5 6 5 5 3 6 6 6 
115 5 6 5 5 3 6 6 6 
110 5 6 5 5 3 4 6 4 4 5 
105 5 6 5 5 3 5 3 6 6 
100 5 6 5 5 3 4 3 5 2 2 
100 5 6 5 5 3 6 2 6 
95 5 6 5 5 3 4 3 4 5 3 6 
95 5 6 5 5 3 4 5 1 1 5 
95 5 6 5 5 3 5 4 2 5 
95 5 6 5 5 3 4 5 4 1 2 
85 5 6 5 5 3 5 1 4 6 
85 5 6 5 5 3 4 5 4 6 
85 5 6 5 5 3 4 6 5 1 
85 5 6 5 5 3 4 6 4 5 
85 5 6 5 5 3 4 6 4 2 
85 5 6 5 5 3 5 6 5 
85 5 6 5 5 3 4 6 2 4 
85 5 6 5 5 3 4 4 2 6 
85 5 6 5 5 3 4 6 1 2 
85 5 6 5 5 3 4 5 1 6 
80 5 6 5 5 3 4 3 4 2 3 5 
80 5 6 5 5 3 4 4 3 3 2 5 
80 5 6 5 5 3 4 3 6 6 
75 5 6 5 5 3 6 6 4 
75 5 6 5 5 3 4 3 5 2 1 
75 5 6 5 5 3 4 3 4 5 5 
75 5 6 5 5 3 4 3 5 2 4 
75 5 6 5 5 3 6 1 3 3 3 5 
75 5 6 5 5 3 6 1 6 
75 5 6 5 5 3 5 5 3 5 
75 5 6 5 5 3 4 6 6 
75 5 6 5 5 3 4 4 5 3 2 
75 5 6 5 5 3 4 3 5 4 5 
70 5 6 5 5 3 4 5 1 2 
70 5 6 5 5 3 4 5 2 1 
70 5 6 5 5 3 4 3 4 4 3 6 
70 5 6 5 5 3 4 5 2 4 
70 5 6 5 5 3 4 5 1 5 
70 5 6 5 5 3 4 5 1 2 
70 5 6 5 5 3 4 5 2 4 
70 5 6 5 5 5 5 5 3 
65 5 6 5 5 3 4 6 3 5 
65 5 6 5 5 3 4 3 5 6 
65 5 6 5 5 3 4 4 3 6 1 
65 5 6 5 5 3 4 3 6 2 
65 5 6 5 5 3 4 3 5 6 
65 5 6 5 5 3 4 3 4 4 6 
65 5 6 5 5 3 4 3 5 6 
65 5 6 5 5 3 4 3 5 6 
60 5 6 5 5 3 4 3 5 3 5 3 
60 5 6 5 5 3 6 4 1 4 
60 5 6 5 5 3 6 2 1 
60 5 6 5 5 3 6 5 1 
50 5 6 5 5 3 4 5 1 3 1 
50 5 6 5 5 3 4 4 1 4 1 3 
50 5 6 5 5 3 4 4 2 3 4 
50 5 6 5 5 3 4 3 5 1 1 
50 5 6 5 5 3 4 3 4 5 4 
50 5 6 5 5 3 4 3 5 4 1 
40 5 6 5 5 3 4 6 3 4 
40 5 6 5 5 3 4 3 6 4 
40 5 6 5 5 3 6 1 1 3 
40 5 6 5 5 3 4 6 1 3 
35 5 6 5 5 3 4 3 3 5 1 3 
5 5 6 5 5 3 4 3 3 2 
0 5 6 5 5 3 4 3 2 
0 5 6 5 5 3 4 3 4 1 
0 5 6 5 5 3 4 3 2 
0 5 6 5 5 3 4 3 2 
0 5 6 5 5 3 4 3 2 
0 5 6 5 5 3 4 3 2 
0 5 6 5 5 3 4 3 2 
0 5 6 5 5 3 4 3 2 
-5 5 6 5 5 3 4 2 
-5 5 6 5 5 3 4 2 
-5 5 6 5 5 3 4 2 
-10 5 6 5 5 3 6 3 
-15 5 6 5 5 3 6 3 1 4 4 
-15 5 6 5 5 3 4 3 4 3 3 
-15 5 6 5 5 3 6 3 3 5 
-20 5 6 5 5 3 4 3 3 1 
-25 5 6 5 5 3 4 3 1 
-25 5 6 5 5 3 4 3 1 
-25 5 6 5 5 3 4 3 1 
-25 5 6 5 5 3 4 3 1 
-30 5 6 5 5 3 4 1 
-30 5 6 5 5 3 2 
-30 5 6 5 5 3 4 1 
-30 5 6 5 5 3 2 
-30 5 6 5 5 3 2 
-30 5 6 5 5 3 4 1 
-30 5 6 5 5 3 4 1 
-30 5 6 5 5 3 4 1 
-30 5 6 5 5 3 4 1 
-35 5 6 5 5 2 
-35 5 6 5 5 2 
-55 5 6 5 5 3 1 
-55 5 6 5 5 3 1 
-55 5 6 5 5 3 1 
-55 5 6 5 5 3 1 
-55 5 6 5 5 3 1 
-60 5 6 5 5 4 
-60 5 6 5 5 4 
-60 5 6 5 5 4 
-60 5 6 5 5 1 
-60 5 6 5 5 1 
-60 5 6 5 5 4 
-65 2 6 5 5 4 4 3 4 5 2 
-70 5 6 5 6 
-70 5 6 5 6 
-75 5 6 5 5 3 3 
-75 5 6 5 5 3 3 
-75 5 6 5 5 3 3 
-75 5 6 5 5 3 3 
-75 5 6 5 5 3 3 
-75 5 6 5 5 3 3 
-85 5 6 5 2 
-110 2 6 5 4 
-110 5 6 5 1 
-110 5 6 5 4 
-160 5 6 4 
-180 6 5 3 
