225 6 5 5 5 3 4 6 6 2 1 5 4 2 6 6 4 6 1 2 2 1 1 2 1 2 
225 6 5 5 5 3 4 6 6 2 1 5 4 2 6 6 4 6 1 2 2 1 1 2 1 2 3 6 
225 6 5 5 5 3 4 6 6 2 1 5 4 2 6 6 4 6 1 2 2 1 1 2 1 2 
225 6 5 5 5 3 4 6 6 2 1 5 4 2 6 6 4 6 1 2 2 1 1 2 1 2 
225 6 5 5 5 3 4 6 6 2 1 5 4 2 6 6 4 6 1 2 2 1 1 2 1 2 3 
225 6 5 5 5 3 4 6 6 2 1 5 4 2 6 6 4 6 1 2 2 1 1 2 1 2 3 
225 6 5 5 5 3 4 6 6 2 1 5 4 2 6 6 4 6 1 2 2 1 1 2 1 2 3 6 
225 6 5 5 5 3 4 6 6 2 1 5 4 2 6 6 4 6 1 2 2 1 1 2 1 2 3 6 
225 6 5 5 5 3 4 6 6 2 1 5 4 2 6 6 4 6 1 2 2 1 1 2 1 2 3 6 
225 6 5 5 5 3 4 6 6 2 1 5 4 2 6 6 4 6 1 2 2 1 1 2 1 2 3 6 
225 6 5 5 5 3 4 6 6 2 1 5 4 2 6 6 4 6 1 2 2 1 1 2 1 2 3 6 
225 6 5 5 5 3 4 6 6 2 1 5 4 2 6 6 4 6 1 2 2 1 1 2 1 2 3 
225 6 5 5 5 3 4 6 6 2 1 5 4 2 6 6 4 6 1 2 2 1 1 2 1 2 3 6 
225 6 5 5 5 3 4 6 6 2 1 5 4 2 6 6 4 6 1 2 2 1 1 2 1 2 3 
225 6 5 5 5 3 4 6 6 2 1 5 4 2 6 6 4 6 1 2 2 1 1 2 1 2 
225 6 5 5 5 3 4 6 6 2 1 5 4 2 6 6 4 6 1 2 2 1 1 2 1 2 
225 6 5 5 5 3 4 6 6 2 1 5 4 2 6 6 4 6 1 2 2 1 1 2 1 2 3 
225 6 5 5 5 3 4 6 6 2 1 5 4 2 6 6 4 6 1 2 2 1 1 2 1 2 3 6 
225 6 5 5 5 3 4 6 6 2 1 5 4 2 6 6 4 6 1 2 2 1 1 2 1 2 
225 6 5 5 5 3 4 6 6 2 1 5 4 2 6 6 4 6 1 2 2 1 1 2 1 2 3 
225 6 5 5 5 3 4 6 6 2 1 5 4 2 6 6 4 6 1 2 2 1 1 2 1 2 3 
225 6 5 5 5 3 4 6 6 2 1 5 4 2 6 6 4 6 1 2 2 1 1 2 1 2 
225 6 5 5 5 3 4 6 6 2 1 5 4 2 6 6 4 6 1 2 2 1 1 2 1 2 3 
225 6 5 5 5 3 4 6 6 2 1 5 4 2 6 6 4 6 1 2 2 1 1 2 1 2 3 6 
225 6 5 5 5 3 4 6 6 2 1 5 4 2 6 6 4 6 1 2 2 1 1 2 1 2 3 
225 6 5 5 5 3 4 6 6 2 1 5 4 2 6 6 4 6 1 2 2 1 1 2 1 2 3 
225 6 5 5 5 3 4 6 6 2 1 5 4 2 6 6 4 6 1 2 2 1 1 2 
225 6 5 5 5 3 4 6 6 2 1 5 4 2 6 6 4 6 1 2 2 1 1 2 1 1 3 3 2 
225 6 5 5 5 3 4 6 6 2 1 5 4 2 6 6 4 6 1 2 2 1 1 2 
225 6 5 5 5 3 4 6 6 2 1 5 4 2 6 6 4 6 1 2 2 1 1 
225 6 5 5 5 3 4 6 6 2 1 5 4 2 6 6 4 6 1 2 2 1 1 2 1 2 3 
225 6 5 5 5 3 4 6 6 2 1 5 4 2 6 6 4 6 1 2 2 1 1 2 
225 6 5 5 5 3 4 6 6 2 1 5 4 2 6 6 4 6 1 2 2 1 1 2 
225 6 5 5 5 3 4 6 6 2 1 5 4 2 6 6 4 6 1 2 2 1 1 2 
225 6 5 5 5 3 4 6 6 2 1 5 4 2 6 6 4 6 1 2 2 1 1 2 
225 6 5 5 5 3 4 6 6 2 1 5 4 2 6 6 4 6 1 2 2 1 1 2 1 
225 6 5 5 5 3 4 6 6 2 1 5 4 2 6 6 4 6 1 2 2 1 1 2 1 2 
225 6 5 5 5 3 4 6 6 2 1 5 4 2 6 6 4 6 1 2 2 1 
225 6 5 5 5 3 4 6 6 2 1 5 4 2 6 6 4 6 1 2 2 1 1 
225 6 5 5 5 3 4 6 6 2 1 5 4 2 6 6 4 6 1 2 2 1 1 2 
225 6 5 5 5 3 4 6 6 2 1 5 4 2 6 6 4 6 1 2 2 1 
225 6 5 5 5 3 4 6 6 2 1 5 4 2 6 6 4 6 1 2 2 1 1 2 
225 6 5 5 5 3 4 6 6 2 1 5 4 2 6 6 4 6 1 2 2 1 1 2 
225 6 5 5 5 3 4 6 6 2 1 5 4 2 6 6 4 6 1 2 2 1 1 
225 6 5 5 5 3 4 6 6 2 1 5 4 2 6 6 4 6 1 2 2 1 1 
225 6 5 5 5 3 4 6 6 2 1 5 4 2 6 6 4 6 1 2 2 1 1 
225 6 5 5 5 3 4 6 6 2 1 5 4 2 6 6 4 6 1 2 2 1 1 
225 6 5 5 5 3 4 6 6 2 1 5 4 2 6 6 4 6 1 2 2 1 
