640 5 6 5 5 5 5 5 2 3 1 3 4 2 1 1 6 5 6 6 6 1 1 3 
630 5 6 5 5 5 5 5 2 3 1 3 4 2 1 1 6 5 4 6 1 4 2 5 
590 5 6 5 5 5 5 5 2 3 1 3 4 2 1 1 6 1 4 4 5 5 5 4 6 
590 5 6 5 5 5 5 5 2 3 1 3 4 2 1 1 6 6 5 4 2 3 2 3 
455 5 6 5 5 5 5 5 2 3 1 3 4 2 1 1 6 5 2 5 5 1 2 1 
440 5 6 5 5 5 5 5 2 3 1 3 4 2 1 1 6 5 5 
440 5 6 5 5 5 5 5 2 3 1 3 4 2 1 1 6 5 5 
440 5 6 5 5 5 5 5 2 3 1 3 4 2 1 1 6 1 4 2 
440 5 6 5 5 5 5 5 2 3 1 3 4 2 1 1 6 5 5 
440 5 6 5 5 5 5 5 2 3 1 3 4 2 1 1 6 5 5 
440 5 6 5 5 5 5 5 2 3 1 3 4 2 1 1 6 5 2 
430 5 6 5 5 5 5 5 2 3 1 3 4 2 1 1 6 6 1 
430 5 6 5 5 5 5 5 2 3 1 3 4 2 1 1 6 6 4 
430 5 6 5 5 5 5 5 2 3 1 3 4 2 1 1 6 1 6 
430 5 6 5 5 5 5 5 2 3 1 3 4 2 1 1 6 6 1 
420 5 6 5 5 5 5 5 2 3 1 3 4 2 1 1 6 5 5 6 5 2 4 3 3 1 
415 5 6 5 5 5 5 5 2 3 1 3 4 2 1 1 6 4 2 
410 5 6 5 5 5 5 5 2 3 1 3 4 2 1 1 6 5 5 6 5 6 4 6 
395 5 6 5 5 5 5 5 2 3 1 3 4 2 1 1 6 3 2 
395 5 6 5 5 5 5 5 2 3 1 3 4 2 1 1 6 5 3 
325 5 6 5 5 5 5 5 2 3 1 3 4 2 1 1 5 
325 5 6 5 5 5 5 5 2 3 1 3 4 2 1 1 1 4 
320 5 6 5 5 5 5 5 2 3 1 3 4 2 1 1 6 5 5 4 6 5 5 5 
285 5 6 5 5 5 5 5 2 3 1 3 4 2 1 1 6 1 6 4 4 6 
235 5 6 5 5 5 5 5 2 3 1 3 4 2 1 1 6 5 5 6 6 6 
230 5 6 5 5 5 5 5 2 3 1 3 4 2 1 1 6 5 6 6 6 3 
175 5 6 5 5 5 5 5 2 3 1 3 4 2 1 1 6 5 6 3 
175 5 6 5 5 5 5 5 2 3 1 3 4 2 1 1 6 5 5 6 3 
175 5 6 5 5 5 5 5 2 3 1 3 4 2 1 1 6 5 5 6 3 
135 5 6 5 5 5 5 5 2 3 1 3 4 2 1 1 6 5 6 6 
80 5 6 5 5 5 5 5 2 3 1 3 4 2 1 1 6 5 5 5 1 
80 5 6 5 5 5 5 5 2 3 1 3 4 2 1 1 6 5 5 6 4 
80 5 6 5 5 5 5 5 2 3 1 3 4 2 1 1 6 5 5 6 1 1 
80 5 6 5 5 5 5 5 2 3 1 3 4 2 1 1 6 5 5 4 
80 5 6 5 5 5 5 5 2 3 1 3 4 2 1 1 6 5 5 2 4 
75 5 6 5 5 5 5 5 2 3 1 3 4 2 1 1 6 5 5 6 3 
60 5 6 5 5 5 5 5 2 3 1 3 4 2 1 1 6 5 5 3 5 
60 5 6 5 5 5 5 5 2 3 1 3 4 2 1 1 6 5 5 3 1 2 
35 5 6 5 5 5 5 5 2 3 1 3 4 2 1 1 6 5 5 3 1 
15 5 6 5 5 5 5 5 2 3 1 3 4 2 1 1 6 5 3 1 3 
-20 5 6 5 5 5 5 5 2 3 1 3 4 2 1 1 6 5 5 1 
-20 5 6 5 5 5 5 5 2 3 1 3 4 2 1 1 6 5 5 4 
-20 5 6 5 5 5 5 5 2 3 1 3 4 2 1 1 6 5 5 6 1 
-20 5 6 5 5 5 5 5 2 3 1 3 4 2 1 1 6 5 1 
-70 5 6 5 5 5 5 5 2 3 1 3 4 2 1 1 6 
-85 5 6 5 5 5 5 5 2 3 1 3 4 2 1 1 6 5 
-85 5 6 5 5 5 5 5 2 3 1 3 4 2 1 1 6 
-150 5 6 5 5 5 5 5 2 3 1 3 4 2 1 1 6 
