85 6 5 5 3 6 4 1 2 5 
80 6 5 5 3 6 6 3 5 1 
80 6 5 5 3 6 6 3 1 2 
75 6 5 5 3 6 3 6 3 6 
75 6 5 5 3 4 5 4 3 5 2 
75 6 5 5 3 5 4 6 6 
75 6 5 5 3 6 6 1 2 
75 6 5 5 3 5 6 1 6 
75 6 5 5 3 4 5 3 5 2 4 
75 6 5 5 3 6 4 4 6 4 
75 6 5 5 3 6 6 1 2 
75 6 5 5 3 6 6 1 5 
70 6 5 5 3 6 6 3 6 
65 6 5 5 3 6 6 6 
65 6 5 5 3 6 6 6 
65 6 5 5 3 6 6 6 
65 6 5 5 3 6 6 6 
60 6 5 5 3 6 4 1 5 4 
60 6 5 5 3 6 4 2 5 
60 6 5 5 3 6 5 4 1 1 
50 6 5 5 3 6 6 5 
50 6 5 5 3 6 6 2 
50 6 5 5 3 6 6 2 
50 6 5 5 3 6 6 2 
50 6 5 5 3 6 6 5 
50 6 5 5 3 6 6 2 
50 6 5 5 3 6 4 6 4 
50 6 5 5 3 6 6 5 
50 6 5 5 3 6 4 6 4 
50 6 5 5 3 6 6 2 
50 6 5 5 3 6 6 5 
50 6 5 5 3 6 6 2 
45 6 5 5 3 6 4 2 3 3 1 
35 6 5 5 3 6 6 3 1 3 
30 6 5 5 3 6 6 4 3 
30 6 5 5 3 4 3 5 4 4 1 3 4 
-5 6 5 5 3 6 3 4 3 1 
-10 6 5 5 3 4 1 6 3 
-15 6 5 5 3 6 2 
-15 6 5 5 3 6 2 
-15 6 5 5 3 6 2 
-15 6 5 5 3 6 2 
-15 6 5 5 3 6 2 
-20 2 1 5 5 5 5 3 
-20 2 1 5 5 5 5 3 
-25 2 1 5 5 5 2 
-30 6 5 5 3 5 5 
-30 6 5 5 3 4 1 2 
-35 6 5 5 3 6 3 1 
-40 6 5 5 3 6 1 
-40 6 5 5 3 6 1 
-40 6 5 5 3 4 6 
-40 6 5 5 3 6 1 
-50 2 1 5 5 5 4 
-50 6 5 5 3 6 3 3 3 
-60 2 1 5 5 6 
-60 5 4 5 5 6 
-75 2 1 5 5 2 
-75 2 1 5 5 2 
-75 2 1 5 5 2 
-75 2 1 5 5 2 
-80 6 5 5 3 2 
-80 6 5 5 3 2 
-80 6 5 5 3 2 
-80 6 5 5 3 2 
-80 6 5 5 3 2 
-80 6 5 5 3 2 
-100 2 1 5 5 1 
-100 2 1 5 5 1 
-100 2 1 5 5 4 
-100 2 1 5 5 4 
-100 2 1 5 5 1 
-100 2 1 5 5 4 
-105 6 5 5 3 1 
-105 6 5 5 3 1 
-105 6 5 5 3 4 
-105 6 5 5 3 1 
-105 6 5 5 3 1 
-110 2 1 5 6 
-110 2 1 5 6 
-120 2 1 5 5 3 
-125 6 5 5 3 3 
-125 6 5 5 3 3 
-125 2 1 5 2 
-125 2 1 5 2 
-125 2 1 5 2 
-125 6 5 5 3 3 
-125 2 1 5 2 
-150 2 1 5 1 
-150 2 1 5 1 
-150 2 1 5 1 
-150 2 1 5 4 
-150 2 1 5 4 
-150 2 1 5 4 
-150 2 1 5 4 
-155 2 1 3 6 
-160 2 6 1 
-160 2 4 6 
-160 2 1 6 
-160 5 1 6 
-160 2 1 6 
-165 5 3 3 5 1 
-165 5 3 3 5 1 
-170 5 1 5 3 
-170 6 6 
-170 2 1 5 3 
-170 2 1 5 3 
-170 2 1 5 3 
-175 2 1 2 
-175 3 3 4 1 6 
-175 1 4 4 2 
-175 2 1 2 
-175 2 1 2 
-175 2 1 2 
-175 2 1 2 
-195 2 3 5 
-195 2 1 3 4 
-200 2 5 
-200 2 1 4 
-200 2 1 4 
-200 2 1 4 
-200 2 2 
-200 1 2 1 
-200 1 2 4 
-200 2 1 4 
-200 2 1 1 
-200 5 2 
-215 4 3 2 3 
