610 4 4 6 5 5 6 4 5 5 1 2 1 3 5 3 6 4 5 6 4 6 1 1 3 
330 4 4 6 5 5 6 4 5 5 1 2 1 1 5 2 
310 4 4 6 5 5 6 4 5 5 1 2 1 3 5 5 
305 4 4 6 5 5 6 4 5 5 1 2 1 1 5 1 
295 4 4 6 5 5 6 4 5 5 1 2 1 1 6 
280 4 4 6 5 5 6 4 5 5 1 2 1 1 2 
270 4 4 6 5 5 6 4 5 5 1 2 1 6 
255 4 4 6 5 5 6 4 5 5 1 2 4 4 1 
255 4 4 6 5 5 6 4 5 5 1 2 4 5 
255 4 4 6 5 5 6 4 5 5 1 2 1 5 
255 4 4 6 5 5 6 4 5 5 1 2 5 4 
255 4 4 6 5 5 6 4 5 5 1 2 4 2 
235 4 4 6 5 5 6 4 5 5 1 2 1 3 1 
235 4 4 6 5 5 6 4 5 5 1 2 3 2 
235 4 4 6 5 5 6 4 5 5 1 2 5 3 
235 4 4 6 5 5 6 4 5 5 1 2 1 1 3 
40 4 4 6 5 5 6 3 3 1 4 
-35 4 4 6 5 5 2 
-110 4 4 6 5 1 
-120 4 4 6 6 
-130 4 4 6 5 3 
-135 4 4 6 2 
-160 4 4 6 1 
-160 4 4 6 1 
-160 4 4 4 6 
-160 4 4 6 4 
-180 4 4 6 3 
-180 4 4 6 3 
-180 4 4 6 3 
-200 4 4 1 4 
