-15 4 1 6 5 5 6 3 3 1 
-15 4 1 6 5 5 6 3 3 1 
-15 4 1 6 5 5 6 3 3 
-15 4 1 6 5 5 6 3 3 
-15 4 1 6 5 5 6 3 3 1 
-15 4 1 6 5 5 6 3 3 
-15 4 1 6 5 5 6 3 3 
-15 4 1 6 5 5 6 3 3 
-15 4 1 6 5 5 6 3 3 1 
-15 4 1 6 5 5 6 3 3 1 5 
-15 4 1 6 5 5 6 3 3 
-15 4 1 6 5 5 6 3 3 1 
-15 4 1 6 5 5 6 3 3 1 
-15 4 1 6 5 5 6 3 3 1 5 
-15 4 1 6 5 5 6 3 3 
-15 4 1 6 5 5 6 3 3 
-15 4 1 6 5 5 6 3 3 1 
-15 4 1 6 5 5 6 3 3 
-15 4 1 6 5 5 6 3 3 
-15 4 1 6 5 5 6 3 3 
-15 4 1 6 5 5 6 3 3 
-15 4 1 6 5 5 6 3 3 1 5 
-15 4 1 6 5 5 6 3 3 1 
-15 4 1 6 5 5 6 3 3 1 
-15 4 1 6 5 5 6 3 3 1 
-15 4 1 6 5 5 6 3 3 1 
-15 4 1 6 5 5 6 3 3 1 
-15 4 1 6 5 5 6 3 3 1 5 
-15 4 1 6 5 5 6 3 3 1 
-15 4 1 6 5 5 6 3 3 
-15 4 1 6 5 5 6 3 3 
-15 4 1 6 5 5 6 3 3 1 
-15 4 1 6 5 5 6 3 3 1 5 
-50 1 2 5 5 5 4 
-85 4 1 6 5 2 
-130 4 1 6 5 3 4 4 5 
-130 4 1 6 5 3 4 4 3 
-130 4 1 6 5 3 4 4 5 
-130 4 1 6 5 3 4 4 5 
-130 4 1 6 5 3 4 4 5 
-130 4 1 6 5 3 4 4 6 
-130 4 1 6 5 3 4 4 5 
-130 4 1 6 5 3 4 4 3 
-130 4 1 6 5 3 4 4 5 
-130 4 1 6 5 3 4 4 5 
-130 4 1 6 5 3 4 4 3 
-130 4 1 6 5 3 4 4 5 6 
-130 4 1 6 5 3 4 4 3 
-130 4 1 6 5 3 4 4 5 6 
-130 4 1 6 5 3 4 4 1 
-130 4 1 6 5 3 4 4 5 
-130 4 1 6 5 3 4 4 6 
-130 4 1 6 5 3 4 4 5 6 
-135 4 1 6 5 3 4 2 
-135 4 1 6 5 3 4 4 
-135 4 1 6 5 3 4 4 
-135 4 1 6 5 3 4 6 
-135 4 1 6 5 3 3 
-135 4 1 6 2 
-135 4 1 6 2 
-135 4 1 6 5 3 4 5 
-175 4 1 1 2 
-200 4 1 2 
-215 4 1 1 3 3 
