335 5 6 5 5 5 5 4 3 2 1 6 1 4 2 2 
320 5 6 5 5 5 5 1 1 5 3 4 4 2 2 5 
315 5 6 5 5 5 5 4 3 2 1 6 6 6 
315 5 6 5 5 5 5 4 3 2 1 6 6 6 
315 5 6 5 5 5 5 4 3 2 1 6 6 6 
315 5 6 5 5 5 5 4 3 2 1 6 6 6 
315 5 6 5 5 5 5 4 3 2 1 6 6 6 
315 5 6 5 5 5 5 4 3 2 1 6 6 6 
315 5 6 5 5 5 5 4 3 2 1 6 6 6 
315 5 6 5 5 5 5 4 3 2 1 6 6 6 
315 5 6 5 5 5 5 4 3 2 1 6 6 6 
315 5 6 5 5 5 5 4 3 2 1 6 6 6 
315 5 6 5 5 5 5 4 3 2 1 6 6 6 
310 5 6 5 5 5 5 4 3 2 1 6 3 3 6 2 
305 5 6 5 5 5 5 4 3 2 1 6 2 3 6 
300 5 6 5 5 5 5 4 3 2 1 6 6 5 
300 5 6 5 5 5 5 4 3 2 1 6 6 5 
300 5 6 5 5 5 5 4 3 2 1 3 4 2 1 4 2 
300 5 6 5 5 5 5 4 3 2 1 6 6 2 
300 5 6 5 5 5 5 4 3 2 1 6 6 2 
300 5 6 5 5 5 5 4 3 2 1 6 6 2 
300 5 6 5 5 5 5 4 3 2 1 6 6 5 
300 5 6 5 5 5 5 4 3 2 1 6 6 5 
300 5 6 5 5 5 5 4 3 2 1 6 6 5 
300 5 6 5 5 5 5 4 3 2 1 6 6 5 
300 5 6 5 5 5 5 4 3 2 1 6 6 5 
300 5 6 5 5 5 5 4 3 2 1 6 6 2 
300 5 6 5 5 5 5 4 3 2 1 6 6 2 
295 5 6 5 5 5 5 4 3 2 1 6 3 4 3 4 2 
295 5 6 5 5 5 5 4 3 2 1 5 6 3 3 2 
290 5 6 5 5 5 5 4 3 2 1 2 3 5 6 
290 5 6 5 5 5 5 4 3 2 1 3 2 2 6 
285 5 6 5 5 5 5 4 3 2 1 6 2 5 
285 5 6 5 5 5 5 4 4 6 2 5 3 2 
285 5 6 5 5 5 5 4 3 2 1 6 2 5 
285 5 6 5 5 5 5 4 3 2 1 5 6 2 
280 5 6 5 5 5 5 4 3 2 1 5 3 3 2 5 
280 5 6 5 5 5 5 4 3 2 1 3 3 5 5 5 
280 5 6 5 5 5 5 4 3 2 1 3 2 3 1 4 1 4 4 
275 5 6 5 5 5 5 4 3 2 1 6 6 1 
275 5 6 5 5 5 5 4 3 2 1 4 6 6 
275 5 6 5 5 5 5 4 3 2 1 6 6 1 
275 5 6 5 5 5 5 4 3 2 1 6 4 6 
275 5 6 5 5 5 5 4 3 2 1 6 1 6 
275 5 6 5 5 5 5 4 3 2 1 6 6 4 
275 5 6 5 5 5 5 4 3 2 1 6 6 1 
275 5 6 5 5 5 5 4 3 2 1 6 6 1 
270 5 6 5 5 5 5 4 3 2 1 6 3 3 2 4 
270 5 6 5 5 5 5 4 3 2 1 2 5 5 
270 5 6 5 5 5 5 4 3 2 1 6 3 3 2 4 
270 5 6 5 5 5 5 4 3 2 1 4 1 3 4 3 6 
270 5 6 5 5 5 5 4 3 2 1 5 1 5 4 
270 5 6 5 5 5 5 4 4 6 5 1 6 
265 5 6 5 5 5 5 4 3 2 1 6 3 2 4 
265 5 6 5 5 5 5 4 3 2 1 6 3 1 5 
265 5 6 5 5 5 5 4 3 2 1 3 3 3 6 6 
265 5 6 5 5 5 5 4 3 2 1 6 3 2 1 
265 5 6 5 5 5 5 4 3 2 1 6 3 5 4 
265 5 6 5 5 5 5 4 3 2 1 3 5 6 1 
260 5 6 5 5 5 5 4 3 2 1 6 4 4 1 
260 5 6 5 5 5 5 4 3 2 1 6 4 5 
260 5 6 5 5 5 5 4 3 2 1 6 4 5 
260 5 6 5 5 5 5 4 3 2 1 6 4 2 
260 5 6 5 5 5 5 4 3 2 1 1 4 2 3 3 3 4 
255 5 6 5 5 5 5 4 3 2 1 6 6 3 
255 5 6 5 5 5 5 4 3 2 1 6 6 3 
255 5 6 5 5 5 5 4 3 2 1 6 6 3 
250 5 6 5 5 5 5 4 3 2 1 6 3 3 3 5 
130 5 6 5 5 5 5 2 6 
115 5 6 5 5 6 3 6 6 
115 5 6 5 5 5 5 2 2 
115 5 6 5 5 5 5 2 2 
110 5 6 5 5 5 5 3 4 6 
105 5 6 5 5 5 5 4 6 
105 5 6 5 5 5 6 1 5 
105 5 6 5 5 5 5 4 6 
100 5 6 5 5 5 6 3 6 
100 5 6 5 5 3 6 2 6 
95 5 6 5 5 5 5 3 4 5 
95 5 6 5 5 6 5 6 
95 5 6 5 5 5 4 3 4 4 5 
90 5 6 5 5 5 5 2 4 
90 5 6 5 5 5 5 1 4 1 
90 5 6 5 5 5 4 4 2 4 
90 5 6 5 5 5 5 1 5 
85 5 6 5 5 3 5 6 2 
80 5 6 5 5 5 6 2 
80 5 6 5 5 5 6 2 
80 5 6 5 5 5 6 1 1 
80 5 6 5 5 5 5 6 
80 5 6 5 5 6 5 5 
75 5 6 5 5 3 5 3 2 2 
70 5 6 5 5 5 5 1 3 1 
70 5 6 5 5 5 4 3 2 1 
70 5 6 5 5 3 5 5 5 
70 5 6 5 5 5 5 3 5 
70 5 6 5 5 5 5 3 5 
70 5 6 5 5 3 6 4 3 3 2 
70 5 6 5 5 5 5 3 2 
70 5 6 5 5 3 5 1 4 4 4 
70 5 6 5 5 5 5 3 2 
70 5 6 5 5 5 5 3 2 
70 5 6 5 5 6 3 4 3 2 3 
60 5 6 5 5 5 6 4 3 
60 5 6 5 5 3 6 1 4 4 
60 5 6 5 5 6 3 1 2 
15 5 6 5 5 5 2 
15 5 6 5 5 5 2 
15 5 6 5 5 5 2 
15 5 6 5 5 5 4 1 
-10 5 6 5 5 5 1 
-10 5 6 5 5 5 1 
-30 5 6 5 5 5 3 5 
-30 5 6 5 5 5 3 
-30 5 6 5 5 3 2 
-30 5 6 5 5 5 3 2 
-35 5 6 5 5 2 
-60 5 6 5 5 1 
-60 5 6 5 5 1 
-70 5 6 5 6 
-70 5 6 5 6 
-110 5 6 5 1 
-110 5 6 5 4 
-110 5 6 5 4 
-110 5 6 5 1 
-120 5 6 6 
-120 5 6 6 
-160 5 6 1 
