110 6 5 5 3 6 4 1 4 5 5 
110 6 5 5 3 6 4 4 4 5 2 
110 6 5 5 3 6 4 1 4 5 5 
110 6 5 5 3 6 4 1 4 5 5 
110 6 5 5 3 6 4 1 4 5 2 
110 6 5 5 3 6 4 1 4 5 2 
100 6 5 5 3 6 4 1 6 2 
100 6 5 5 3 6 4 1 5 6 
100 6 5 5 3 6 4 1 6 5 
100 6 5 5 3 6 4 1 2 6 
85 6 5 5 3 6 4 1 1 4 2 
85 6 5 5 3 6 4 1 2 5 
85 6 5 5 3 6 4 1 4 5 4 
85 6 5 5 3 6 4 1 4 2 1 
85 6 5 5 3 6 4 1 4 1 2 
85 6 5 5 3 6 4 1 4 5 4 
85 6 5 5 3 6 4 1 4 5 4 
85 6 5 5 3 6 4 1 4 2 4 
85 6 5 5 3 6 4 1 1 1 5 
85 6 5 5 3 6 4 1 4 1 2 
85 6 5 5 3 6 4 3 3 6 5 
85 6 5 5 3 6 4 1 4 5 4 
80 6 5 5 3 6 4 3 2 6 
75 6 5 5 3 6 4 6 2 
75 6 5 5 3 6 4 1 1 6 
75 6 5 5 3 6 4 1 4 6 
75 6 5 5 3 6 4 1 6 1 
75 6 5 5 3 6 4 1 6 4 
75 6 5 5 3 6 4 1 4 6 
65 6 5 5 3 6 4 1 4 3 4 1 6 
65 6 5 5 3 6 4 1 4 5 3 
65 6 5 5 3 6 4 1 4 4 3 1 
65 6 5 5 3 6 4 5 2 3 
65 6 5 5 3 6 4 1 4 5 3 
65 6 5 5 3 6 4 1 1 3 5 
60 6 5 5 3 6 4 4 5 4 
60 6 5 5 3 6 4 1 4 1 4 
60 6 5 5 3 6 4 4 5 1 
60 6 5 5 3 6 4 5 1 4 
60 6 5 5 3 6 4 4 2 1 
60 6 5 5 3 6 4 1 4 1 4 
60 6 5 5 3 6 4 2 1 1 
30 6 5 5 3 6 4 6 3 
-10 6 5 5 3 6 4 1 3 
-10 6 5 5 3 6 4 1 3 
-10 6 5 5 3 6 4 4 3 4 
-10 6 5 5 3 6 4 1 3 
-15 6 5 5 3 6 2 
