245 6 5 5 3 6 4 1 4 3 2 5 3 1 5 1 4 4 
115 6 5 5 3 6 4 1 6 6 
110 6 5 5 3 6 4 1 4 2 2 
110 6 5 5 3 5 6 4 2 5 
100 2 1 5 5 5 5 5 5 1 
100 6 5 5 3 6 4 2 4 6 
100 6 5 5 3 6 4 1 5 6 
100 6 5 5 3 6 4 1 2 6 
100 6 5 5 3 6 4 2 4 6 
100 6 5 5 3 6 4 1 5 6 
100 6 5 5 3 6 4 1 6 2 
100 6 5 5 3 6 4 1 2 6 
100 6 5 5 3 6 4 1 2 6 
100 6 5 5 3 6 4 1 2 6 
100 6 5 5 3 6 4 2 4 6 
95 5 4 5 5 5 6 3 5 5 
90 6 5 5 3 6 6 1 6 
85 6 5 5 3 6 4 1 2 5 
85 6 5 5 3 6 4 1 2 2 
85 6 5 5 3 6 4 1 2 2 
85 6 5 5 3 6 4 1 4 2 4 
85 6 5 5 3 6 4 1 2 2 
85 6 5 5 3 6 4 1 2 2 
85 6 5 5 3 6 4 1 2 2 
85 6 5 5 3 6 4 1 2 5 
85 6 5 5 3 6 4 1 2 2 
85 6 5 5 3 6 4 1 1 4 5 
85 6 5 5 3 6 4 1 5 2 
85 6 5 5 3 6 4 1 2 2 
85 6 5 5 3 6 4 1 5 5 
85 6 5 5 3 6 5 2 2 
85 6 5 5 3 6 4 5 5 1 
85 6 5 5 3 6 4 1 5 5 
85 6 5 5 3 6 4 1 2 2 
85 6 5 5 3 6 5 4 1 5 
80 6 5 5 3 6 3 5 4 6 
80 6 5 5 3 6 4 3 5 6 
75 6 5 5 3 6 4 5 6 
75 6 5 5 3 4 5 3 5 2 1 
75 6 5 5 3 6 4 5 6 
75 6 5 5 3 6 5 4 6 
75 6 5 5 3 4 5 4 5 3 5 
75 6 5 5 3 4 1 4 3 5 1 2 
75 6 5 5 3 6 4 1 6 1 
75 6 5 5 3 6 4 5 6 
75 6 5 5 3 6 6 4 5 
75 6 5 5 3 4 4 6 6 4 
75 6 5 5 3 6 5 1 6 
70 6 5 5 3 6 4 2 3 3 2 
65 6 5 5 3 4 5 4 1 3 6 
65 6 5 5 3 6 4 2 3 2 
65 6 5 5 3 6 4 2 3 5 
65 6 5 5 3 6 4 3 2 5 
65 6 5 5 3 6 6 6 
65 6 5 5 3 6 5 3 5 4 
60 6 5 5 3 6 4 1 2 1 
60 6 5 5 3 6 4 1 2 1 
60 6 5 5 3 6 4 1 2 1 
60 6 5 5 3 6 4 1 2 4 
60 6 5 5 3 6 4 1 1 4 4 
60 6 5 5 3 6 4 1 5 4 
60 6 5 5 3 6 4 1 2 1 
60 6 5 5 3 6 4 1 4 1 1 
60 6 5 5 3 6 4 5 1 4 
60 6 5 5 3 5 4 6 4 1 
60 6 5 5 3 6 4 5 1 4 
60 6 5 5 3 6 4 2 2 
60 6 5 5 3 6 4 1 5 1 
60 6 5 5 3 6 4 1 2 1 
60 6 5 5 3 6 3 6 3 2 
60 6 5 5 3 6 4 1 2 4 
60 6 5 5 3 6 5 2 1 
60 6 5 5 3 6 4 1 2 4 
60 6 5 5 3 6 4 1 2 4 
60 6 5 5 3 6 4 1 2 1 
60 6 5 5 3 6 4 1 2 4 
60 6 5 5 3 6 4 4 2 4 
60 6 5 5 3 6 4 1 2 1 
60 6 5 5 3 6 4 1 2 1 
55 6 5 5 3 6 4 4 6 3 
55 6 5 5 3 6 6 3 5 
50 6 5 5 3 4 3 5 4 4 1 4 
50 6 5 5 3 6 6 2 
50 6 5 5 3 6 6 1 4 
50 6 5 5 3 6 6 2 
50 6 5 5 3 6 6 2 
45 6 5 5 3 6 4 3 3 5 1 
40 6 5 5 3 6 4 1 2 3 
40 6 5 5 3 6 4 1 2 3 
40 6 5 5 3 6 4 1 2 3 
40 6 5 5 3 6 4 1 2 3 
40 6 5 5 3 6 4 1 1 3 1 
40 6 5 5 3 6 4 4 5 3 
30 6 5 5 3 6 6 3 1 
30 6 5 5 3 6 6 3 1 
30 6 5 5 3 6 6 4 3 
20 6 5 5 3 6 3 4 5 3 
20 6 5 5 3 6 4 3 4 1 3 
-5 2 1 5 5 3 6 2 
-10 6 5 5 3 6 4 1 3 
-10 6 5 5 3 6 4 1 3 
-10 6 5 5 3 6 4 1 3 
-10 6 5 5 3 6 4 4 3 
-15 6 5 5 3 6 2 
-15 6 5 5 3 6 2 
-15 6 5 5 3 6 2 
-25 2 1 5 5 5 2 
-35 6 5 5 3 6 3 1 
-35 6 5 5 3 6 3 1 
-40 6 5 5 3 6 1 
-55 6 5 5 3 5 1 
-60 2 1 5 5 6 
-70 6 5 5 6 
-75 2 1 5 5 2 
-80 6 5 5 3 2 
-80 6 5 5 3 2 
-85 6 5 5 2 
-85 6 5 5 2 
-105 6 5 5 3 1 
-125 6 5 5 3 3 
-125 6 5 5 3 3 
-125 6 5 5 3 3 
-135 6 5 2 
-150 2 1 5 1 
-170 2 1 5 3 
-180 6 5 3 
-200 2 1 1 
-200 2 1 1 
