700 2 4 5 5 5 6 4 4 6 6 5 5 6 3 3 5 5 2 3 2 2 1 1 2 6 
635 2 4 5 5 5 6 4 4 6 6 5 5 3 5 5 6 4 3 6 2 5 
630 2 4 5 5 5 6 4 4 6 6 5 5 3 5 3 6 4 4 3 6 6 1 4 
620 2 4 5 5 5 6 4 4 6 6 5 5 3 6 3 5 4 5 2 4 1 5 
610 2 4 5 5 5 6 4 4 6 6 5 5 3 6 6 4 6 6 1 4 
585 2 4 5 5 5 6 4 4 6 6 5 5 3 6 6 4 3 5 5 5 
575 2 4 5 5 5 6 4 4 6 6 5 5 6 6 5 3 2 6 3 
555 2 4 5 5 5 6 4 4 6 6 5 5 6 3 3 6 6 1 5 3 
540 2 4 5 5 5 6 4 4 6 6 5 5 3 6 3 6 5 2 1 3 
465 2 4 5 5 5 6 4 4 6 6 5 5 3 6 4 5 2 
455 2 4 5 5 5 6 4 4 6 6 5 5 3 6 6 2 
450 2 4 5 5 5 6 4 4 6 6 5 5 6 6 2 
450 2 4 5 5 5 6 4 4 6 6 5 5 6 6 2 
425 2 4 5 5 5 6 4 4 6 6 5 5 6 6 1 
425 2 4 5 5 5 6 4 4 6 6 5 5 3 5 5 2 
425 2 4 5 5 5 6 4 4 6 6 5 5 6 6 1 
420 2 4 5 5 5 6 4 4 6 6 5 5 3 6 3 5 1 
405 2 4 5 5 5 6 4 4 6 6 5 5 3 5 3 4 2 
400 2 4 5 5 5 6 4 4 6 6 5 5 3 5 5 1 
400 2 4 5 5 5 6 4 4 6 6 5 5 3 5 5 1 
400 2 4 5 5 5 6 4 4 6 6 5 5 3 5 1 2 
390 2 4 5 5 5 6 4 4 6 6 5 5 3 6 5 
390 2 4 5 5 5 6 4 4 6 6 5 5 6 3 5 
390 2 4 5 5 5 6 4 4 6 6 5 5 3 6 4 1 
390 2 4 5 5 5 6 4 4 6 6 5 5 3 6 5 
390 2 4 5 5 5 6 4 4 6 6 5 5 3 6 2 
385 2 4 5 5 5 6 4 4 6 6 5 5 6 1 4 
385 2 4 5 5 5 6 4 4 6 6 5 5 3 5 5 3 3 
385 2 4 5 5 5 6 4 4 6 6 5 5 6 1 1 
385 2 4 5 5 5 6 4 4 6 6 5 5 6 2 
385 2 4 5 5 5 6 4 4 6 6 5 5 6 5 
385 2 4 5 5 5 6 4 4 6 6 5 5 6 5 
375 2 4 5 5 5 6 4 4 6 6 5 5 3 5 2 
375 2 4 5 5 5 6 4 4 6 6 5 5 3 5 2 
370 2 4 5 5 5 6 4 4 6 6 5 5 3 6 3 1 
365 2 4 5 5 5 6 4 4 6 6 5 5 3 6 1 
365 2 4 5 5 5 6 4 4 6 6 5 5 3 6 1 
365 2 4 5 5 5 6 4 4 6 6 5 5 3 6 1 
360 2 4 5 5 5 6 4 4 6 6 5 5 3 5 1 3 3 
325 2 4 5 5 5 6 4 4 6 6 5 5 3 2 
325 2 4 5 5 5 6 4 4 6 6 5 5 3 2 
325 2 4 5 5 5 6 4 4 6 6 5 5 3 2 
325 2 4 5 5 5 6 4 4 6 6 5 5 3 2 
325 2 4 5 5 5 6 4 4 6 6 5 5 3 2 
325 2 4 5 5 5 6 4 4 6 6 5 5 3 2 
325 2 4 5 5 5 6 4 4 6 6 5 5 3 2 
325 2 4 5 5 5 6 4 4 6 6 5 5 3 2 
325 2 4 5 5 5 6 4 4 6 6 5 5 3 2 
325 2 4 5 5 5 6 4 4 6 6 5 5 3 2 
325 2 4 5 5 5 6 4 4 6 6 5 5 3 2 
320 2 4 5 5 5 6 4 4 6 6 5 5 2 
320 2 4 5 5 5 6 4 4 6 6 5 5 2 
320 2 4 5 5 5 6 4 4 6 6 5 5 5 
320 2 4 5 5 5 6 4 4 6 6 5 5 2 
320 2 4 5 5 5 6 4 4 6 6 5 5 5 
320 2 4 5 5 5 6 4 4 6 6 5 5 2 
320 2 4 5 5 5 6 4 4 6 6 5 5 5 
320 2 4 5 5 5 6 4 4 6 6 5 5 5 
320 2 4 5 5 5 6 4 4 6 6 5 5 5 
320 2 4 5 5 5 6 4 4 6 6 5 5 5 
320 2 4 5 5 5 6 4 4 6 6 5 5 2 
320 2 4 5 5 5 6 4 4 6 6 5 5 5 
320 2 4 5 5 5 6 4 4 6 6 5 5 5 
320 2 4 5 5 5 6 4 4 6 6 5 5 5 
320 2 4 5 5 5 6 4 4 6 6 5 5 2 
320 2 4 5 5 5 6 4 4 6 6 5 5 5 
320 2 4 5 5 5 6 4 4 6 6 5 5 5 
310 2 4 5 5 5 6 4 4 6 1 1 4 3 1 1 5 1 
300 2 4 5 5 5 6 4 4 6 6 5 5 3 4 
300 2 4 5 5 5 6 4 4 6 6 5 5 3 1 
300 2 4 5 5 5 6 4 4 6 6 5 5 3 1 
300 2 4 5 5 5 6 4 4 6 6 5 5 3 1 
300 2 4 5 5 5 6 4 4 6 6 5 5 3 4 
300 2 4 5 5 5 6 4 4 6 6 5 5 3 4 
300 2 4 5 5 5 6 4 4 6 6 5 5 3 4 
300 2 4 5 5 5 6 4 4 6 6 5 5 3 1 
300 2 4 5 5 5 6 4 4 6 6 5 5 3 4 
300 2 4 5 5 5 6 4 4 6 6 5 5 3 1 
300 2 4 5 5 5 6 4 4 6 6 5 5 3 1 
300 2 4 5 5 5 6 4 4 6 6 5 5 3 4 
300 2 4 5 5 5 6 4 4 6 6 5 5 3 4 
300 2 4 5 5 5 6 4 4 6 6 5 5 3 4 
300 2 4 5 5 5 6 4 4 6 6 5 5 3 1 
300 2 4 5 5 5 6 4 4 6 6 5 5 3 1 
300 2 4 5 5 5 6 4 4 6 6 5 5 3 4 
295 2 4 5 5 5 6 4 4 6 6 5 5 4 
295 2 4 5 5 5 6 4 4 6 6 5 5 4 
295 2 4 5 5 5 6 4 4 6 6 5 5 4 
295 2 4 5 5 5 6 4 4 6 6 5 5 4 
295 2 4 5 5 5 6 4 4 6 6 5 5 4 
295 2 4 5 5 5 6 4 4 6 6 5 5 4 
295 2 4 5 5 5 6 4 4 6 6 5 5 1 
295 2 4 5 5 5 6 4 4 6 6 5 5 1 
295 2 4 5 5 5 6 4 4 6 6 5 5 4 
295 2 4 5 5 5 6 4 4 6 6 5 5 4 
295 2 4 5 5 5 6 4 4 6 6 5 5 1 
295 2 4 5 5 5 6 4 4 6 6 5 5 4 
295 2 4 5 5 5 6 4 4 6 6 5 5 1 
295 2 4 5 5 5 6 4 4 6 6 5 5 1 
295 2 4 5 5 5 6 4 4 6 6 5 5 1 
295 2 4 5 5 5 6 4 4 6 6 5 5 4 
295 2 4 5 5 5 6 4 4 6 6 5 5 1 
295 2 4 5 5 5 6 4 4 6 6 5 5 1 
295 2 4 5 5 5 6 4 4 6 6 5 5 4 
295 2 4 5 5 5 6 4 4 6 6 5 5 1 
295 2 4 5 5 5 6 4 4 6 6 5 5 4 
295 2 4 5 5 5 6 4 4 6 6 5 5 4 
295 2 4 5 5 5 6 4 4 6 6 5 5 1 
295 2 4 5 5 5 6 4 4 6 6 5 5 4 
295 2 4 5 5 5 6 4 4 6 6 5 5 1 
295 2 4 5 5 5 6 4 4 6 6 5 5 4 
285 2 4 5 5 5 6 4 4 6 6 5 6 
285 2 4 5 5 5 6 4 4 6 6 5 6 
285 2 4 5 5 5 6 4 4 6 6 5 6 
285 2 4 5 5 5 6 4 4 6 6 5 6 
285 2 4 5 5 5 6 4 4 6 1 1 5 3 1 2 
285 2 4 5 5 5 6 4 4 6 6 5 6 
285 2 4 5 5 5 6 4 4 6 6 5 6 
285 2 4 5 5 5 6 4 4 6 6 5 6 
280 2 4 5 5 5 6 4 4 6 6 5 5 3 3 
280 2 4 5 5 5 6 4 4 6 6 5 5 3 3 
280 2 4 5 5 5 6 4 4 6 6 5 5 3 3 
280 2 4 5 5 5 6 4 4 6 6 5 5 3 3 
280 2 4 5 5 5 6 4 4 6 6 5 5 3 3 
280 2 4 5 5 5 6 4 4 6 6 5 5 3 3 
280 2 4 5 5 5 6 4 4 6 6 5 5 3 3 
275 2 4 5 5 5 6 4 4 6 6 5 3 2 
270 2 4 5 5 5 6 4 4 6 6 5 2 
270 2 4 5 5 5 6 4 4 6 6 5 2 
270 2 4 5 5 5 6 4 4 6 6 5 2 
270 2 4 5 5 5 6 4 4 6 6 5 2 
270 2 4 5 5 5 6 4 4 6 6 5 2 
270 2 4 5 5 5 6 4 4 6 6 5 2 
270 2 4 5 5 5 6 4 4 6 6 5 2 
270 2 4 5 5 5 6 4 4 6 6 5 2 
260 2 4 5 5 5 6 4 4 3 6 6 3 3 4 2 
250 2 4 5 5 5 6 4 4 6 6 5 3 1 
250 2 4 5 5 5 6 4 4 3 6 4 6 5 
250 2 4 5 5 5 6 4 4 6 6 5 3 1 
245 2 4 5 5 5 6 4 4 6 6 5 1 
245 2 4 5 5 5 6 4 4 6 6 5 4 
245 2 4 5 5 5 6 4 4 6 6 5 4 
245 2 4 5 5 5 6 4 4 3 3 6 6 6 
245 2 4 5 5 5 6 4 4 6 6 1 5 
245 2 4 5 5 5 6 4 4 6 6 5 1 
245 2 4 5 5 5 6 4 4 6 6 5 1 
245 2 4 5 5 5 6 4 4 6 6 5 4 
245 2 4 5 5 5 6 4 4 6 6 5 4 
245 2 4 5 5 5 6 4 4 6 6 5 4 
245 2 4 5 5 5 6 4 4 6 6 5 4 
245 2 4 5 5 5 6 4 4 6 6 5 4 
245 2 4 5 5 5 6 4 4 6 6 5 4 
245 2 4 5 5 5 6 4 4 6 6 5 1 
245 2 4 5 5 5 6 4 4 6 6 5 4 
245 2 4 5 5 5 6 4 4 6 6 5 4 
245 2 4 5 5 5 6 4 4 6 6 4 2 
245 2 4 5 5 5 6 4 4 6 6 5 1 
230 2 4 5 5 5 6 4 4 6 6 5 3 3 
130 2 4 5 5 5 6 4 4 4 6 
130 2 4 5 5 5 6 4 4 4 6 
130 2 4 5 5 5 6 4 4 4 6 
125 2 4 5 5 5 6 4 4 4 6 4 
125 2 4 5 5 5 6 4 4 4 6 3 
125 2 4 5 5 5 6 4 4 4 6 1 5 
125 2 4 5 5 5 6 4 4 4 6 1 
125 2 4 5 5 5 6 4 4 4 6 1 3 
125 2 4 5 5 5 6 4 4 4 6 1 
125 2 4 5 5 5 6 4 4 4 6 1 4 
125 2 4 5 5 5 6 4 4 4 6 3 
125 2 4 5 5 5 6 4 4 4 6 1 5 3 
125 2 4 5 5 5 6 4 4 4 6 5 
125 2 4 5 5 5 6 4 4 4 6 1 5 2 
125 2 4 5 5 5 6 4 4 4 6 2 
125 2 4 5 5 5 6 4 4 4 6 1 5 1 
125 2 4 5 5 5 6 4 4 4 6 3 
125 2 4 5 5 5 6 4 4 4 6 1 3 
125 2 4 5 5 5 6 4 4 4 6 1 5 5 
125 2 4 5 5 5 6 4 4 4 6 6 
125 2 4 5 5 5 6 4 4 4 6 1 2 
125 2 4 5 5 5 6 4 4 4 6 5 
125 2 4 5 5 5 6 4 4 4 6 1 
125 2 4 5 5 5 6 4 4 4 6 5 
125 2 4 5 5 5 6 4 4 4 6 1 5 6 
125 2 4 5 5 5 6 4 4 4 6 1 3 
125 2 4 5 5 5 6 4 4 4 6 5 
125 2 4 5 5 5 6 4 4 4 6 2 
125 2 4 5 5 5 6 4 4 4 6 1 5 
125 2 4 5 5 5 6 4 4 4 6 1 4 
125 2 4 5 5 5 6 4 4 4 6 3 
125 2 4 5 5 5 6 4 4 4 6 1 3 
125 2 4 5 5 5 6 4 4 4 6 1 5 
125 2 4 5 5 5 6 4 4 4 6 6 
125 2 4 5 5 5 6 4 4 4 6 1 5 5 
125 2 4 5 5 5 6 4 4 4 6 1 5 1 
125 2 4 5 5 5 6 4 4 4 6 1 1 
125 2 4 5 5 5 6 4 4 4 6 1 
125 2 4 5 5 5 6 4 4 4 6 1 
125 2 4 5 5 5 6 4 4 4 6 1 4 
125 2 4 5 5 5 6 4 4 4 6 1 5 3 
125 2 4 5 5 5 6 4 4 4 6 5 
125 2 4 5 5 5 6 4 4 4 6 1 3 
125 2 4 5 5 5 6 4 4 4 6 1 5 
125 2 4 5 5 5 6 4 4 4 6 1 5 3 
125 2 4 5 5 5 6 4 4 4 6 1 
125 2 4 5 5 5 6 4 4 4 6 2 
125 2 4 5 5 5 6 4 4 4 6 3 
125 2 4 5 5 5 6 4 4 4 6 3 
125 2 4 5 5 5 6 4 4 4 6 2 
125 2 4 5 5 5 6 4 4 4 6 3 
125 2 4 5 5 5 6 4 4 4 6 1 
125 2 4 5 5 5 6 4 4 4 6 1 
125 2 4 5 5 5 6 4 4 4 6 1 5 1 
125 2 4 5 5 5 6 4 4 4 6 1 
125 2 4 5 5 5 6 4 4 4 6 1 5 1 
125 2 4 5 5 5 6 4 4 4 6 6 
125 2 4 5 5 5 6 4 4 4 6 1 2 
125 2 4 5 5 5 6 4 4 4 6 1 5 3 
125 2 4 5 5 5 6 4 4 4 6 2 
125 2 4 5 5 5 6 4 4 4 6 3 
125 2 4 5 5 5 6 4 4 4 6 1 5 2 
125 2 4 5 5 5 6 4 4 4 6 2 
125 2 4 5 5 5 6 4 4 4 6 1 6 
125 2 4 5 5 5 6 4 4 4 6 3 
125 2 4 5 5 5 6 4 4 4 6 1 3 
125 2 4 5 5 5 6 4 4 4 6 2 
125 2 4 5 5 5 6 4 4 4 6 4 
125 2 4 5 5 5 6 4 4 4 6 2 
125 2 4 5 5 5 6 4 4 4 6 1 5 
125 2 4 5 5 5 6 4 4 4 6 1 3 
125 2 4 5 5 5 6 4 4 4 6 6 
125 2 4 5 5 5 6 4 4 4 6 1 
125 2 4 5 5 5 6 4 4 4 6 3 
125 2 4 5 5 5 6 4 4 4 6 5 
125 2 4 5 5 5 6 4 4 4 6 1 4 
125 2 4 5 5 5 6 4 4 4 6 1 
125 2 4 5 5 5 6 4 4 4 6 2 
125 2 4 5 5 5 6 4 4 4 6 1 
125 2 4 5 5 5 6 4 4 4 6 1 5 6 
125 2 4 5 5 5 6 4 4 4 6 1 
125 2 4 5 5 5 6 4 4 4 6 1 4 
125 2 4 5 5 5 6 4 4 4 6 1 5 1 
125 2 4 5 5 5 6 4 4 4 6 2 
125 2 4 5 5 5 6 4 4 4 6 4 
125 2 4 5 5 5 6 4 4 4 6 5 
125 2 4 5 5 5 6 4 4 4 6 5 
125 2 4 5 5 5 6 4 4 4 6 1 4 
125 2 4 5 5 5 6 4 4 4 6 6 
125 2 4 5 5 5 6 4 4 4 6 3 
125 2 4 5 5 5 6 4 4 4 6 1 4 
125 2 4 5 5 5 6 4 4 4 6 2 
125 2 4 5 5 5 6 4 4 4 6 1 5 
125 2 4 5 5 5 6 4 4 4 6 4 
125 2 4 5 5 5 6 4 4 4 6 1 1 
125 2 4 5 5 5 6 4 4 4 6 1 6 
125 2 4 5 5 5 6 4 4 4 6 5 
125 2 4 5 5 5 6 4 4 4 6 1 5 3 
125 2 4 5 5 5 6 4 4 4 6 2 
125 2 4 5 5 5 6 4 4 4 6 3 
125 2 4 5 5 5 6 4 4 4 6 1 5 6 
115 2 4 5 5 5 6 4 4 4 5 
115 2 4 5 5 5 6 4 4 1 5 
115 2 4 5 5 5 6 4 5 2 
115 2 4 5 5 5 6 4 4 4 5 
115 2 4 5 5 5 6 4 4 4 5 
115 2 4 5 5 5 6 4 4 4 5 
115 2 4 5 5 5 6 4 4 4 2 
115 2 4 5 5 5 6 4 4 4 5 
115 2 4 5 5 5 6 4 4 4 2 
115 2 4 5 5 5 6 4 4 4 2 
90 2 4 5 5 5 6 4 4 4 4 
90 2 4 5 5 5 6 4 4 2 
90 2 4 5 5 5 6 4 4 2 
90 2 4 5 5 5 6 4 4 4 4 
90 2 4 5 5 5 6 4 4 4 1 
90 2 4 5 5 5 6 4 4 4 1 
90 2 4 5 5 5 6 4 4 4 4 
90 2 4 5 5 5 6 4 4 4 1 
90 2 4 5 5 5 6 4 4 4 4 
90 2 4 5 5 5 6 4 4 2 
90 2 4 5 5 5 6 4 4 2 
90 2 4 5 5 5 6 4 4 4 1 
90 2 4 5 5 5 6 4 4 2 
90 2 4 5 5 5 6 4 4 4 1 
90 2 4 5 5 5 6 4 4 2 
90 2 4 5 5 5 6 4 4 4 1 
90 2 4 5 5 5 6 4 4 5 
90 2 4 5 5 5 6 4 4 4 1 
90 2 4 5 5 5 6 4 4 4 1 
90 2 4 5 5 5 6 4 4 4 4 
90 2 4 5 5 5 6 4 4 4 4 
70 2 4 5 5 5 6 4 4 4 3 
70 2 4 5 5 5 6 4 4 4 3 
70 2 4 5 5 5 6 4 4 4 3 
70 2 4 5 5 5 6 4 4 3 1 
70 2 4 5 5 5 6 4 4 4 3 
70 2 4 5 5 5 6 4 4 4 3 
70 2 4 5 5 5 6 4 4 4 3 
70 2 4 5 5 5 6 4 4 4 3 
70 2 4 5 5 5 6 4 4 4 3 
70 2 4 5 5 5 6 4 4 4 3 
