245 4 5 5 5 5 3 5 1 4 3 6 6 4 2 3 1 
145 4 5 5 5 5 3 5 5 2 6 
135 4 5 5 5 5 3 6 4 4 1 6 
130 4 5 5 5 5 3 5 5 2 5 
130 4 5 5 5 5 3 5 5 2 5 
130 4 5 5 5 5 3 5 5 5 5 
130 4 5 5 5 5 3 5 5 2 2 
130 4 5 5 5 5 3 5 5 5 2 
120 4 5 5 5 5 3 5 4 6 2 
120 4 5 5 5 5 3 5 1 2 6 
120 4 5 5 5 5 3 5 1 5 6 
120 4 5 5 5 5 3 5 2 1 6 
120 4 5 5 5 5 3 5 1 6 2 
115 4 5 5 5 5 6 3 4 4 3 6 
110 4 5 5 5 5 3 6 6 2 
110 4 5 5 5 5 3 5 5 4 3 5 
110 4 5 5 5 5 3 5 3 4 5 5 
105 4 5 5 5 5 3 5 5 5 1 
105 4 5 5 5 5 3 5 5 2 1 
105 4 5 5 5 5 6 2 6 
105 4 5 5 5 5 3 5 1 4 5 1 
105 4 5 5 5 5 3 5 5 5 4 
105 4 5 5 5 5 3 5 5 4 4 1 
95 4 5 5 5 5 3 5 5 6 
95 4 5 5 5 5 3 5 1 6 4 
95 4 5 5 5 5 3 5 5 6 
95 4 5 5 5 5 3 5 5 6 
90 4 5 5 5 5 6 2 2 
85 4 5 5 5 5 3 5 5 2 3 
85 4 5 5 5 5 3 5 5 2 3 
85 4 5 5 5 5 3 5 5 2 3 
85 4 5 5 5 5 3 5 5 3 2 
85 4 5 5 5 5 3 5 5 5 3 
85 4 5 5 5 5 3 5 5 5 3 
85 4 5 5 5 5 3 5 3 5 5 
85 4 5 5 5 5 3 5 5 3 5 
85 4 5 5 5 5 3 4 6 6 
80 4 5 5 5 5 3 5 2 2 
80 4 5 5 5 5 3 5 5 1 1 
80 4 5 5 5 5 3 5 5 1 1 
80 4 5 5 5 5 3 5 4 1 5 
60 4 5 5 5 5 3 5 1 5 3 
60 4 5 5 5 5 3 5 5 3 1 
60 4 5 5 5 5 3 5 5 3 1 
60 4 5 5 5 5 3 5 1 1 3 1 
40 4 5 5 5 5 3 5 5 3 3 
-20 4 5 5 5 5 3 2 
-45 4 5 5 5 5 3 1 
