110 6 5 5 3 4 4 5 2 1 6 
110 6 5 5 3 4 4 5 2 4 6 
110 6 5 5 3 4 4 5 2 4 6 
110 6 5 5 3 4 4 5 4 5 6 
110 6 5 5 3 4 4 5 1 2 6 
100 6 5 5 3 4 4 5 6 6 
95 6 5 5 3 4 4 5 2 1 5 
95 6 5 5 3 4 4 5 2 4 5 
95 6 5 5 3 4 4 5 4 4 5 4 
95 6 5 5 3 4 4 5 1 4 1 5 
95 6 5 5 3 4 4 5 2 4 2 
95 6 5 5 3 4 4 5 4 4 4 2 
95 6 5 5 3 4 4 5 2 1 2 
95 6 5 5 3 4 4 5 2 4 2 
95 6 5 5 3 4 4 5 2 4 2 
95 6 5 5 3 4 4 5 5 5 1 
95 6 5 5 3 4 4 5 2 4 2 
90 6 5 5 3 4 4 5 1 1 3 6 
90 6 5 5 3 4 4 5 2 3 6 
85 6 5 5 3 4 4 5 2 6 
85 6 5 5 3 4 4 5 2 6 
85 6 5 5 3 4 4 5 2 6 
85 6 5 5 3 4 4 5 6 2 
85 6 5 5 3 4 4 5 6 2 
85 6 5 5 3 4 4 5 2 6 
85 6 5 5 3 4 4 5 2 6 
85 6 5 5 3 4 4 5 2 6 
70 6 5 5 3 4 4 5 2 5 
70 6 5 5 3 4 4 5 2 1 4 
70 6 5 5 3 4 4 5 2 2 
70 6 5 5 3 4 4 5 1 2 4 
70 6 5 5 3 4 4 5 2 4 1 
70 6 5 5 3 4 4 5 2 1 4 
70 6 5 5 3 4 4 5 2 2 
70 6 5 5 3 4 4 5 2 4 1 
70 6 5 5 3 4 4 5 2 4 1 
70 6 5 5 3 4 4 5 2 4 1 
70 6 5 5 3 4 4 5 2 4 4 
70 6 5 5 3 4 4 5 2 5 
70 6 5 5 3 4 4 5 2 4 1 
70 6 5 5 3 4 4 5 2 1 4 
70 6 5 5 3 4 4 5 4 2 4 
70 6 5 5 3 4 4 5 2 5 
70 6 5 5 3 4 4 5 5 1 1 
70 6 5 5 3 4 4 5 3 3 6 4 
70 6 5 5 3 4 4 5 2 4 4 
70 6 5 5 3 4 4 5 4 1 1 1 
70 6 5 5 3 4 4 5 2 4 1 
70 6 5 5 3 4 4 5 2 4 4 
60 6 5 5 3 4 4 5 6 4 
60 6 5 5 3 4 4 5 6 4 
55 6 5 5 3 4 4 5 1 4 3 4 3 4 
50 6 5 5 3 4 4 5 2 3 1 
50 6 5 5 3 4 4 5 2 4 3 
50 6 5 5 3 4 4 5 2 1 3 
50 6 5 5 3 4 4 5 5 3 4 
50 6 5 5 3 4 4 5 2 3 1 
50 6 5 5 3 4 4 5 2 3 1 
50 6 5 5 3 4 4 5 3 3 6 3 
50 6 5 5 3 4 4 5 2 4 3 
40 6 5 5 3 4 4 5 6 3 
30 6 5 5 3 4 4 5 5 3 3 
0 6 5 5 3 4 4 5 1 3 
-30 6 5 5 3 4 4 2 
