685 5 6 5 5 3 4 6 4 6 3 1 3 1 2 5 6 6 6 2 6 2 6 
680 5 6 5 5 3 4 6 4 6 3 1 3 1 2 5 6 5 5 6 5 2 1 6 
675 5 6 5 5 3 4 6 4 6 3 1 3 1 2 5 6 6 5 1 4 4 3 6 1 6 
645 5 6 5 5 3 4 6 4 6 3 1 3 1 2 5 6 6 5 6 5 1 6 
640 5 6 5 5 3 4 6 4 6 3 1 3 1 2 5 6 1 5 6 3 4 3 4 2 6 
635 5 6 5 5 3 4 6 4 6 3 1 3 1 2 5 6 4 4 4 5 3 6 6 1 1 6 
620 5 6 5 5 3 4 6 4 6 3 1 3 1 2 5 6 6 4 4 3 5 4 1 1 5 
620 5 6 5 5 3 4 6 4 6 3 1 3 1 2 5 6 6 6 1 4 5 6 
620 5 6 5 5 3 4 6 4 6 3 1 3 1 2 5 6 6 5 6 5 6 
615 5 6 5 5 3 4 6 4 6 3 1 3 1 2 5 6 6 5 4 1 5 1 5 
605 5 6 5 5 3 4 6 4 6 3 1 3 1 2 5 6 6 6 1 2 1 5 
605 5 6 5 5 3 4 6 4 6 3 1 3 1 2 5 6 3 3 6 4 1 1 6 6 
605 5 6 5 5 3 4 6 4 6 3 1 3 1 2 5 6 6 3 3 4 1 6 6 4 
600 5 6 5 5 3 4 6 4 6 3 1 3 1 2 5 6 6 3 6 1 2 6 
595 5 6 5 5 3 4 6 4 6 3 1 3 1 2 5 6 6 6 4 5 6 
595 5 6 5 5 3 4 6 4 6 3 1 3 1 2 5 6 6 4 5 6 6 
595 5 6 5 5 3 4 6 4 6 3 1 3 1 2 5 6 3 4 6 4 2 1 5 4 
595 5 6 5 5 3 4 6 4 6 3 1 3 1 2 5 6 3 6 3 5 2 1 3 6 
590 5 6 5 5 3 4 6 4 6 3 1 3 1 2 5 6 6 5 2 5 5 
585 5 6 5 5 3 4 6 4 6 3 1 3 1 2 5 6 6 5 3 4 1 6 4 
580 5 6 5 5 3 4 6 4 6 3 1 3 1 2 5 6 6 6 5 4 5 
575 5 6 5 5 3 4 6 4 6 3 1 3 1 2 5 3 3 6 5 5 5 6 4 
575 5 6 5 5 3 4 6 4 6 3 1 3 1 2 5 6 6 3 5 1 3 4 1 4 4 
570 5 6 5 5 3 4 6 4 6 3 1 3 1 2 5 6 6 5 3 2 5 4 
570 5 6 5 5 3 4 6 4 6 3 1 3 1 2 5 6 6 6 3 3 3 5 5 
560 5 6 5 5 3 4 6 4 6 3 1 3 1 2 5 6 6 4 5 3 6 4 
560 5 6 5 5 3 4 6 4 6 3 1 3 1 2 5 6 6 3 5 1 6 4 
555 5 6 5 5 3 4 6 4 6 3 1 3 1 2 5 6 6 4 3 6 6 3 
550 5 6 5 5 3 4 6 4 6 3 1 3 1 2 5 6 6 6 3 6 4 
550 5 6 5 5 3 4 6 4 6 3 1 3 1 2 5 6 6 5 3 5 2 3 
540 5 6 5 5 3 4 6 4 6 3 1 3 1 2 5 6 6 6 2 3 4 3 
475 5 6 5 5 3 4 6 4 6 3 1 3 1 2 5 6 1 4 5 2 
465 5 6 5 5 3 4 6 4 6 3 1 3 1 2 5 6 6 4 2 
465 5 6 5 5 3 4 6 4 6 3 1 3 1 2 5 6 6 4 2 
460 5 6 5 5 3 4 6 4 6 3 1 5 4 4 5 6 4 6 1 
450 5 6 5 5 3 4 6 4 6 3 1 3 5 1 5 6 1 5 2 
450 5 6 5 5 3 4 6 4 6 3 1 3 1 2 5 6 3 3 6 2 
445 5 6 5 5 3 4 6 4 6 3 1 3 1 2 5 3 3 6 5 3 3 2 
440 5 6 5 5 3 4 6 4 6 3 1 3 1 2 5 6 6 2 
440 5 6 5 5 3 4 6 4 6 3 1 3 1 2 5 6 6 2 
440 5 6 5 5 3 4 6 4 6 3 1 3 1 2 5 6 6 2 
440 5 6 5 5 3 4 6 4 6 3 1 3 1 2 5 6 6 2 
440 5 6 5 5 3 4 6 4 6 3 1 3 1 2 5 6 6 2 
440 5 6 5 5 3 4 6 4 6 3 1 3 1 2 5 6 6 2 
440 5 6 5 5 3 4 6 4 6 3 1 3 1 2 5 6 6 4 1 
440 5 6 5 5 3 4 6 4 6 3 1 3 1 2 5 6 6 2 
440 5 6 5 5 3 4 6 4 6 3 1 3 1 2 5 6 6 2 
440 5 6 5 5 3 4 6 4 6 3 1 3 1 2 5 6 6 2 
440 5 6 5 5 3 4 6 4 6 3 1 3 1 2 5 6 6 2 
425 5 6 5 5 3 4 6 4 6 3 1 3 1 2 5 6 1 5 1 
425 5 6 5 5 3 4 6 4 6 3 1 3 1 2 5 6 4 4 2 
420 5 6 5 5 3 4 6 4 6 3 1 3 1 2 5 6 6 3 1 
420 5 6 5 5 3 4 6 4 6 3 1 3 1 2 5 6 6 3 1 
420 5 6 5 5 3 4 6 4 6 3 1 3 1 2 5 6 6 3 1 
415 5 6 5 5 3 4 6 4 6 3 1 3 1 2 5 6 6 1 
415 5 6 5 5 3 4 6 4 6 3 1 3 1 2 5 6 6 1 
415 5 6 5 5 3 4 6 4 6 3 1 3 1 2 5 6 6 1 
415 5 6 5 5 3 4 6 4 6 3 1 3 1 2 5 6 6 1 
415 5 6 5 5 3 4 6 4 6 3 1 3 1 2 5 6 6 1 
415 5 6 5 5 3 4 6 4 6 3 1 3 1 2 5 6 6 1 
415 5 6 5 5 3 4 6 4 6 3 1 3 1 2 5 6 6 1 
415 5 6 5 5 3 4 6 4 6 3 1 3 1 2 5 6 6 1 
415 5 6 5 5 3 4 6 4 6 3 1 3 1 2 5 6 6 1 
415 5 6 5 5 3 4 6 4 6 3 1 3 1 2 5 6 6 1 
400 5 6 5 5 3 4 6 4 6 3 1 3 1 2 5 6 4 2 
400 5 6 5 5 3 4 6 4 6 3 1 3 1 2 5 6 4 2 
400 5 6 5 5 3 4 6 4 6 3 1 3 1 2 5 6 1 4 1 
400 5 6 5 5 3 4 6 4 6 3 1 4 5 1 4 6 3 1 2 
400 5 6 5 5 3 4 6 4 6 3 1 3 1 2 5 6 4 2 
390 5 6 5 5 3 4 6 4 6 3 1 3 1 2 5 3 3 6 3 2 
385 5 6 5 5 3 4 6 4 6 3 1 6 6 5 1 5 
380 5 6 5 5 3 4 6 4 6 3 1 3 1 2 5 6 3 5 
380 5 6 5 5 3 4 6 4 6 3 1 3 1 2 5 6 3 2 
380 5 6 5 5 3 4 6 4 6 3 1 3 1 2 5 6 5 3 
380 5 6 5 5 3 4 6 4 6 3 1 3 1 2 5 6 3 2 
375 5 6 5 5 3 4 6 4 6 3 1 3 1 2 5 6 2 
375 5 6 5 5 3 4 6 4 6 3 1 3 1 2 5 6 2 
375 5 6 5 5 3 4 6 4 6 3 1 3 1 2 5 6 4 1 
375 5 6 5 5 3 4 6 4 6 3 1 3 1 2 5 6 2 
375 5 6 5 5 3 4 6 4 6 3 1 3 1 2 5 6 4 1 
375 5 6 5 5 3 4 6 4 6 3 1 3 1 2 5 6 2 
375 5 6 5 5 3 4 6 4 6 3 1 3 1 2 5 6 2 
375 5 6 5 5 3 4 6 4 6 3 1 3 1 2 5 6 1 1 
375 5 6 5 5 3 4 6 4 6 3 1 3 1 2 5 3 5 1 3 3 4 
370 5 6 5 5 3 4 6 4 6 3 1 3 5 3 6 6 1 1 
355 5 6 5 5 3 4 6 4 6 3 1 3 1 2 5 6 4 3 
355 5 6 5 5 3 4 6 4 6 3 1 3 1 2 5 6 3 1 
310 5 6 5 5 3 4 6 4 6 3 1 3 1 2 5 2 
310 5 6 5 5 3 4 6 4 6 3 1 3 1 2 5 2 
310 5 6 5 5 3 4 6 4 6 3 1 3 1 2 5 2 
310 5 6 5 5 3 4 6 4 6 3 1 3 1 5 5 2 
310 5 6 5 5 3 4 6 4 6 3 1 3 1 2 5 2 
310 5 6 5 5 3 4 6 4 6 3 1 3 1 2 5 2 
310 5 6 5 5 3 4 6 4 6 3 1 3 1 2 5 5 
310 5 6 5 5 3 4 6 4 6 3 1 3 1 2 5 5 
310 5 6 5 5 3 4 6 4 6 3 1 3 1 2 5 5 
310 5 6 5 5 3 4 6 4 6 3 1 3 1 2 5 2 
310 5 6 5 5 3 4 6 4 6 3 1 3 1 2 5 5 
310 5 6 5 5 3 4 6 4 6 3 1 3 1 2 5 2 
310 5 6 5 5 3 4 6 4 6 3 1 3 1 2 5 2 
310 5 6 5 5 3 4 6 4 6 3 1 3 1 2 5 2 
310 5 6 5 5 3 4 6 4 6 3 1 3 1 2 5 2 
310 5 6 5 5 3 4 6 4 6 3 1 1 3 3 1 3 6 2 
310 5 6 5 5 3 4 6 4 6 3 1 3 1 2 5 2 
310 5 6 5 5 3 4 6 4 6 3 1 3 1 2 5 2 
310 5 6 5 5 3 4 6 4 6 3 1 3 1 2 5 2 
310 5 6 5 5 3 4 6 4 6 3 1 3 1 2 5 2 
310 5 6 5 5 3 4 6 4 6 3 1 3 2 4 5 5 
310 5 6 5 5 3 4 6 4 6 3 1 3 1 2 5 5 
310 5 6 5 5 3 4 6 4 6 3 1 3 1 2 5 2 
310 5 6 5 5 3 4 6 4 6 3 1 3 1 2 5 2 
305 5 6 5 5 3 4 6 4 6 3 1 2 4 4 4 5 
305 5 6 5 5 3 4 6 4 6 3 1 1 1 5 4 5 
305 5 6 5 5 3 4 6 4 6 3 1 1 1 2 5 1 
305 5 6 5 5 3 4 6 4 6 3 1 4 5 1 4 5 
305 5 6 5 5 3 4 6 4 6 3 1 1 1 2 4 2 
300 5 6 5 5 3 4 6 4 6 3 1 3 1 4 6 5 
300 5 6 5 5 3 4 6 4 6 3 1 1 1 3 6 2 
295 5 6 5 5 3 4 6 4 6 3 1 4 2 4 6 
295 5 6 5 5 3 4 6 4 6 3 1 1 4 2 6 
295 5 6 5 5 3 4 6 4 6 3 1 4 1 2 6 
295 5 6 5 5 3 4 6 4 6 3 1 1 1 5 6 
290 5 6 5 5 3 4 6 4 6 3 1 3 1 2 5 3 1 
290 5 6 5 5 3 4 6 4 6 3 1 3 1 2 5 3 4 
290 5 6 5 5 3 4 6 4 6 3 1 3 1 2 5 3 1 
290 5 6 5 5 3 4 6 4 6 3 1 3 1 2 5 3 4 
290 5 6 5 5 3 4 6 4 6 3 1 3 1 2 5 3 1 
290 5 6 5 5 3 4 6 4 6 3 1 3 1 2 5 3 4 
285 5 6 5 5 3 4 6 4 6 3 1 3 1 2 5 4 
285 5 6 5 5 3 4 6 4 6 3 1 3 1 2 5 1 
285 5 6 5 5 3 4 6 4 6 3 1 3 1 2 5 4 
285 5 6 5 5 3 4 6 4 6 3 1 3 1 2 5 4 
285 5 6 5 5 3 4 6 4 6 3 1 3 1 2 5 4 
285 5 6 5 5 3 4 6 4 6 3 1 3 5 4 5 1 
285 5 6 5 5 3 4 6 4 6 3 1 3 1 2 5 4 
285 5 6 5 5 3 4 6 4 6 3 1 3 1 2 5 4 
285 5 6 5 5 3 4 6 4 6 3 1 3 1 2 5 4 
285 5 6 5 5 3 4 6 4 6 3 1 3 1 2 5 1 
285 5 6 5 5 3 4 6 4 6 3 1 3 1 2 5 1 
285 5 6 5 5 3 4 6 4 6 3 1 3 1 2 5 1 
285 5 6 5 5 3 4 6 4 6 3 1 3 1 2 5 4 
285 5 6 5 5 3 4 6 4 6 3 1 3 1 2 5 4 
285 5 6 5 5 3 4 6 4 6 3 1 3 1 2 5 1 
285 5 6 5 5 3 4 6 4 6 3 1 3 5 4 5 1 
285 5 6 5 5 3 4 6 4 6 3 1 3 1 2 5 1 
285 5 6 5 5 3 4 6 4 6 3 1 3 1 2 5 1 
285 5 6 5 5 3 4 6 4 6 3 1 3 1 2 5 1 
285 5 6 5 5 3 4 6 4 6 3 1 3 1 2 5 4 
285 5 6 5 5 3 4 6 4 6 3 1 3 1 2 5 1 
285 5 6 5 5 3 4 6 4 6 3 1 3 1 2 5 1 
280 5 6 5 5 3 4 6 4 6 3 1 3 5 3 6 1 
280 5 6 5 5 3 4 6 4 6 3 1 5 2 5 
280 5 6 5 5 3 4 6 4 6 3 1 3 1 2 3 6 
280 5 6 5 5 3 4 6 4 6 3 1 5 5 2 
280 5 6 5 5 3 4 6 4 6 3 1 3 5 3 4 6 
280 5 6 5 5 3 4 6 4 6 3 1 3 5 1 3 6 
280 5 6 5 5 3 4 6 4 6 3 1 5 4 4 2 
280 5 6 5 5 3 4 6 4 6 3 1 3 3 2 1 6 
280 5 6 5 5 3 4 6 4 6 3 1 3 1 1 3 4 6 
275 5 6 5 5 3 4 6 4 6 3 1 3 4 4 6 4 
275 5 6 5 5 3 4 6 4 6 3 1 3 5 4 6 
275 5 6 5 5 3 4 6 4 6 3 1 3 5 1 6 
275 5 6 5 5 3 4 6 4 6 3 1 4 5 3 6 
275 5 6 5 5 3 4 6 4 6 3 1 3 5 1 6 
270 5 6 5 5 3 4 6 4 6 3 1 6 4 2 
270 5 6 5 5 3 4 6 4 6 3 1 6 1 5 
270 5 6 5 5 3 4 6 4 6 3 1 2 4 6 
270 5 6 5 5 3 4 6 4 6 3 1 3 6 3 6 
265 5 6 5 5 3 4 6 4 6 3 1 3 5 3 1 2 
265 5 6 5 5 3 4 6 4 6 3 1 3 6 6 
265 5 6 5 5 3 4 6 4 6 3 1 3 6 6 
265 5 6 5 5 3 4 6 4 6 3 1 3 3 5 4 5 
265 5 6 5 5 3 4 6 4 6 3 1 3 6 6 
265 5 6 5 5 3 4 6 4 6 3 1 3 3 4 2 2 
260 5 6 5 5 3 4 6 4 6 3 1 3 5 1 2 
260 5 6 5 5 3 4 6 4 6 3 1 3 5 4 2 
260 5 6 5 5 3 4 6 4 6 3 1 4 1 3 4 2 
260 5 6 5 5 3 4 6 4 6 3 1 3 1 5 2 
260 5 6 5 5 3 4 6 4 6 3 1 3 1 5 2 
260 5 6 5 5 3 4 6 4 6 3 1 3 4 2 2 
260 5 6 5 5 3 4 6 4 6 3 1 3 5 4 2 
260 5 6 5 5 3 4 6 4 6 3 1 3 5 1 2 
255 5 6 5 5 3 4 6 4 6 3 1 1 4 1 2 
255 5 6 5 5 3 4 6 4 6 3 1 4 5 5 
255 5 6 5 5 3 4 6 4 6 3 1 1 5 5 
255 5 6 5 5 3 4 6 4 6 3 1 2 2 4 
255 5 6 5 5 3 4 6 4 6 3 1 2 2 4 
255 5 6 5 5 3 4 6 4 6 3 1 2 4 2 
255 5 6 5 5 3 4 6 4 6 3 1 2 4 2 
255 5 6 5 5 3 4 6 4 6 3 1 5 4 5 
250 5 6 5 5 3 4 6 4 6 3 1 6 3 2 
250 5 6 5 5 3 4 6 4 6 3 1 3 2 6 
250 5 6 5 5 3 4 6 4 6 3 1 3 5 6 
250 5 6 5 5 3 4 6 4 6 3 1 3 5 6 
250 5 6 5 5 3 4 6 4 6 3 1 3 5 6 
250 5 6 5 5 3 4 6 4 6 3 1 3 5 6 
250 5 6 5 5 3 4 6 4 6 3 1 3 2 6 
250 5 6 5 5 3 4 6 4 6 3 1 6 3 5 
250 5 6 5 5 3 4 6 4 6 3 1 3 6 2 
250 5 6 5 5 3 4 6 4 6 3 1 3 5 6 
245 5 6 5 5 3 4 6 4 6 3 1 4 6 4 
245 5 6 5 5 3 4 6 4 6 3 1 2 6 
245 5 6 5 5 3 4 6 4 6 3 1 6 2 
245 5 6 5 5 3 4 6 4 6 3 1 6 1 4 
245 5 6 5 5 3 4 6 4 6 3 1 1 6 1 
245 5 6 5 5 3 4 6 4 6 3 1 5 6 
245 5 6 5 5 3 4 6 4 6 3 1 1 6 4 
245 5 6 5 5 3 4 6 4 6 3 1 6 2 
245 5 6 5 5 3 4 6 4 6 3 3 2 3 3 1 5 
245 5 6 5 5 3 4 6 4 6 3 1 6 1 4 
245 5 6 5 5 3 4 6 4 6 3 1 4 6 1 
240 5 6 5 5 3 4 6 4 6 3 1 3 3 5 4 4 
240 5 6 5 5 3 4 6 4 6 3 1 3 1 5 3 1 
240 5 6 5 5 3 4 6 4 6 3 1 3 5 3 1 1 
240 5 6 5 5 3 4 6 4 6 3 1 3 2 3 2 
240 5 6 5 5 3 4 6 4 6 3 1 4 3 5 3 1 
240 5 6 5 5 3 4 6 4 6 3 1 3 4 5 3 4 
240 5 6 5 5 3 4 6 4 6 3 1 3 3 2 4 1 
240 5 6 5 5 3 4 6 4 6 3 1 3 4 3 1 5 
240 5 6 5 5 3 4 6 4 6 3 1 3 5 4 3 4 
235 5 6 5 5 3 4 6 4 6 3 1 3 2 5 
235 5 6 5 5 3 4 6 4 6 3 1 3 1 5 1 
235 5 6 5 5 3 4 6 4 6 3 1 3 5 5 
235 5 6 5 5 3 4 6 4 6 3 1 3 5 1 1 
235 5 6 5 5 3 4 6 4 6 3 1 3 5 4 4 
235 5 6 5 5 3 4 6 4 6 3 1 3 2 1 1 
235 5 6 5 5 3 4 6 4 6 3 1 3 2 2 
235 5 6 5 5 3 4 6 4 6 3 1 4 3 4 2 
235 5 6 5 5 3 4 6 4 6 3 1 3 5 5 
235 5 6 5 5 3 4 6 4 6 3 1 3 5 2 
235 5 6 5 5 3 4 6 4 6 3 1 3 2 5 
235 5 6 5 5 3 4 6 4 6 3 1 1 5 4 3 
235 5 6 5 5 3 4 6 4 6 3 1 3 5 2 
235 5 6 5 5 3 4 6 4 6 3 1 3 1 1 4 4 
235 5 6 5 5 3 4 6 4 6 3 1 3 3 3 1 6 
235 5 6 5 5 3 4 6 4 6 3 1 3 2 2 
235 5 6 5 5 3 4 6 4 6 3 1 3 1 2 4 
235 5 6 5 5 3 4 6 4 6 3 1 3 1 4 5 
235 5 6 5 5 3 4 6 4 6 3 1 3 5 5 
235 5 6 5 5 3 4 6 4 6 3 1 3 2 5 
235 5 6 5 5 3 4 6 4 6 3 1 2 1 3 4 
230 5 6 5 5 3 4 6 4 6 3 1 3 6 3 4 
230 5 6 5 5 3 4 6 4 6 3 1 3 4 3 6 
230 5 6 5 5 3 4 6 4 6 3 1 6 3 3 4 
230 5 6 5 5 3 4 6 4 6 3 1 3 6 3 4 
230 5 6 5 5 3 4 6 4 6 3 1 3 6 3 1 
230 5 6 5 5 3 4 6 4 6 3 1 4 3 3 6 
225 5 6 5 5 3 4 6 4 6 3 1 3 6 1 
225 5 6 5 5 3 4 6 4 6 3 1 6 3 4 
225 5 6 5 5 3 4 6 4 6 3 1 6 3 1 
225 5 6 5 5 3 4 6 4 6 3 1 3 1 6 
220 5 6 5 5 3 4 6 4 6 3 1 3 5 3 4 3 
220 5 6 5 5 3 4 6 4 6 3 1 3 4 3 4 3 4 
220 5 6 5 5 3 4 6 4 6 3 1 3 4 1 1 3 3 
220 5 6 5 5 3 4 6 4 6 3 1 3 5 3 1 3 
210 5 6 5 5 3 4 6 4 6 3 1 3 6 3 3 
