215 6 5 5 5 6 4 3 4 6 2 6 4 
130 6 5 5 5 5 4 4 2 6 
120 6 5 5 5 5 3 5 5 2 
120 6 5 5 5 5 4 6 6 
115 6 5 5 5 5 5 5 2 
115 6 5 5 5 5 4 4 5 2 
115 6 5 5 5 6 3 6 6 
115 6 5 5 5 5 5 2 5 
115 6 5 5 5 5 5 5 2 
115 6 5 5 5 5 5 5 2 
105 6 5 5 5 5 4 2 6 
105 6 5 5 5 5 4 5 6 
105 6 5 5 5 5 4 6 5 
95 6 5 5 5 5 6 6 
95 6 5 5 5 5 3 2 1 2 
95 6 5 5 5 5 6 6 
95 6 5 5 5 5 4 2 3 5 
95 6 5 5 5 5 6 6 
95 6 5 5 5 5 6 6 
95 6 5 5 5 5 6 6 
95 6 5 5 5 5 5 3 4 2 
95 6 5 5 5 5 3 1 5 2 
95 6 5 5 5 5 6 6 
95 6 5 5 5 5 6 6 
90 6 5 5 5 5 4 5 2 
90 6 5 5 5 5 5 5 4 
85 6 5 5 5 3 5 6 5 
85 6 5 5 5 6 3 5 2 
85 6 5 5 5 6 3 1 1 2 
85 6 5 5 5 6 3 2 2 
80 6 5 5 5 5 6 2 
80 6 5 5 5 5 6 5 
80 6 5 5 5 5 6 2 
80 6 5 5 5 5 6 2 
80 6 5 5 5 5 6 2 
80 6 5 5 5 5 6 5 
80 6 5 5 5 5 6 5 
80 6 5 5 5 5 6 5 
80 6 5 5 5 5 6 2 
80 6 5 5 5 5 6 5 
80 6 5 5 5 5 6 2 
80 6 5 5 5 5 6 2 
80 6 5 5 5 5 6 5 
80 6 5 5 5 5 6 2 
80 6 5 5 5 6 2 5 
80 6 5 5 5 5 5 6 
80 6 5 5 5 5 6 5 
80 6 5 5 5 5 6 5 
70 6 5 5 5 5 3 2 5 
70 6 5 5 5 6 6 4 
70 6 5 5 5 3 5 2 2 
70 6 5 5 5 6 6 4 
65 6 5 5 5 5 3 4 6 3 
65 6 5 5 5 5 5 1 4 
60 6 5 5 5 5 4 6 3 
60 6 5 5 5 6 3 2 1 
55 6 5 5 5 5 6 4 
55 6 5 5 5 5 6 4 
55 6 5 5 5 5 6 1 
55 6 5 5 5 5 6 1 
55 6 5 5 5 5 6 1 
55 6 5 5 5 5 6 4 
55 6 5 5 5 5 6 1 
55 6 5 5 5 6 2 1 
55 6 5 5 5 6 2 1 
55 6 5 5 5 5 6 4 
55 6 5 5 5 5 6 1 
55 6 5 5 5 6 5 1 
55 6 5 5 5 5 6 1 
55 6 5 5 5 6 2 1 
55 6 5 5 5 5 6 1 
55 6 5 5 5 5 6 1 
55 6 5 5 5 5 6 4 
50 6 5 5 5 3 5 5 1 3 
50 6 5 5 5 6 6 3 
50 6 5 5 5 5 3 1 2 3 
35 6 5 5 5 5 6 3 
35 6 5 5 5 5 6 3 
35 6 5 5 5 5 6 3 
30 6 5 5 5 5 5 3 3 3 
15 6 5 5 5 5 2 
15 6 5 5 5 5 2 
15 6 5 5 5 5 2 
15 6 5 5 5 5 2 
15 6 5 5 5 5 4 1 
15 6 5 5 5 5 2 
15 6 5 5 5 5 2 
15 6 5 5 5 5 2 
15 6 5 5 5 5 2 
5 6 5 5 5 6 1 
0 6 5 5 5 3 5 4 3 
-5 6 5 5 5 3 4 2 
-5 6 5 5 5 3 4 2 
-10 6 5 5 5 5 1 
-10 6 5 5 5 5 1 
-10 6 5 5 5 5 1 
-10 6 5 5 5 5 1 
-10 6 5 5 5 5 1 
-15 6 5 5 3 6 2 
-30 4 3 3 3 6 5 6 2 
-35 6 5 5 5 2 
-35 6 5 5 5 2 
-35 6 5 5 5 2 
-35 6 5 5 5 2 
-35 6 5 5 5 2 
-35 6 5 5 5 2 
-35 6 5 5 5 2 
-35 6 5 5 5 2 
-35 6 5 5 5 2 
-35 6 5 5 5 2 
-60 6 5 5 5 4 
-60 6 5 5 5 4 
-60 6 5 5 5 4 
-60 6 5 5 5 1 
-60 6 5 5 5 1 
-60 6 5 5 5 1 
-60 6 5 5 5 1 
-60 6 5 5 5 1 
-60 6 5 5 5 4 
-60 6 5 5 5 4 
-60 6 5 5 5 4 
-60 6 5 5 5 1 
-75 6 5 5 5 3 3 
-75 6 5 5 5 3 3 
-85 6 5 5 2 
-160 6 5 4 
-160 6 5 4 
-160 6 5 4 
