130 5 6 5 5 5 4 4 2 6 
115 5 6 5 5 5 4 4 5 5 
115 5 6 5 5 5 4 4 2 2 
115 5 6 5 5 5 4 4 2 2 
115 5 6 5 5 5 4 4 5 5 
115 5 6 5 5 5 4 4 2 2 
115 5 6 5 5 5 4 4 5 2 
105 5 6 5 5 5 4 4 1 6 
105 5 6 5 5 5 4 4 4 6 
100 5 6 5 5 5 4 2 3 3 5 
90 5 6 5 5 5 4 4 4 5 
90 5 6 5 5 5 4 4 2 4 
90 5 6 5 5 5 4 4 2 4 
90 5 6 5 5 5 4 4 1 2 
90 5 6 5 5 5 4 2 5 
90 5 6 5 5 5 4 2 2 
80 5 6 5 5 5 4 4 6 
70 5 6 5 5 5 4 4 3 4 1 6 
65 5 6 5 5 5 4 4 1 1 
65 5 6 5 5 5 4 2 1 
65 5 6 5 5 5 4 5 1 
65 5 6 5 5 5 4 5 1 
65 5 6 5 5 5 4 5 1 
15 5 6 5 5 5 4 1 
0 5 6 5 5 5 4 4 2 4 5 4 
-60 5 6 5 5 4 
-85 5 6 5 2 
-110 5 6 5 1 
-110 5 1 5 6 
-125 4 2 5 2 
-135 5 6 2 
-135 5 6 2 
-135 5 6 2 
-150 5 4 5 1 
-160 5 6 4 
-160 4 5 6 
-160 5 4 6 
-160 5 6 1 
-160 5 6 1 
-170 5 3 1 5 
-170 5 1 5 3 
-175 5 1 2 
-180 5 6 3 
-195 4 5 3 1 
-200 2 4 4 
-200 5 5 
-210 4 6 
-210 4 6 
