230 4 2 5 5 5 6 3 4 3 5 4 6 6 2 
105 4 2 5 5 5 6 6 5 
105 4 2 5 5 5 6 6 2 
100 4 2 5 5 5 4 5 2 2 
100 4 2 5 5 5 5 5 2 1 
95 4 2 5 5 5 6 3 2 2 
90 4 2 5 5 5 6 5 5 
90 4 2 5 5 5 6 2 2 
90 4 2 5 5 5 6 5 5 
90 4 2 5 5 5 6 4 1 2 
90 4 2 5 5 5 5 6 5 
90 4 2 5 5 5 6 5 2 
90 4 2 5 5 5 6 4 1 5 
90 4 2 5 5 5 6 2 2 
80 4 2 5 5 5 6 4 6 
80 4 2 5 5 5 6 3 4 3 4 3 1 
80 4 2 5 5 5 6 6 4 
75 4 2 5 5 5 5 4 2 4 
65 4 2 5 5 5 6 2 4 
65 4 2 5 5 5 6 5 4 
65 4 2 5 5 5 6 4 1 4 
65 4 2 5 5 5 6 2 1 
45 4 2 5 5 5 6 5 3 
45 4 2 5 5 5 6 5 3 
45 4 2 5 5 5 6 5 3 
15 4 2 5 5 5 6 1 
15 4 2 5 5 5 4 6 
0 4 2 5 5 5 5 1 
0 4 2 5 5 5 3 6 3 
0 4 2 5 5 5 3 6 3 
-20 4 2 5 5 5 3 2 
-50 4 2 5 5 5 1 
-50 4 2 5 5 5 1 
-50 4 2 5 5 5 1 
-60 4 2 5 5 6 
-60 4 2 5 5 6 
-60 4 2 5 5 6 
-60 4 2 5 5 6 
-65 4 2 5 5 5 3 3 
-65 4 2 5 5 5 3 3 
-75 4 2 5 5 2 
-100 4 2 5 5 4 
-120 4 2 5 5 3 
-120 4 2 5 5 3 
-130 6 5 5 3 
-150 4 2 5 1 
-170 2 4 3 2 
-170 4 2 5 3 
