970 2 4 5 5 5 6 4 4 6 6 5 5 6 3 3 5 5 2 3 2 2 1 1 2 2 5 6 1 3 5 1 2 
915 2 4 5 5 5 6 4 4 6 6 5 5 6 3 3 5 5 2 3 2 2 1 1 2 2 5 6 1 1 
905 2 4 5 5 5 6 4 4 6 6 5 5 6 3 3 5 5 2 3 2 2 1 1 2 2 4 6 6 
900 2 4 5 5 5 6 4 4 6 6 5 5 6 3 3 5 5 2 3 2 2 1 1 2 2 5 2 2 
860 2 4 5 5 5 6 4 4 6 6 5 5 6 3 3 5 5 2 3 2 2 1 1 2 2 2 3 4 3 4 
825 2 4 5 5 5 6 4 4 6 6 5 5 6 3 3 5 5 2 3 2 2 1 1 2 2 1 5 
825 2 4 5 5 5 6 4 4 6 6 5 5 6 3 3 5 5 2 3 2 2 1 1 2 1 1 4 1 4 
815 2 4 5 5 5 6 4 4 6 6 5 5 6 3 3 5 5 2 3 2 2 1 1 2 2 6 
815 2 4 5 5 5 6 4 4 6 6 5 5 6 3 3 5 5 2 3 2 2 1 1 2 2 6 
780 2 4 5 5 5 6 4 4 6 6 5 5 6 3 3 5 5 2 3 2 2 1 1 2 1 2 3 
780 2 4 5 5 5 6 4 4 6 6 5 5 6 3 3 5 5 2 3 2 2 1 1 2 1 2 3 
775 2 4 5 5 5 6 4 4 6 6 5 5 6 3 3 5 5 2 3 2 2 1 1 2 1 5 
775 2 4 5 5 5 6 4 4 6 6 5 5 6 3 3 5 5 2 3 2 2 1 1 2 1 5 
775 2 4 5 5 5 6 4 4 6 6 5 5 6 3 3 5 5 2 3 2 2 1 1 2 1 5 
775 2 4 5 5 5 6 4 4 6 6 5 5 6 3 3 5 5 2 3 2 2 1 1 2 1 5 
765 2 4 5 5 5 6 4 4 6 6 5 5 6 3 3 5 5 2 3 2 2 1 1 2 6 
765 2 4 5 5 5 6 4 4 6 6 5 5 6 3 3 5 5 2 3 2 2 1 1 2 6 
765 2 4 5 5 5 6 4 4 6 6 5 5 6 3 3 5 5 2 3 2 2 1 1 2 6 
765 2 4 5 5 5 6 4 4 6 6 5 5 6 3 3 5 5 2 3 2 2 1 1 2 6 
765 2 4 5 5 5 6 4 4 6 6 5 5 6 3 3 5 5 2 3 2 2 1 1 2 6 
765 2 4 5 5 5 6 4 4 6 6 5 5 6 3 3 5 5 2 3 2 2 1 1 2 6 
765 2 4 5 5 5 6 4 4 6 6 5 5 6 3 3 5 5 2 3 2 2 1 1 2 6 
765 2 4 5 5 5 6 4 4 6 6 5 5 6 3 3 5 5 2 3 2 2 1 1 2 6 
765 2 4 5 5 5 6 4 4 6 6 5 5 6 3 3 5 5 2 3 2 2 1 1 2 6 
765 2 4 5 5 5 6 4 4 6 6 5 5 6 3 3 5 5 2 3 2 2 1 1 2 6 
765 2 4 5 5 5 6 4 4 6 6 5 5 6 3 3 5 5 2 3 2 2 1 1 2 6 
750 2 4 5 5 5 6 4 4 6 6 5 5 6 3 3 5 5 2 3 2 2 1 1 2 5 
750 2 4 5 5 5 6 4 4 6 6 5 5 6 3 3 5 5 2 3 2 2 1 2 2 4 
750 2 4 5 5 5 6 4 4 6 6 5 5 6 3 3 5 5 2 3 2 2 1 1 2 1 4 
750 2 4 5 5 5 6 4 4 6 6 5 5 6 3 3 5 5 2 3 2 2 1 1 2 5 
750 2 4 5 5 5 6 4 4 6 6 5 5 6 3 3 5 5 2 3 2 2 1 2 2 4 
750 2 4 5 5 5 6 4 4 6 6 5 5 6 3 3 5 5 2 3 2 2 1 1 2 5 
750 2 4 5 5 5 6 4 4 6 6 5 5 6 3 3 5 5 2 3 2 2 1 1 2 5 
750 2 4 5 5 5 6 4 4 6 6 5 5 6 3 3 5 5 2 3 2 2 1 1 2 1 4 
750 2 4 5 5 5 6 4 4 6 6 5 5 6 3 3 5 5 2 3 2 2 1 1 2 5 
750 2 4 5 5 5 6 4 4 6 6 5 5 6 3 3 5 5 2 3 2 2 1 1 2 5 
750 2 4 5 5 5 6 4 4 6 6 5 5 6 3 3 5 5 2 3 2 2 1 1 2 5 
730 2 4 5 5 5 6 4 4 6 6 5 5 6 3 3 5 5 2 3 2 2 1 1 2 1 3 
730 2 4 5 5 5 6 4 4 6 6 5 5 6 3 3 5 5 2 3 2 2 1 1 2 1 3 
725 2 4 5 5 5 6 4 4 6 6 5 5 6 3 3 5 5 2 3 2 2 1 1 2 4 
725 2 4 5 5 5 6 4 4 6 6 5 5 6 3 3 5 5 2 3 2 2 1 1 2 4 
725 2 4 5 5 5 6 4 4 6 6 5 5 6 3 3 5 5 2 3 2 2 1 1 2 4 
725 2 4 5 5 5 6 4 4 6 6 5 5 6 3 3 5 5 2 3 2 2 1 1 2 4 
725 2 4 5 5 5 6 4 4 6 6 5 5 6 3 3 5 5 2 3 2 2 1 1 2 4 
725 2 4 5 5 5 6 4 4 6 6 5 5 6 3 3 5 5 2 3 2 2 1 1 2 4 
725 2 4 5 5 5 6 4 4 6 6 5 5 6 3 3 5 5 2 3 2 2 1 1 2 4 
725 2 4 5 5 5 6 4 4 6 6 5 5 6 3 3 5 5 2 3 2 2 1 1 2 4 
725 2 4 5 5 5 6 4 4 6 6 5 5 6 3 3 5 5 2 3 2 2 1 1 2 4 
725 2 4 5 5 5 6 4 4 6 6 5 5 6 3 3 5 5 2 3 2 2 1 2 5 
725 2 4 5 5 5 6 4 4 6 6 5 5 6 3 3 5 5 2 3 2 2 1 1 2 4 
725 2 4 5 5 5 6 4 4 6 6 5 5 6 3 3 5 5 2 3 2 2 1 2 5 
725 2 4 5 5 5 6 4 4 6 6 5 5 6 3 3 5 5 2 3 2 2 1 1 2 4 
725 2 4 5 5 5 6 4 4 6 6 5 5 6 3 3 5 5 2 3 2 2 1 1 2 4 
715 2 4 5 5 5 6 4 4 6 6 5 5 6 3 3 5 5 2 3 2 2 1 1 6 
715 2 4 5 5 5 6 4 4 6 6 5 5 6 3 3 5 5 2 3 2 2 1 1 6 
715 2 4 5 5 5 6 4 4 6 6 5 5 6 3 3 5 5 2 3 2 2 1 1 6 
715 2 4 5 5 5 6 4 4 6 6 5 5 6 3 3 5 5 2 3 2 2 1 1 6 
715 2 4 5 5 5 6 4 4 6 6 5 5 6 3 3 5 5 2 3 2 2 1 1 6 
715 2 4 5 5 5 6 4 4 6 6 5 5 6 3 3 5 5 2 3 2 2 1 1 6 
715 2 4 5 5 5 6 4 4 6 6 5 5 6 3 3 5 5 2 3 2 2 1 1 6 
715 2 4 5 5 5 6 4 4 6 6 5 5 6 3 3 5 5 2 3 2 2 1 1 6 
715 2 4 5 5 5 6 4 4 6 6 5 5 6 3 3 5 5 2 3 2 2 1 1 6 
715 2 4 5 5 5 6 4 4 6 6 5 5 6 3 3 5 5 2 3 2 2 1 1 6 
705 2 4 5 5 5 6 4 4 6 6 5 5 6 3 3 5 5 2 3 2 2 1 1 2 3 
705 2 4 5 5 5 6 4 4 6 6 5 5 6 3 3 5 5 2 3 2 2 1 1 2 3 
705 2 4 5 5 5 6 4 4 6 6 5 5 6 3 3 5 5 2 3 2 2 1 1 2 3 
705 2 4 5 5 5 6 4 4 6 6 5 5 6 3 3 5 5 2 3 2 2 1 1 2 3 
705 2 4 5 5 5 6 4 4 6 6 5 5 6 3 3 5 5 2 3 2 2 1 1 2 3 
705 2 4 5 5 5 6 4 4 6 6 5 5 6 3 3 5 5 2 3 2 2 1 1 2 3 
705 2 4 5 5 5 6 4 4 6 6 5 5 6 3 3 5 5 2 3 2 2 1 1 2 3 
705 2 4 5 5 5 6 4 4 6 6 5 5 6 3 3 5 5 2 3 2 2 1 1 2 3 
705 2 4 5 5 5 6 4 4 6 6 5 5 6 3 3 5 5 2 3 2 2 1 1 2 3 
705 2 4 5 5 5 6 4 4 6 6 5 5 6 3 3 5 5 2 3 2 2 1 1 2 3 
700 2 4 5 5 5 6 4 4 6 6 5 5 6 3 3 5 5 2 3 2 2 1 1 1 4 
700 2 4 5 5 5 6 4 4 6 6 5 5 6 3 3 5 5 2 3 2 2 1 1 5 
700 2 4 5 5 5 6 4 4 6 6 5 5 6 3 3 5 5 2 3 2 2 1 2 4 
700 2 4 5 5 5 6 4 4 6 6 5 5 6 3 3 5 5 2 3 2 2 1 1 5 
700 2 4 5 5 5 6 4 4 6 6 5 5 6 3 3 5 5 2 3 2 2 1 1 1 4 
700 2 4 5 5 5 6 4 4 6 6 5 5 6 3 3 5 5 2 3 2 2 1 1 5 
700 2 4 5 5 5 6 4 4 6 6 5 5 6 3 3 5 5 2 3 2 2 1 2 4 
700 2 4 5 5 5 6 4 4 6 6 5 5 6 3 3 5 5 2 3 2 2 1 1 5 
700 2 4 5 5 5 6 4 4 6 6 5 5 6 3 3 5 5 2 3 2 2 1 1 5 
700 2 4 5 5 5 6 4 4 6 6 5 5 6 3 3 5 5 2 3 2 2 1 1 1 4 
700 2 4 5 5 5 6 4 4 6 6 5 5 6 3 3 5 5 2 3 2 2 1 1 5 
700 2 4 5 5 5 6 4 4 6 6 5 5 6 3 3 5 5 2 3 2 2 1 1 1 4 
700 2 4 5 5 5 6 4 4 6 6 5 5 6 3 3 5 5 2 3 2 2 1 1 5 
700 2 4 5 5 5 6 4 4 6 6 5 5 6 3 3 5 5 2 3 2 2 1 1 5 
690 2 4 5 5 5 6 4 4 6 6 5 5 6 3 3 5 5 2 3 2 2 1 6 
690 2 4 5 5 5 6 4 4 6 6 5 5 6 3 3 5 5 2 3 2 2 1 6 
690 2 4 5 5 5 6 4 4 6 6 5 5 6 3 3 5 5 2 3 2 2 1 6 
690 2 4 5 5 5 6 4 4 6 6 5 5 6 3 3 5 5 2 3 2 2 1 6 
690 2 4 5 5 5 6 4 4 6 6 5 5 6 3 3 5 5 2 3 2 2 1 6 
690 2 4 5 5 5 6 4 4 6 6 5 5 6 3 3 5 5 2 3 2 2 1 6 
680 2 4 5 5 5 6 4 4 6 6 5 5 6 3 3 5 5 2 3 2 2 1 2 3 
680 2 4 5 5 5 6 4 4 6 6 5 5 6 3 3 5 5 2 3 2 2 1 1 1 3 
680 2 4 5 5 5 6 4 4 6 6 5 5 6 3 3 5 5 2 3 2 2 1 1 1 3 
680 2 4 5 5 5 6 4 4 6 6 5 5 6 3 3 5 5 2 3 2 2 1 2 3 
680 2 4 5 5 5 6 4 4 6 6 5 5 6 3 3 5 5 2 3 2 2 1 2 3 
675 2 4 5 5 5 6 4 4 6 6 5 5 6 3 3 5 5 2 3 2 2 1 1 4 
675 2 4 5 5 5 6 4 4 6 6 5 5 6 3 3 5 5 2 3 2 2 1 5 
675 2 4 5 5 5 6 4 4 6 6 5 5 6 3 3 5 5 2 3 2 2 1 1 4 
675 2 4 5 5 5 6 4 4 6 6 5 5 6 3 3 5 5 2 3 2 2 1 5 
675 2 4 5 5 5 6 4 4 6 6 5 5 6 3 3 5 5 2 3 2 2 1 5 
675 2 4 5 5 5 6 4 4 6 6 5 5 6 3 3 5 5 2 3 2 2 1 5 
675 2 4 5 5 5 6 4 4 6 6 5 5 6 3 3 5 5 2 3 2 2 1 5 
675 2 4 5 5 5 6 4 4 6 6 5 5 6 3 3 5 5 2 3 2 2 1 1 4 
675 2 4 5 5 5 6 4 4 6 6 5 5 6 3 3 5 5 2 3 2 2 1 1 4 
675 2 4 5 5 5 6 4 4 6 6 5 5 6 3 3 5 5 2 3 2 2 1 5 
675 2 4 5 5 5 6 4 4 6 6 5 5 6 3 3 5 5 2 3 2 2 1 1 4 
675 2 4 5 5 5 6 4 4 6 6 5 5 6 3 3 5 5 2 3 2 2 1 1 4 
675 2 4 5 5 5 6 4 4 6 6 5 5 6 3 3 5 5 2 3 2 2 1 1 4 
675 2 4 5 5 5 6 4 4 6 6 5 5 6 3 3 5 5 2 3 2 2 1 5 
675 2 4 5 5 5 6 4 4 6 6 5 5 6 3 3 5 5 2 3 2 2 1 5 
675 2 4 5 5 5 6 4 4 6 6 5 5 6 3 3 5 5 2 3 2 2 1 5 
675 2 4 5 5 5 6 4 4 6 6 5 5 6 3 3 5 5 2 3 2 2 1 5 
675 2 4 5 5 5 6 4 4 6 6 5 5 6 3 3 5 5 2 3 2 2 1 5 
675 2 4 5 5 5 6 4 4 6 6 5 5 6 3 3 5 5 2 3 2 2 1 5 
675 2 4 5 5 5 6 4 4 6 6 5 5 6 3 3 5 5 2 3 2 2 1 1 4 
675 2 4 5 5 5 6 4 4 6 6 5 5 6 3 3 5 5 2 3 2 2 1 1 4 
675 2 4 5 5 5 6 4 4 6 6 5 5 6 3 3 5 5 2 3 2 2 1 5 
675 2 4 5 5 5 6 4 4 6 6 5 5 6 6 3 3 6 4 3 3 5 2 6 
660 2 4 5 5 5 6 4 4 6 6 5 5 3 6 6 4 3 5 5 2 2 4 
655 2 4 5 5 5 6 4 4 6 6 5 5 6 3 3 5 5 2 3 2 2 1 1 3 
655 2 4 5 5 5 6 4 4 6 6 5 5 6 4 6 6 3 1 3 6 6 
655 2 4 5 5 5 6 4 4 6 6 5 5 6 3 3 5 5 2 3 2 2 1 1 3 
655 2 4 5 5 5 6 4 4 6 6 5 5 6 3 3 5 5 2 3 2 2 1 1 3 
655 2 4 5 5 5 6 4 4 6 6 5 5 6 3 3 5 5 2 3 2 2 1 1 3 
655 2 4 5 5 5 6 4 4 6 6 5 5 6 3 3 5 5 2 3 2 2 1 1 3 
655 2 4 5 5 5 6 4 4 6 6 5 5 6 3 3 5 5 2 3 2 2 1 1 3 
655 2 4 5 5 5 6 4 4 6 6 5 5 6 3 3 5 5 2 3 2 2 1 1 3 
655 2 4 5 5 5 6 4 4 6 6 5 5 6 3 3 5 5 2 3 2 2 1 1 3 
655 2 4 5 5 5 6 4 4 6 6 5 5 6 3 3 5 5 2 3 2 2 1 1 3 
655 2 4 5 5 5 6 4 4 6 6 5 5 6 3 3 5 5 2 3 2 2 1 1 3 
655 2 4 5 5 5 6 4 4 6 6 5 5 6 3 3 6 6 2 6 6 
650 2 4 5 5 5 6 4 4 6 6 5 5 6 3 3 5 5 2 3 2 2 1 4 
650 2 4 5 5 5 6 4 4 6 6 5 5 6 3 3 5 5 2 3 2 2 1 4 
650 2 4 5 5 5 6 4 4 6 6 5 5 6 4 6 5 5 1 2 5 
650 2 4 5 5 5 6 4 4 6 6 5 5 6 3 3 5 5 2 3 2 2 1 4 
650 2 4 5 5 5 6 4 4 6 6 5 5 6 3 3 5 5 2 3 2 2 1 4 
650 2 4 5 5 5 6 4 4 6 6 5 5 6 3 3 5 5 2 3 2 2 1 4 
650 2 4 5 5 5 6 4 4 6 6 5 5 6 3 3 5 5 2 3 2 2 1 4 
650 2 4 5 5 5 6 4 4 6 6 5 5 6 3 3 5 5 2 3 2 2 1 4 
650 2 4 5 5 5 6 4 4 6 6 5 5 6 3 3 5 5 2 3 2 2 1 4 
650 2 4 5 5 5 6 4 4 6 6 5 5 6 3 3 5 5 2 3 2 2 1 4 
650 2 4 5 5 5 6 4 4 6 6 5 5 3 5 5 6 4 3 2 3 1 1 1 5 
650 2 4 5 5 5 6 4 4 6 6 5 5 6 3 3 5 5 2 3 2 2 1 4 
650 2 4 5 5 5 6 4 4 6 6 5 5 6 3 3 5 5 2 3 2 2 1 4 
645 2 4 5 5 5 6 4 4 6 6 5 5 3 6 3 5 4 5 2 4 1 1 5 
630 2 4 5 5 5 6 4 4 6 6 5 5 6 3 3 5 5 2 3 2 2 1 3 
630 2 4 5 5 5 6 4 4 6 6 5 5 6 3 3 5 5 2 3 2 2 1 3 
630 2 4 5 5 5 6 4 4 6 6 5 5 6 3 3 5 5 2 3 2 2 1 3 
630 2 4 5 5 5 6 4 4 6 6 5 5 6 3 3 5 5 2 3 2 2 1 3 
630 2 4 5 5 5 6 4 4 6 6 5 5 6 3 3 5 5 2 3 2 2 1 3 
630 2 4 5 5 5 6 4 4 6 6 5 5 6 3 3 5 5 2 3 2 2 1 3 
630 2 4 5 5 5 6 4 4 6 6 5 5 6 3 3 5 5 2 3 2 2 1 3 
630 2 4 5 5 5 6 4 4 6 6 5 5 6 3 3 5 5 2 3 2 2 1 3 
630 2 4 5 5 5 6 4 4 6 6 5 5 6 3 3 5 5 2 3 2 2 1 3 
630 2 4 5 5 5 6 4 4 6 6 5 5 6 3 3 5 5 2 3 2 2 1 3 
620 2 4 5 5 5 6 4 4 6 6 5 5 3 6 6 4 6 2 2 4 
615 2 4 5 5 5 6 4 4 6 6 5 5 3 6 4 6 3 5 2 4 2 3 
605 2 4 5 5 5 6 4 4 6 6 5 5 3 5 3 6 4 4 3 6 1 6 
600 2 4 5 5 5 6 4 4 6 6 5 5 3 5 3 6 5 6 1 6 
600 2 4 5 5 5 6 4 4 6 6 5 5 6 6 4 4 5 4 5 4 
590 2 4 5 5 5 6 4 4 6 6 5 5 3 6 3 6 5 2 3 1 5 
580 2 4 5 5 5 6 4 4 6 6 5 5 6 4 6 3 4 1 1 2 4 
575 2 4 5 5 5 6 4 4 6 6 5 5 6 6 5 3 2 6 3 
540 2 4 5 5 5 6 4 4 6 6 5 5 6 6 3 6 6 3 
480 2 4 5 5 5 6 4 4 6 6 5 5 3 5 5 5 3 2 
450 2 4 5 5 5 6 4 4 6 6 5 5 6 1 6 1 
440 2 4 5 5 5 6 4 4 6 6 5 5 3 6 4 5 1 
435 2 4 5 5 5 6 4 4 6 6 5 5 6 1 5 1 
435 2 4 5 5 5 6 4 4 6 6 5 5 3 5 3 4 5 3 1 
430 2 4 5 5 5 6 4 4 6 6 5 5 3 5 3 5 4 1 
430 2 4 5 5 5 6 4 4 6 6 5 5 3 6 6 1 
430 2 4 5 5 5 6 4 4 6 6 5 5 6 6 3 1 
400 2 4 5 5 5 6 4 4 6 6 5 5 3 5 1 5 
390 2 4 5 5 5 6 4 4 6 6 5 5 3 5 6 
390 2 4 5 5 5 6 4 4 6 6 5 5 6 3 2 
390 2 4 5 5 5 6 4 4 6 6 5 5 3 6 2 
390 2 4 5 5 5 6 4 4 6 6 5 5 3 6 2 
390 2 4 5 5 5 6 4 4 6 2 6 5 3 5 6 
390 2 4 5 5 5 6 4 4 6 6 5 5 6 3 5 
385 2 4 5 5 5 6 4 4 6 6 5 5 6 2 
385 2 4 5 5 5 6 4 4 6 6 5 5 6 4 1 
385 2 4 5 5 5 6 4 4 6 6 5 5 6 2 
375 2 4 5 5 5 6 4 4 6 6 5 5 3 5 1 1 
375 2 4 5 5 5 6 4 4 6 6 5 5 3 5 4 1 
370 2 4 5 5 5 6 4 4 6 6 5 5 3 6 3 1 
365 2 4 5 5 5 6 4 4 6 6 5 5 6 3 1 
365 2 4 5 5 5 6 4 4 6 6 5 5 3 6 1 
360 2 4 5 5 5 6 4 4 6 6 3 3 4 5 3 5 5 
360 2 4 5 5 5 6 4 4 6 6 5 5 3 5 1 3 3 
325 2 4 5 5 5 6 4 4 6 6 5 5 3 2 
325 2 4 5 5 5 6 4 4 6 6 5 5 3 2 
325 2 4 5 5 5 6 4 4 6 6 5 5 3 2 
325 2 4 5 5 5 6 4 4 6 6 5 5 3 2 
325 2 4 5 5 5 6 4 4 6 6 5 5 3 2 
325 2 4 5 5 5 6 4 4 6 6 5 5 3 2 
325 2 4 5 5 5 6 4 4 6 6 5 5 3 2 
320 2 4 5 5 5 6 4 4 6 6 5 5 2 
320 2 4 5 5 5 6 4 4 6 6 5 5 5 
320 2 4 5 5 5 6 4 4 6 6 5 5 2 
320 2 4 5 5 5 6 4 4 6 6 5 5 5 
320 2 4 5 5 5 6 4 4 6 6 5 5 5 
320 2 4 5 5 5 6 4 4 6 6 5 5 5 
320 2 4 5 5 5 6 4 4 6 6 5 5 5 
320 2 4 5 5 5 6 4 4 6 6 5 5 5 
320 2 4 5 5 5 6 4 4 6 6 5 5 2 
320 2 4 5 5 5 6 4 4 6 6 5 5 5 
320 2 4 5 5 5 6 4 4 6 6 5 5 2 
320 2 4 5 5 5 6 4 4 6 6 5 5 2 
320 2 4 5 5 5 6 4 4 6 6 5 5 5 
320 2 4 5 5 5 6 4 4 6 6 5 5 5 
320 2 4 5 5 5 6 4 4 6 6 5 5 2 
320 2 4 5 5 5 6 4 4 6 6 5 5 2 
310 2 4 5 5 5 6 4 4 6 6 4 6 2 
300 2 4 5 5 5 6 4 4 6 6 5 5 3 1 
300 2 4 5 5 5 6 4 4 6 6 5 5 3 1 
300 2 4 5 5 5 6 4 4 6 6 5 5 3 1 
300 2 4 5 5 5 6 4 4 6 6 5 5 3 1 
300 2 4 5 5 5 6 4 4 6 6 5 5 3 4 
300 2 4 5 5 5 6 4 4 6 1 1 5 3 6 4 
300 2 4 5 5 5 6 4 4 6 6 5 5 3 1 
295 2 4 5 5 5 6 4 4 6 6 5 5 4 
295 2 4 5 5 5 6 4 4 6 6 5 5 1 
295 2 4 5 5 5 6 4 4 6 6 5 5 4 
295 2 4 5 5 5 6 4 4 6 6 5 5 4 
295 2 4 5 5 5 6 4 4 6 6 5 5 1 
295 2 4 5 5 5 6 4 4 6 6 5 5 4 
295 2 4 5 5 5 6 4 4 6 6 5 5 4 
295 2 4 5 5 5 6 4 4 6 6 5 5 1 
295 2 4 5 5 5 6 4 4 6 6 5 5 1 
295 2 4 5 5 5 6 4 4 6 5 4 1 1 6 
295 2 4 5 5 5 6 4 4 6 6 5 5 4 
295 2 4 5 5 5 6 4 4 6 6 5 5 4 
295 2 4 5 5 5 6 4 4 6 6 5 5 4 
295 2 4 5 5 5 6 4 4 6 6 5 5 1 
295 2 4 5 5 5 6 4 4 6 6 5 5 4 
290 2 4 5 5 5 6 4 4 6 6 1 3 4 6 
285 2 4 5 5 5 6 4 4 6 6 5 6 
285 2 4 5 5 5 6 4 4 6 6 5 6 
285 2 4 5 5 5 6 4 4 6 6 5 6 
285 2 4 5 5 5 6 4 4 6 6 5 6 
285 2 4 5 5 5 6 4 4 3 6 4 3 3 5 1 6 
285 2 4 5 5 5 6 4 4 6 6 5 6 
285 2 4 5 5 5 6 4 4 6 6 5 6 
280 2 4 5 5 5 6 4 4 6 6 5 5 3 3 
280 2 4 5 5 5 6 4 4 6 6 5 5 3 3 
275 2 4 5 5 5 6 4 4 6 1 1 4 3 1 6 
275 2 4 5 5 5 6 4 4 6 6 1 1 3 2 
275 2 4 5 5 5 6 4 4 6 6 5 3 2 
275 2 4 5 5 5 6 4 4 6 4 3 1 6 5 
275 2 4 5 5 5 6 4 4 6 6 3 5 2 
270 2 4 5 5 5 6 4 4 6 6 5 2 
270 2 4 5 5 5 6 4 4 6 6 5 2 
270 2 4 5 5 5 6 4 4 6 6 5 2 
270 2 4 5 5 5 6 4 4 6 6 5 2 
270 2 4 5 5 5 6 4 4 6 6 5 2 
270 2 4 5 5 5 6 4 4 6 2 4 4 6 
270 2 4 5 5 5 6 4 4 6 6 5 2 
270 2 4 5 5 5 6 4 4 6 6 1 1 5 
255 2 4 5 5 5 6 4 4 6 2 2 2 
255 2 4 5 5 5 6 4 4 6 4 2 2 1 
250 2 4 5 5 5 6 4 4 6 6 5 3 1 
250 2 4 5 5 5 6 4 4 6 6 4 3 2 
250 2 4 5 5 5 6 4 4 6 6 5 3 1 
250 2 4 5 5 5 6 4 4 6 3 6 1 4 4 
250 2 4 5 5 5 6 4 4 6 6 1 3 5 
250 2 4 5 5 5 6 4 4 6 6 5 3 1 
250 2 4 5 5 5 6 4 4 6 6 4 3 4 4 
250 2 4 5 5 5 6 4 4 6 6 5 3 1 
245 2 4 5 5 5 6 4 4 6 6 5 4 
245 2 4 5 5 5 6 4 4 6 6 5 1 
245 2 4 5 5 5 6 4 4 6 6 4 2 
245 2 4 5 5 5 6 4 4 6 6 1 5 
245 2 4 5 5 5 6 4 4 6 6 5 1 
245 2 4 5 5 5 6 4 4 6 6 5 1 
245 2 4 5 5 5 6 4 4 6 6 5 1 
245 2 4 5 5 5 6 4 4 6 6 5 4 
245 2 4 5 5 5 6 4 4 6 6 5 4 
245 2 4 5 5 5 6 4 4 6 6 1 4 1 
245 2 4 5 5 5 6 4 4 6 6 4 2 
245 2 4 5 5 5 6 4 4 6 6 5 1 
245 2 4 5 5 5 6 4 4 6 6 5 1 
245 2 4 5 5 5 6 4 4 6 6 5 4 
245 2 4 5 5 5 6 4 4 6 6 5 4 
245 2 4 5 5 5 6 4 4 6 6 5 4 
240 2 4 5 5 5 6 4 4 6 6 3 6 
240 2 4 5 5 5 6 4 4 6 5 1 4 3 3 1 
235 2 4 5 5 5 6 4 4 6 6 6 
235 2 4 5 5 5 6 4 4 6 6 6 
235 2 4 5 5 5 6 4 4 6 6 6 
235 2 4 5 5 5 6 4 4 6 6 6 
235 2 4 5 5 5 6 4 4 6 6 6 
235 2 4 5 5 5 6 4 4 6 4 3 3 3 6 4 
230 2 4 5 5 5 6 4 4 3 6 6 3 1 4 
230 2 4 5 5 5 6 4 4 6 6 3 1 1 3 
230 2 4 5 5 5 6 4 4 6 3 4 3 6 1 
-25 2 4 5 5 5 6 4 4 6 6 5 3 5 
-70 2 4 5 5 5 6 4 4 6 6 5 3 3 
