420 6 5 5 5 6 4 3 4 6 2 2 3 6 5 5 5 1 
320 6 5 5 5 6 4 3 4 6 2 3 2 6 2 
315 6 5 5 5 6 4 3 4 6 6 1 1 5 5 
305 6 5 5 5 5 4 4 5 5 2 4 1 1 6 
295 6 5 5 5 6 4 3 4 6 2 3 1 2 6 
295 6 5 5 5 6 4 3 4 6 2 4 2 3 6 
290 6 5 5 5 6 4 3 4 6 2 5 4 6 
290 6 5 5 5 6 4 3 4 6 2 1 2 6 
290 6 5 5 5 6 4 3 4 6 2 1 2 6 
285 6 5 5 5 6 4 3 4 6 2 3 6 6 
285 6 5 5 5 6 4 3 4 6 5 3 2 5 4 3 
280 6 5 5 5 6 4 3 4 6 2 6 6 
280 6 5 5 5 6 4 3 4 6 2 6 6 
280 6 5 5 5 6 4 3 4 6 2 6 6 
280 6 5 5 5 6 4 3 4 6 5 1 2 3 5 
275 6 5 5 5 6 4 3 4 6 2 5 3 6 3 
275 6 5 5 5 6 4 3 4 6 2 2 4 2 
275 6 5 5 5 6 4 3 4 6 5 4 1 1 5 
270 6 5 5 5 6 4 3 4 6 2 6 3 5 
270 6 5 5 5 6 4 3 4 6 3 6 1 1 2 
270 6 5 5 5 6 4 3 4 6 2 1 3 4 6 
270 6 5 5 5 6 4 3 4 6 2 1 3 1 6 
265 6 5 5 5 6 4 3 4 6 2 5 6 
265 6 5 5 5 6 4 3 4 6 2 2 6 
265 6 5 5 5 6 4 3 4 6 2 6 2 
265 6 5 5 5 6 4 3 4 6 2 6 5 
265 6 5 5 5 6 4 3 4 6 2 2 6 
265 6 5 5 5 6 4 3 4 6 2 6 5 
265 6 5 5 5 6 4 3 4 6 2 6 2 
265 6 5 5 5 6 4 3 4 6 2 6 5 
265 6 5 5 5 6 4 3 4 6 2 6 5 
265 6 5 5 5 6 4 3 4 6 2 2 6 
265 6 5 5 5 6 4 3 4 6 2 6 2 
265 6 5 5 5 6 4 3 4 6 2 5 6 
265 6 5 5 5 6 4 3 4 6 2 6 2 
255 6 5 5 5 6 4 3 4 6 2 3 5 2 
255 6 5 5 5 6 4 3 4 6 3 1 2 4 5 
255 6 5 5 5 6 4 3 4 6 2 5 3 4 4 
255 6 5 5 5 6 4 3 4 6 2 4 1 3 2 
250 6 5 5 5 6 4 3 4 6 2 2 4 4 
250 6 5 5 5 6 4 3 4 6 4 2 5 1 
250 6 5 5 5 6 4 3 4 6 2 4 1 5 
250 6 5 5 5 6 4 3 4 6 2 4 4 4 4 
250 6 5 5 5 6 4 3 4 6 2 1 4 2 
240 6 5 5 5 6 4 3 4 6 4 6 2 
240 6 5 5 5 6 4 3 4 6 2 6 1 
240 6 5 5 5 6 4 3 4 6 2 6 4 
240 6 5 5 5 6 4 3 4 6 2 6 1 
240 6 5 5 5 6 4 3 4 6 2 6 1 
240 6 5 5 5 6 4 3 4 6 2 1 6 
240 6 5 5 5 6 4 3 4 6 5 6 4 
240 6 5 5 5 6 4 3 4 6 2 6 4 
240 6 5 5 5 6 4 3 4 6 2 6 1 
240 6 5 5 5 6 4 3 4 6 2 6 4 
240 6 5 5 5 6 4 3 4 6 2 6 4 
235 6 5 5 5 6 4 3 4 6 3 5 5 4 3 
235 6 5 5 5 6 4 3 4 6 5 1 4 3 1 3 
235 6 5 5 5 6 4 3 4 6 2 1 3 5 3 
235 6 5 5 5 6 4 3 4 6 6 3 6 
235 6 5 5 5 6 4 3 4 6 2 4 3 5 3 
235 6 5 5 5 6 4 3 4 6 2 3 4 3 1 1 
235 6 5 5 5 6 4 3 4 6 2 1 3 3 4 1 
225 6 5 5 5 6 4 3 4 6 2 6 3 3 
225 6 5 5 5 6 4 3 4 6 2 6 3 3 
115 6 5 5 5 5 5 5 2 
110 6 5 5 5 5 4 3 6 5 
105 6 5 5 5 5 4 6 2 
95 6 5 5 5 5 6 6 
95 6 5 5 5 6 6 2 
90 6 5 5 5 5 5 5 1 
90 6 5 5 5 5 5 5 1 
90 6 5 5 5 5 5 5 4 
90 6 5 5 5 5 5 5 1 
90 6 5 5 5 5 4 2 5 
85 6 5 5 5 6 3 5 5 
85 6 5 5 5 6 3 1 1 5 
85 6 5 5 5 6 3 2 5 
80 6 5 5 5 5 6 2 
80 6 5 5 5 5 6 5 
80 6 5 5 5 5 6 2 
75 6 5 5 5 5 5 3 5 3 
75 6 5 5 5 6 3 6 4 
75 6 5 5 5 6 3 6 4 
70 6 5 5 5 6 6 4 
70 6 5 5 5 6 4 6 
70 6 5 5 5 5 5 5 3 
70 6 5 5 5 5 5 5 3 
70 6 5 5 5 5 5 3 1 4 
65 6 5 5 5 5 4 5 4 
65 6 5 5 5 5 4 2 4 
65 6 5 5 5 5 4 2 4 
55 6 5 5 5 5 6 1 
55 6 5 5 5 5 6 1 
55 6 5 5 5 6 2 1 
55 6 5 5 5 5 6 4 
55 6 5 5 5 5 6 1 
45 6 5 5 5 5 5 1 3 
45 6 5 5 5 5 4 5 3 
40 6 5 5 5 6 3 1 1 3 
35 6 5 5 5 6 5 3 
15 6 5 5 5 5 4 1 
15 6 5 5 5 5 2 
15 6 5 5 5 5 2 
15 6 5 5 5 5 2 
15 6 5 5 5 5 2 
15 6 5 5 5 5 2 
15 6 5 5 5 5 2 
15 6 5 5 5 5 4 1 
15 6 5 5 5 5 2 
-5 6 5 5 5 3 5 1 
-10 6 5 5 5 6 3 3 
-15 6 5 5 5 6 4 3 4 6 3 4 6 1 6 
-30 6 5 5 5 6 4 3 4 6 3 1 6 4 5 
-30 6 5 5 5 3 2 
-35 6 5 5 5 2 
-35 6 5 5 5 5 3 5 5 
-35 6 5 5 5 2 
-35 6 5 5 5 2 
-35 6 5 5 5 2 
-35 6 5 5 5 5 3 2 1 5 
-35 6 5 5 5 5 3 1 6 
-35 6 5 5 5 5 3 4 1 
-35 6 5 5 5 5 3 2 
-35 6 5 5 5 2 
-55 6 5 5 5 3 1 
-60 6 5 5 5 1 
-60 6 5 5 5 1 
-75 6 5 5 5 3 3 
