320 2 1 5 5 5 5 5 5 2 6 4 1 1 3 2 
270 6 5 5 3 6 4 1 4 3 2 5 3 1 5 1 5 
270 6 5 5 3 6 4 1 4 3 2 5 3 1 5 1 4 1 
270 6 5 5 3 6 4 1 4 3 2 5 3 1 5 1 5 
250 6 5 5 3 6 4 1 4 3 2 5 3 1 5 3 4 1 3 
100 6 5 5 3 4 5 3 5 2 2 
90 6 5 5 3 4 5 4 5 3 6 
90 6 5 5 3 4 1 4 3 5 1 6 
85 6 5 5 3 6 4 2 4 2 
80 6 5 5 3 6 4 2 3 6 
80 6 5 5 3 6 4 3 2 6 
75 6 5 5 3 6 4 6 5 
75 6 5 5 3 6 4 5 6 
75 6 5 5 3 6 4 2 6 
75 6 5 5 3 6 4 2 3 3 3 2 
70 6 5 5 3 4 5 4 1 1 2 
70 5 4 5 5 5 6 3 5 1 
65 6 5 5 3 6 4 3 5 5 
65 6 5 5 3 6 6 6 
65 6 5 5 3 6 3 5 4 2 
60 6 5 5 3 6 4 5 5 
60 6 5 5 3 6 4 2 5 
60 6 5 5 3 6 4 2 4 1 
60 6 5 5 3 6 4 2 4 1 
50 6 5 5 3 6 6 5 
50 6 5 5 3 6 4 6 1 
40 6 5 5 3 6 4 3 5 4 
30 6 5 5 3 6 4 6 3 
-10 6 5 5 3 4 4 6 3 
-10 6 5 5 3 6 4 3 1 
-10 6 5 5 3 6 4 3 1 
-15 6 5 5 3 6 4 1 4 3 2 5 3 1 5 
-15 6 5 5 3 6 4 1 4 3 2 5 3 1 5 1 
-15 6 5 5 3 6 4 1 4 3 2 5 3 1 5 
-15 6 5 5 3 6 4 1 4 3 2 5 3 1 5 
-15 6 5 5 3 6 4 1 4 3 2 5 3 1 5 1 
-15 6 5 5 3 6 4 1 4 3 2 5 3 1 5 1 4 
-15 6 5 5 3 6 4 1 4 3 2 5 3 1 5 1 4 
-15 6 5 5 3 6 4 1 4 3 2 5 3 1 5 1 
-15 6 5 5 3 6 4 1 4 3 2 5 3 1 5 1 4 
-15 6 5 5 3 6 4 1 4 3 2 5 3 1 5 1 4 
-15 6 5 5 3 6 4 1 4 3 2 5 3 1 5 
-15 6 5 5 3 6 4 1 4 3 2 5 3 1 5 1 4 
-15 6 5 5 3 6 4 1 4 3 2 5 3 1 5 1 4 
-15 6 5 5 3 6 4 1 4 3 2 5 3 1 5 1 4 
-15 6 5 5 3 6 4 1 4 3 2 5 3 1 5 
-15 6 5 5 3 6 4 1 4 3 2 5 3 1 5 1 4 
-15 6 5 5 3 6 4 1 4 3 2 5 3 1 5 1 
-15 6 5 5 3 6 4 1 4 3 2 5 3 1 5 1 4 
-15 6 5 5 3 6 4 1 4 3 2 5 3 1 5 1 4 
-15 6 5 5 3 6 4 1 4 3 2 5 3 1 5 1 
-15 6 5 5 3 6 4 1 4 3 2 5 3 1 5 1 4 
-15 6 5 5 3 6 4 1 4 3 2 5 3 1 5 
-15 6 5 5 3 6 4 1 4 3 2 5 3 1 5 
-15 6 5 5 3 6 4 1 4 3 2 5 3 1 5 1 
-15 6 5 5 3 6 4 1 4 3 2 5 3 1 5 1 
-15 6 5 5 3 6 4 1 4 3 2 5 3 1 5 
-15 6 5 5 3 6 4 1 4 3 2 5 3 1 5 1 4 
-15 6 5 5 3 6 4 1 4 3 2 5 3 1 5 1 
-15 6 5 5 3 6 4 1 4 3 2 5 3 1 5 1 
-15 6 5 5 3 6 4 1 4 3 2 5 3 1 5 1 
-15 6 5 5 3 6 4 1 4 3 2 5 3 1 5 
-15 6 5 5 3 6 4 1 4 3 2 5 3 1 5 
-15 6 5 5 3 6 4 1 4 3 2 5 3 1 5 1 
-15 6 5 5 3 6 4 1 4 3 2 5 3 1 5 1 
-15 6 5 5 3 6 4 1 4 3 2 5 3 1 5 1 
-15 6 5 5 3 6 4 1 4 3 2 5 3 1 5 
-15 6 5 5 3 6 4 1 4 3 2 5 3 1 5 
-15 6 5 5 3 6 4 1 4 3 2 5 3 1 5 
-15 6 5 5 3 6 4 1 4 3 2 5 3 1 5 1 4 
-15 6 5 5 3 6 4 1 4 3 2 5 3 1 5 
-15 6 5 5 3 6 4 1 4 3 2 5 3 1 5 1 4 
-15 6 5 5 3 6 4 1 4 3 2 5 3 1 5 
-15 6 5 5 3 6 4 1 4 3 2 5 3 1 5 1 
-15 6 5 5 3 6 4 1 4 3 2 5 3 1 5 
-15 6 5 5 3 6 4 1 4 3 2 5 3 1 5 
-15 6 5 5 3 6 4 1 4 3 2 5 3 1 5 1 
-15 6 5 5 3 6 5 
-15 6 5 5 3 6 5 4 
-15 6 5 5 3 6 4 1 6 
-15 6 5 5 3 6 5 
-15 6 5 5 3 6 4 1 
-15 6 5 5 3 6 4 1 2 
-15 6 5 5 3 6 4 1 4 2 
-15 6 5 5 3 6 4 1 2 
-15 6 5 5 3 6 4 4 
-15 6 5 5 3 6 4 1 2 
-15 6 5 5 3 6 5 4 1 
-15 6 5 5 3 6 4 1 
-15 6 5 5 3 6 5 
-15 6 5 5 3 6 4 1 5 
-15 6 5 5 3 6 4 1 2 
-15 6 5 5 3 6 4 1 
-15 6 5 5 3 6 4 1 1 4 
-15 6 5 5 3 6 4 1 
-15 6 5 5 3 6 4 1 
-15 6 5 5 3 6 4 1 2 
-15 6 5 5 3 6 4 1 2 
-15 6 5 5 3 5 6 4 
-15 6 5 5 3 6 4 1 4 2 
-15 6 5 5 3 6 4 1 6 
-15 6 5 5 3 6 4 1 4 3 2 5 3 1 5 
-15 6 5 5 3 6 4 1 4 3 2 5 3 1 5 1 4 
-15 6 5 5 3 6 4 1 4 3 2 5 3 1 5 
-15 6 5 5 3 6 4 1 4 3 2 5 3 1 5 1 
-15 6 5 5 3 6 4 1 4 3 2 5 3 1 5 
-15 6 5 5 3 6 4 1 4 3 2 5 3 1 5 1 
-15 6 5 5 3 6 4 1 4 3 2 5 3 1 5 1 
-15 6 5 5 3 6 4 1 4 3 2 5 3 1 5 
-15 6 5 5 3 6 4 1 4 3 2 5 3 1 5 1 4 
-15 6 5 5 3 6 4 1 4 3 2 5 3 1 5 1 
-15 6 5 5 3 6 4 1 4 3 2 5 3 1 5 1 
-15 6 5 5 3 6 4 1 4 3 2 5 3 1 5 1 
-15 6 5 5 3 6 4 1 4 3 2 5 3 1 5 
-15 6 5 5 3 6 4 1 4 3 2 5 3 1 5 1 
-15 6 5 5 3 6 4 1 4 3 2 5 3 1 5 1 
-15 6 5 5 3 6 5 
-15 6 5 5 3 6 4 1 
-15 6 5 5 3 6 4 1 
-15 6 5 5 3 6 4 1 
-15 6 5 5 3 6 4 1 2 
-15 6 5 5 3 6 4 1 
-15 6 5 5 3 6 4 1 
-15 6 5 5 3 6 4 1 
-15 6 5 5 3 6 4 4 
-15 6 5 5 3 6 5 3 
-15 6 5 5 3 6 4 1 
-40 6 5 5 3 6 1 
