330 5 6 5 5 5 4 4 4 4 5 5 2 1 1 6 
280 5 6 5 5 5 4 4 4 4 5 6 5 4 4 
270 5 6 5 5 5 4 3 4 5 2 1 4 2 4 4 4 
130 5 6 5 5 5 4 4 5 6 
130 5 6 5 5 5 4 4 5 6 
130 5 6 5 5 5 4 4 5 6 
120 5 6 5 5 5 4 4 3 2 2 
115 5 6 5 5 5 4 4 2 5 
115 5 6 5 5 5 4 4 2 5 
115 5 6 5 5 5 4 4 2 5 
115 5 6 5 5 5 4 4 2 5 
115 5 6 5 5 5 4 4 2 2 
115 5 6 5 5 5 4 4 2 5 
115 5 6 5 5 5 4 4 2 5 
110 5 6 5 5 5 4 2 3 6 
105 5 6 5 5 5 4 4 4 6 
105 5 6 5 5 5 4 4 4 6 
105 5 6 5 5 5 4 4 4 6 
95 5 6 5 5 5 6 6 
95 5 6 5 5 5 4 4 3 5 4 
90 5 6 5 5 5 4 4 1 5 
90 5 6 5 5 5 4 2 2 
90 5 6 5 5 5 4 2 5 
90 5 6 5 5 5 4 4 2 4 
90 5 6 5 5 5 4 4 1 2 
90 5 6 5 5 5 4 4 2 1 
90 5 6 5 5 5 4 4 2 1 
90 5 6 5 5 5 4 4 2 4 
90 5 6 5 5 5 4 2 2 
90 5 6 5 5 5 4 4 2 1 
90 5 6 5 5 5 4 4 2 4 
90 5 6 5 5 5 4 2 2 
80 5 6 5 5 5 4 4 6 
80 5 6 5 5 5 4 4 6 
80 5 6 5 5 5 4 4 6 
80 5 6 5 5 5 4 4 6 
70 5 6 5 5 5 4 4 2 3 
70 5 6 5 5 5 4 4 2 3 
65 5 6 5 5 5 4 2 4 
65 5 6 5 5 5 4 5 1 
45 5 6 5 5 5 4 5 3 
30 5 6 5 5 5 4 4 3 3 3 
15 5 6 5 5 5 4 1 
15 5 6 5 5 5 4 1 
15 5 6 5 5 5 4 1 
0 5 6 5 5 5 4 3 3 
-190 5 6 5 5 5 4 4 3 5 
-230 5 6 5 5 5 4 4 5 
