210 4 2 5 5 5 6 4 6 6 6 2 
115 4 2 5 5 5 6 4 2 5 
115 4 2 5 5 5 4 6 2 5 
115 4 2 5 5 5 6 4 5 2 
110 4 2 5 5 5 6 4 4 3 6 
105 4 2 5 5 5 6 2 6 
105 4 2 5 5 5 6 6 2 
100 4 2 5 5 5 5 5 4 1 4 
100 4 2 5 5 5 5 5 5 1 
90 4 2 5 5 5 6 5 2 
80 4 2 5 5 5 5 4 2 3 4 
75 4 2 5 5 5 4 5 2 1 
-5 4 2 5 5 5 6 3 4 3 5 4 6 6 
-5 4 2 5 5 5 6 3 4 3 5 4 6 6 
-5 4 2 5 5 5 6 3 4 3 5 4 6 6 
-5 4 2 5 5 5 6 3 4 3 5 4 6 
-5 4 2 5 5 5 6 3 4 3 5 4 6 
-5 4 2 5 5 5 6 3 4 3 5 4 6 6 
-5 4 2 5 5 5 6 3 4 3 5 4 
-5 4 2 5 5 5 6 3 4 3 5 4 
-5 4 2 5 5 5 6 3 4 3 5 4 6 6 
-5 4 2 5 5 5 6 3 4 3 5 4 6 6 
-5 4 2 5 5 5 6 3 4 3 5 4 6 
-5 4 2 5 5 5 6 3 4 3 5 4 6 
-5 4 2 5 5 5 6 3 4 3 5 4 
-5 4 2 5 5 5 6 3 4 3 5 4 
-5 4 2 5 5 5 6 3 4 3 5 4 
-5 4 2 5 5 5 6 3 4 3 5 4 
-5 4 2 5 5 5 6 3 4 3 5 4 6 6 
-5 4 2 5 5 5 6 3 4 3 5 4 
-5 4 2 5 5 5 6 3 4 3 5 4 
-5 4 2 5 5 5 6 3 
-5 4 2 5 5 5 6 3 
-5 4 2 5 5 5 6 3 
-5 4 2 5 5 5 6 3 4 3 4 3 
-5 4 2 5 5 5 6 3 
-5 4 2 5 5 5 3 6 
-5 4 2 5 5 5 6 3 4 3 5 4 6 6 
-5 4 2 5 5 5 6 3 4 3 5 4 6 6 
-5 4 2 5 5 5 6 3 4 3 5 4 
-5 4 2 5 5 5 6 3 4 3 5 4 6 
-5 4 2 5 5 5 6 3 4 3 5 4 6 6 
-5 4 2 5 5 5 6 3 4 3 5 4 
-20 4 2 5 5 5 5 3 
-20 4 2 5 5 5 5 3 
-20 4 2 5 5 5 3 2 
-25 4 2 5 5 5 2 
-50 4 2 5 5 5 1 
