800 5 6 5 5 3 4 6 4 6 3 1 3 1 2 5 6 6 6 2 3 6 2 2 2 2 4 
760 5 6 5 5 3 4 6 4 6 3 1 3 1 2 5 6 6 6 2 6 2 1 2 6 
750 5 6 5 5 3 4 6 4 6 3 1 3 1 2 5 6 4 4 4 5 3 6 6 2 2 6 
745 5 6 5 5 3 4 6 4 6 3 1 3 1 2 5 6 6 6 2 6 2 1 1 2 4 
735 5 6 5 5 3 4 6 4 6 3 1 3 1 2 5 6 6 6 2 6 2 2 6 
730 5 6 5 5 3 4 6 4 6 3 1 3 1 2 5 6 6 5 2 6 2 2 2 4 
725 5 6 5 5 3 4 6 4 6 3 1 3 1 2 5 6 6 6 2 6 2 1 1 2 3 
710 5 6 5 5 3 4 6 4 6 3 1 3 1 2 5 6 6 6 2 6 2 1 6 
695 5 6 5 5 3 4 6 4 6 3 1 3 1 2 5 6 6 6 2 6 2 1 5 
695 5 6 5 5 3 4 6 4 6 3 1 3 1 2 5 6 6 6 2 6 1 2 1 4 
695 5 6 5 5 3 4 6 4 6 3 1 3 1 2 5 6 6 6 2 6 2 1 5 
695 5 6 5 5 3 4 6 4 6 3 1 3 1 2 5 6 6 6 2 6 2 2 4 
685 5 6 5 5 3 4 6 4 6 3 1 3 1 2 5 6 6 6 2 6 2 6 
685 5 6 5 5 3 4 6 4 6 3 1 3 1 2 5 6 6 6 2 6 2 6 
685 5 6 5 5 3 4 6 4 6 3 1 3 1 2 5 6 6 6 2 6 2 6 
685 5 6 5 5 3 4 6 4 6 3 1 3 1 2 5 6 6 6 2 6 2 6 
685 5 6 5 5 3 4 6 4 6 3 1 3 1 2 5 6 6 6 2 6 2 6 
685 5 6 5 5 3 4 6 4 6 3 1 3 1 2 5 6 6 6 2 6 2 6 
685 5 6 5 5 3 4 6 4 6 3 1 3 1 2 5 6 6 6 2 6 2 6 
685 5 6 5 5 3 4 6 4 6 3 1 3 1 2 5 6 6 6 2 6 2 6 
685 5 6 5 5 3 4 6 4 6 3 1 3 1 2 5 6 6 6 2 6 2 6 
685 5 6 5 5 3 4 6 4 6 3 1 3 1 2 5 6 6 6 2 6 2 6 
685 5 6 5 5 3 4 6 4 6 3 1 3 1 2 5 6 6 6 2 6 2 6 
685 5 6 5 5 3 4 6 4 6 3 1 3 1 2 5 6 6 6 2 6 2 6 
685 5 6 5 5 3 4 6 4 6 3 1 3 1 2 5 6 6 6 2 6 2 6 
685 5 6 5 5 3 4 6 4 6 3 1 3 1 2 5 6 6 6 2 6 2 6 
680 5 6 5 5 3 4 6 4 6 3 1 3 1 2 5 6 6 6 2 5 2 1 5 
680 5 6 5 5 3 4 6 4 6 3 1 3 1 2 5 6 6 6 2 3 3 6 1 1 5 
675 5 6 5 5 3 4 6 4 6 3 1 3 1 2 5 3 3 6 5 5 6 5 1 2 5 
675 5 6 5 5 3 4 6 4 6 3 1 3 1 2 5 6 6 5 3 4 1 6 2 6 
670 5 6 5 5 3 4 6 4 6 3 1 3 1 2 5 6 6 6 2 6 2 5 
670 5 6 5 5 3 4 6 4 6 3 1 3 1 2 5 6 6 6 2 6 2 5 
670 5 6 5 5 3 4 6 4 6 3 1 3 1 2 5 6 6 6 2 1 2 1 6 
670 5 6 5 5 3 4 6 4 6 3 1 3 1 2 5 6 6 6 2 6 2 5 
670 5 6 5 5 3 4 6 4 6 3 1 3 1 2 5 6 6 6 2 6 2 5 
670 5 6 5 5 3 4 6 4 6 3 1 3 1 2 5 6 6 6 2 6 2 5 
660 5 6 5 5 3 4 6 4 6 3 1 3 1 2 5 6 6 3 5 1 1 2 1 1 6 
660 5 6 5 5 3 4 6 4 6 3 1 3 1 2 5 6 6 6 2 6 1 6 
650 5 6 5 5 3 4 6 4 6 3 1 3 1 2 5 6 6 3 5 1 3 4 1 4 2 5 
645 5 6 5 5 3 4 6 4 6 3 1 3 1 2 5 6 6 6 2 5 1 6 
645 5 6 5 5 3 4 6 4 6 3 1 3 1 2 5 6 6 6 2 6 2 4 
645 5 6 5 5 3 4 6 4 6 3 1 3 1 2 5 6 6 6 2 6 2 4 
645 5 6 5 5 3 4 6 4 6 3 1 3 1 2 5 6 6 6 2 6 2 4 
645 5 6 5 5 3 4 6 4 6 3 1 3 1 2 5 6 6 6 2 6 2 4 
645 5 6 5 5 3 4 6 4 6 3 1 3 1 2 5 6 6 6 2 6 2 4 
645 5 6 5 5 3 4 6 4 6 3 1 3 1 2 5 6 6 6 2 6 2 4 
645 5 6 5 5 3 4 6 4 6 3 1 3 1 2 5 6 6 6 2 6 2 4 
645 5 6 5 5 3 4 6 4 6 3 1 3 1 2 5 6 6 6 2 6 2 4 
645 5 6 5 5 3 4 6 4 6 3 1 3 1 2 5 6 6 6 2 6 2 4 
645 5 6 5 5 3 4 6 4 6 3 1 3 1 2 5 6 6 6 2 6 2 4 
645 5 6 5 5 3 4 6 4 6 3 1 3 1 2 5 6 6 6 2 6 2 4 
645 5 6 5 5 3 4 6 4 6 3 1 3 1 2 5 6 6 3 3 4 1 6 6 6 
645 5 6 5 5 3 4 6 4 6 3 1 3 1 2 5 6 6 6 2 6 2 4 
645 5 6 5 5 3 4 6 4 6 3 1 3 1 2 5 6 6 6 2 6 2 4 
645 5 6 5 5 3 4 6 4 6 3 1 3 1 2 5 6 6 6 2 6 2 4 
645 5 6 5 5 3 4 6 4 6 3 1 3 1 2 5 6 6 6 2 6 2 4 
640 5 6 5 5 3 4 6 4 6 3 1 3 1 2 5 6 6 6 1 4 3 6 6 
640 5 6 5 5 3 4 6 4 6 3 1 3 1 2 5 6 6 3 6 1 2 2 2 3 
640 5 6 5 5 3 4 6 4 6 3 1 3 1 2 5 6 5 5 6 5 2 1 4 
635 5 6 5 5 3 4 6 4 6 3 1 3 1 2 5 6 6 6 2 6 6 
635 5 6 5 5 3 4 6 4 6 3 1 3 1 2 5 6 6 6 2 6 6 
635 5 6 5 5 3 4 6 4 6 3 1 3 1 2 5 6 3 4 6 4 2 1 5 6 
635 5 6 5 5 3 4 6 4 6 3 1 3 1 2 5 6 6 6 2 6 6 
635 5 6 5 5 3 4 6 4 6 3 1 3 1 2 5 6 6 6 2 6 6 
635 5 6 5 5 3 4 6 4 6 3 1 3 1 2 5 6 6 6 2 6 6 
635 5 6 5 5 3 4 6 4 6 3 1 3 1 2 5 6 6 6 2 6 6 
635 5 6 5 5 3 4 6 4 6 3 1 3 1 2 5 6 6 6 2 6 6 
635 5 6 5 5 3 4 6 4 6 3 1 3 1 2 5 6 6 6 2 6 6 
635 5 6 5 5 3 4 6 4 6 3 1 3 1 2 5 6 6 6 2 6 6 
635 5 6 5 5 3 4 6 4 6 3 1 3 1 2 5 6 6 6 2 2 2 1 3 
635 5 6 5 5 3 4 6 4 6 3 1 3 1 2 5 6 6 6 2 6 6 
635 5 6 5 5 3 4 6 4 6 3 1 3 1 2 5 6 6 6 2 6 6 
630 5 6 5 5 3 4 6 4 6 3 1 3 1 2 5 6 6 6 1 2 2 5 
630 5 6 5 5 3 4 6 4 6 3 1 3 1 2 5 6 6 6 2 4 2 5 
630 5 6 5 5 3 4 6 4 6 3 1 3 1 2 5 6 6 6 2 2 1 5 
630 5 6 5 5 3 4 6 4 6 3 1 3 1 2 5 6 1 4 5 5 3 1 4 2 5 
630 5 6 5 5 3 4 6 4 6 3 1 3 1 2 5 6 6 4 5 2 6 5 
625 5 6 5 5 3 4 6 4 6 3 1 3 1 2 5 6 6 6 3 4 1 2 6 
625 5 6 5 5 3 4 6 4 6 3 1 3 1 2 5 6 6 6 2 6 2 3 
625 5 6 5 5 3 4 6 4 6 3 1 3 1 2 5 6 6 6 2 6 2 3 
625 5 6 5 5 3 4 6 4 6 3 1 3 1 2 5 6 6 6 2 6 2 3 
625 5 6 5 5 3 4 6 4 6 3 1 3 1 2 5 6 6 6 2 6 2 3 
625 5 6 5 5 3 4 6 4 6 3 1 3 1 2 5 6 6 6 2 3 5 6 
625 5 6 5 5 3 4 6 4 6 3 1 3 1 2 5 6 6 6 2 6 2 3 
625 5 6 5 5 3 4 6 4 6 3 1 3 1 2 5 6 6 6 2 3 6 5 
620 5 6 5 5 3 4 6 4 6 3 1 3 1 2 5 6 6 6 2 6 5 
620 5 6 5 5 3 4 6 4 6 3 1 3 1 2 5 6 6 6 2 6 5 
620 5 6 5 5 3 4 6 4 6 3 1 3 1 2 5 6 6 6 2 6 1 4 
620 5 6 5 5 3 4 6 4 6 3 1 3 1 2 5 6 6 6 2 5 6 
620 5 6 5 5 3 4 6 4 6 3 1 3 1 2 5 6 6 6 2 6 5 
620 5 6 5 5 3 4 6 4 6 3 1 3 1 2 5 6 6 6 2 6 5 
620 5 6 5 5 3 4 6 4 6 3 1 3 1 2 5 6 6 6 2 6 5 
620 5 6 5 5 3 4 6 4 6 3 1 3 1 2 5 6 6 6 2 6 5 
620 5 6 5 5 3 4 6 4 6 3 1 3 1 2 5 6 6 6 2 6 1 4 
620 5 6 5 5 3 4 6 4 6 3 1 3 1 2 5 6 6 6 2 6 5 
620 5 6 5 5 3 4 6 4 6 3 1 3 1 2 5 6 6 6 2 5 6 
620 5 6 5 5 3 4 6 4 6 3 1 3 1 2 5 6 6 6 2 6 5 
620 5 6 5 5 3 4 6 4 6 3 1 3 1 2 5 6 6 6 2 2 6 
620 5 6 5 5 3 4 6 4 6 3 1 3 1 2 5 6 6 4 4 3 5 4 1 2 4 
615 5 6 5 5 3 4 6 4 6 3 1 3 1 2 5 6 6 6 2 3 5 2 3 
615 5 6 5 5 3 4 6 4 6 3 1 3 1 2 5 6 5 6 1 4 2 1 5 
610 5 6 5 5 3 4 6 4 6 3 1 3 1 2 5 6 6 5 3 5 2 6 
610 5 6 5 5 3 4 6 4 6 3 1 3 1 2 5 6 6 4 3 6 3 4 6 1 3 
610 5 6 5 5 3 4 6 4 6 3 1 3 1 2 5 6 6 4 5 2 3 1 6 
605 5 6 5 5 3 4 6 4 6 3 1 3 1 2 5 6 6 6 2 5 5 
605 5 6 5 5 3 4 6 4 6 3 1 3 1 2 5 6 6 6 2 5 5 
605 5 6 5 5 3 4 6 4 6 3 1 3 1 2 5 6 6 4 5 4 4 6 4 
605 5 6 5 5 3 4 6 4 6 3 1 3 1 2 5 6 6 6 2 5 5 
605 5 6 5 5 3 4 6 4 6 3 1 3 1 2 5 6 6 5 6 5 5 
605 5 6 5 5 3 4 6 4 6 3 1 3 1 2 5 6 6 6 2 2 5 
600 5 6 5 5 3 4 6 4 6 3 1 3 1 2 5 6 6 6 2 3 4 6 
600 5 6 5 5 3 4 6 4 6 3 1 3 1 2 5 6 6 6 2 6 1 3 
600 5 6 5 5 3 4 6 4 6 3 1 3 1 2 5 6 6 6 4 4 3 6 4 
600 5 6 5 5 3 4 6 4 6 3 1 3 1 2 5 6 6 6 2 6 1 3 
600 5 6 5 5 3 4 6 4 6 3 1 3 1 2 5 6 6 6 4 3 6 5 
600 5 6 5 5 3 4 6 4 6 3 1 3 1 2 5 6 4 6 6 3 1 1 6 
595 5 6 5 5 3 4 6 4 6 3 1 3 1 2 5 3 3 6 5 3 6 1 6 5 
595 5 6 5 5 3 4 6 4 6 3 1 3 1 2 5 6 6 6 2 6 4 
595 5 6 5 5 3 4 6 4 6 3 1 3 1 2 5 6 6 6 2 6 4 
595 5 6 5 5 3 4 6 4 6 3 1 3 1 2 5 6 6 5 4 1 5 1 1 3 
595 5 6 5 5 3 4 6 4 6 3 1 3 1 2 5 6 6 4 3 5 4 2 5 
595 5 6 5 5 3 4 6 4 6 3 1 3 1 2 5 6 6 5 1 4 4 3 1 5 
595 5 6 5 5 3 4 6 4 6 3 1 3 1 2 5 6 6 6 2 6 4 
595 5 6 5 5 3 4 6 4 6 3 1 3 1 2 5 6 6 6 2 6 4 
595 5 6 5 5 3 4 6 4 6 3 1 3 1 2 5 6 6 6 2 6 4 
595 5 6 5 5 3 4 6 4 6 3 1 3 1 2 5 6 6 6 2 6 4 
595 5 6 5 5 3 4 6 4 6 3 1 3 1 2 5 6 3 6 4 5 4 2 5 
595 5 6 5 5 3 4 6 4 6 3 1 3 1 2 5 6 6 6 2 6 4 
595 5 6 5 5 3 4 6 4 6 3 1 3 1 2 5 6 6 6 2 1 6 
595 5 6 5 5 3 4 6 4 6 3 1 3 1 2 5 6 6 6 2 4 6 
590 5 6 5 5 3 4 6 4 6 3 1 3 1 2 5 6 6 4 5 1 1 2 4 
590 5 6 5 5 3 4 6 4 6 3 1 3 1 2 5 6 5 5 6 5 5 
585 5 6 5 5 3 4 6 4 6 3 1 3 1 2 5 6 6 4 3 6 3 3 4 6 
585 5 6 5 5 3 4 6 4 6 3 1 3 1 2 5 6 6 6 2 1 2 3 
580 5 6 5 5 3 4 6 4 6 3 1 3 1 2 5 6 6 6 2 1 5 
580 5 6 5 5 3 4 6 4 6 3 1 3 1 2 5 6 6 6 2 2 4 
580 5 6 5 5 3 4 6 4 6 3 1 3 1 2 5 6 6 6 2 4 5 
580 5 6 5 5 3 4 6 4 6 3 1 3 1 2 5 6 6 6 2 2 4 
580 5 6 5 5 3 4 6 4 6 3 1 3 1 2 5 6 6 6 2 4 5 
580 5 6 5 5 3 4 6 4 6 3 1 3 1 2 5 6 3 3 6 4 1 1 3 4 2 1 3 
580 5 6 5 5 3 4 6 4 6 3 1 3 1 2 5 6 1 5 6 3 4 3 4 2 3 
580 5 6 5 5 3 4 6 4 6 3 1 3 1 2 5 6 6 6 2 4 5 
580 5 6 5 5 3 4 6 4 6 3 1 3 1 2 5 6 6 6 2 1 5 
580 5 6 5 5 3 4 6 4 6 3 1 3 1 2 5 6 6 6 2 2 4 
575 5 6 5 5 3 4 6 4 6 3 1 3 1 2 5 6 6 6 3 3 4 3 3 4 5 
575 5 6 5 5 3 4 6 4 6 3 1 3 1 2 5 6 6 6 2 6 3 
575 5 6 5 5 3 4 6 4 6 3 1 3 1 2 5 6 6 6 2 6 3 
575 5 6 5 5 3 4 6 4 6 3 1 3 1 2 5 6 6 6 2 6 3 
575 5 6 5 5 3 4 6 4 6 3 1 3 1 2 5 6 6 6 2 6 3 
575 5 6 5 5 3 4 6 4 6 3 1 3 1 2 5 6 6 6 2 6 3 
575 5 6 5 5 3 4 6 4 6 3 1 3 1 2 5 6 6 6 3 6 5 
575 5 6 5 5 3 4 6 4 6 3 1 3 1 2 5 6 6 6 2 6 3 
575 5 6 5 5 3 4 6 4 6 3 1 3 1 2 5 6 6 6 2 6 3 
575 5 6 5 5 3 4 6 4 6 3 1 3 1 2 5 6 6 6 2 6 3 
570 5 6 5 5 3 4 6 4 6 3 1 3 1 2 5 6 1 6 4 3 2 2 4 
565 5 6 5 5 3 4 6 4 6 3 1 3 1 2 5 6 6 6 2 3 5 3 
560 5 6 5 5 3 4 6 4 6 3 1 3 1 2 5 6 6 6 2 2 3 
560 5 6 5 5 3 4 6 4 6 3 1 3 1 2 5 6 6 6 2 2 3 
560 5 6 5 5 3 4 6 4 6 3 1 3 1 2 5 6 6 6 2 3 4 4 
560 5 6 5 5 3 4 6 4 6 3 1 3 1 2 5 6 6 5 6 5 3 
560 5 6 5 5 3 4 6 4 6 3 1 3 1 2 5 6 6 6 2 4 1 3 
555 5 6 5 5 3 4 6 4 6 3 1 3 1 2 5 6 3 4 3 6 5 5 4 3 
555 5 6 5 5 3 4 6 4 6 3 1 3 1 2 5 6 6 6 4 5 4 
555 5 6 5 5 3 4 6 4 6 3 1 3 1 2 5 6 6 6 2 4 4 
555 5 6 5 5 3 4 6 4 6 3 1 3 1 2 5 6 6 6 2 1 4 
555 5 6 5 5 3 4 6 4 6 3 1 3 1 2 5 6 6 6 2 1 4 
555 5 6 5 5 3 4 6 4 6 3 1 3 1 2 5 6 6 6 2 1 4 
555 5 6 5 5 3 4 6 4 6 3 1 3 1 2 5 6 6 6 2 4 4 
550 5 6 5 5 3 4 6 4 6 3 1 3 1 2 5 6 6 5 3 2 5 3 
535 5 6 5 5 3 4 6 4 6 3 1 3 1 2 5 6 6 6 2 4 3 
535 5 6 5 5 3 4 6 4 6 3 1 3 1 2 5 6 6 6 2 4 3 
535 5 6 5 5 3 4 6 4 6 3 1 3 1 2 5 6 6 6 2 4 3 
465 5 6 5 5 3 4 6 4 6 3 1 3 1 2 5 6 6 4 2 
445 5 6 5 5 3 4 6 4 6 3 1 3 5 1 5 6 3 6 4 1 
445 5 6 5 5 3 4 6 4 6 3 1 3 1 2 5 6 6 3 2 
445 5 6 5 5 3 4 6 4 6 3 1 3 1 2 5 6 6 3 2 
440 5 6 5 5 3 4 6 4 6 3 1 3 1 2 5 6 6 2 
440 5 6 5 5 3 4 6 4 6 3 1 3 1 2 5 6 1 6 1 
435 5 6 5 5 3 4 6 4 6 3 1 3 1 2 5 6 3 3 5 2 
435 5 6 5 5 3 4 6 4 6 3 1 3 1 2 5 3 5 1 3 3 3 3 5 1 
435 5 6 5 5 3 4 6 4 6 3 1 3 1 2 5 3 3 6 5 2 
425 5 6 5 5 3 4 6 4 6 3 1 3 1 2 5 6 6 3 3 1 
425 5 6 5 5 3 4 6 4 6 3 1 3 1 2 5 6 5 2 
425 5 6 5 5 3 4 6 4 6 3 1 3 1 2 5 6 5 2 
425 5 6 5 5 3 4 6 4 6 3 1 3 1 2 5 6 5 2 
425 5 6 5 5 3 4 6 4 6 3 1 3 1 2 5 6 3 3 6 1 
420 5 6 5 5 3 4 6 4 6 3 1 3 1 2 5 6 6 3 1 
420 5 6 5 5 3 4 6 4 6 3 1 3 1 2 5 6 6 3 1 
415 5 6 5 5 3 4 6 4 6 3 1 3 1 2 5 6 6 1 
415 5 6 5 5 3 4 6 4 6 3 1 3 1 2 5 6 6 1 
415 5 6 5 5 3 4 6 4 6 3 1 3 1 2 5 6 6 1 
400 5 6 5 5 3 4 6 4 6 3 1 3 1 2 5 6 1 2 
400 5 6 5 5 3 4 6 4 6 3 1 3 1 2 5 6 1 4 1 
400 5 6 5 5 3 4 6 4 6 3 1 3 1 2 5 6 3 6 3 
395 5 6 5 5 3 4 6 4 6 3 1 3 1 2 5 6 3 6 3 5 2 1 6 
390 5 6 5 5 3 4 6 4 6 3 1 3 1 2 5 3 5 1 4 1 
380 5 6 5 5 3 4 6 4 6 3 1 3 1 2 5 3 5 6 
380 5 6 5 5 3 4 6 4 6 3 1 3 1 2 5 6 5 3 
380 5 6 5 5 3 4 6 4 6 3 1 3 1 2 5 6 3 2 
375 5 6 5 5 3 4 6 4 6 3 1 3 1 2 5 6 1 1 
375 5 6 5 5 3 4 6 4 6 3 1 3 1 2 5 6 1 1 
375 5 6 5 5 3 4 6 4 6 3 1 3 1 2 5 6 2 
375 5 6 5 5 3 4 6 4 6 3 1 3 1 2 5 6 4 1 
375 5 6 5 5 3 4 6 4 6 3 1 3 1 2 5 6 4 1 
360 5 6 5 5 3 4 6 4 6 3 1 3 1 2 5 3 6 3 1 
360 5 6 5 5 3 4 6 4 6 3 1 6 6 5 1 1 
355 5 6 5 5 3 4 6 4 6 3 1 3 1 2 5 6 1 3 
355 5 6 5 5 3 4 6 4 6 3 1 3 1 2 5 3 6 1 
340 5 6 5 5 3 4 6 4 6 3 1 3 5 3 6 6 1 4 
315 5 6 5 5 3 4 6 4 6 3 1 3 1 2 5 3 2 
310 5 6 5 5 3 4 6 4 6 3 1 3 1 2 5 5 
310 5 6 5 5 3 4 6 4 6 3 1 3 1 2 5 2 
310 5 6 5 5 3 4 6 4 6 3 1 3 1 2 5 5 
310 5 6 5 5 3 4 6 4 6 3 1 3 1 2 5 5 
310 5 6 5 5 3 4 6 4 6 3 1 3 1 2 5 5 
310 5 6 5 5 3 4 6 4 6 3 1 3 1 2 5 5 
310 5 6 5 5 3 4 6 4 6 3 1 3 1 2 5 2 
300 5 6 5 5 3 4 6 4 6 3 1 1 1 3 6 2 
295 5 6 5 5 3 4 6 4 6 3 1 1 1 5 6 
295 5 6 5 5 3 4 6 4 6 3 1 1 1 5 6 
285 5 6 5 5 3 4 6 4 6 3 1 3 1 2 5 1 
285 5 6 5 5 3 4 6 4 6 3 1 3 1 2 5 4 
285 5 6 5 5 3 4 6 4 6 3 1 3 1 2 5 1 
285 5 6 5 5 3 4 6 4 6 3 1 3 1 2 5 1 
285 5 6 5 5 3 4 6 4 6 3 1 3 1 2 5 1 
285 5 6 5 5 3 4 6 4 6 3 1 3 1 2 5 1 
285 5 6 5 5 3 4 6 4 6 3 1 3 1 2 5 4 
285 5 6 5 5 3 4 6 4 6 3 1 3 1 2 5 4 
280 5 6 5 5 3 4 6 4 6 3 1 4 2 4 5 
280 5 6 5 5 3 4 6 4 6 3 1 1 1 2 2 
275 5 6 5 5 3 4 6 4 6 3 1 3 1 2 6 
275 5 6 5 5 3 4 6 4 6 3 1 3 1 2 6 
275 5 6 5 5 3 4 6 4 6 3 1 5 4 4 5 6 6 
275 5 6 5 5 3 4 6 4 6 3 1 3 1 2 6 
275 5 6 5 5 3 4 6 4 6 3 1 3 1 2 6 
275 5 6 5 5 3 4 6 4 6 3 1 3 1 2 6 
265 5 6 5 5 3 4 6 4 6 3 1 3 1 2 3 2 
265 5 6 5 5 3 4 6 4 6 3 1 3 1 2 3 2 
260 5 6 5 5 3 4 6 4 6 3 1 3 1 2 2 
255 5 6 5 5 3 4 6 4 6 3 1 1 3 3 1 6 
255 5 6 5 5 3 4 6 4 6 3 1 2 4 2 
255 5 6 5 5 3 4 6 4 6 3 1 1 1 5 1 
255 5 6 5 5 3 4 6 4 6 3 1 4 1 2 1 
250 5 6 5 5 3 4 6 4 6 3 1 4 5 1 4 6 3 2 
250 5 6 5 5 3 4 6 4 6 3 1 4 5 1 4 6 
235 5 6 5 5 3 4 6 4 6 3 1 3 1 1 2 
235 5 6 5 5 3 4 6 4 6 3 1 3 1 2 4 
235 5 6 5 5 3 4 6 4 6 3 1 3 1 2 1 
235 5 6 5 5 3 4 6 4 6 3 1 3 1 2 4 
235 5 6 5 5 3 4 6 4 6 3 1 3 2 5 
235 5 6 5 5 3 4 6 4 6 3 1 3 1 1 5 
235 5 6 5 5 3 4 6 4 6 3 1 1 4 2 3 
230 5 6 5 5 3 4 6 4 6 3 1 3 1 3 6 
225 5 6 5 5 3 4 6 4 6 3 1 3 1 6 
225 5 6 5 5 3 4 6 4 6 3 1 3 1 6 
225 5 6 5 5 3 4 6 4 6 3 1 3 1 6 
