535 5 6 5 5 5 5 4 3 2 1 6 1 4 2 6 3 6 6 2 
495 5 6 5 5 5 5 4 3 2 1 6 1 4 2 3 5 1 5 3 4 5 1 
480 5 6 5 5 5 5 4 3 2 1 6 1 4 2 5 4 6 3 2 
455 5 6 5 5 5 5 4 3 2 1 6 1 4 2 3 5 6 5 
455 5 6 5 5 5 5 4 3 2 1 5 4 6 6 5 5 3 1 
445 5 6 5 5 5 5 4 3 2 1 6 1 4 2 6 3 4 6 
435 5 6 5 5 5 5 4 3 2 1 6 1 4 2 5 5 2 
435 5 6 5 5 5 5 4 3 2 1 6 1 4 2 5 4 4 2 
410 5 6 5 5 5 5 4 3 2 1 6 1 2 1 5 4 2 
400 5 6 5 5 5 5 4 3 2 1 6 1 4 2 5 6 
400 5 6 5 5 5 5 4 3 2 1 6 1 5 1 6 2 
400 5 6 5 5 5 5 4 3 2 1 6 1 4 2 6 5 
395 5 6 5 5 5 5 4 3 2 1 6 1 4 2 5 3 5 3 
375 5 6 5 5 5 5 4 3 2 1 6 1 5 4 6 1 
375 5 6 5 5 5 5 4 3 2 1 6 1 5 6 2 
335 5 6 5 5 5 5 4 3 2 1 6 1 2 1 2 
335 5 6 5 5 5 5 4 3 2 1 6 1 4 2 2 
335 5 6 5 5 5 5 4 3 2 1 6 1 4 2 2 
335 5 6 5 5 5 5 4 3 2 1 6 1 4 2 2 
335 5 6 5 5 5 5 4 3 2 1 6 1 4 2 2 
325 5 6 5 5 5 5 4 3 2 1 6 1 4 1 6 
325 5 6 5 5 5 5 4 3 2 1 2 5 2 4 3 4 
325 5 6 5 5 5 5 4 3 2 1 6 1 1 1 6 
325 5 6 5 5 5 5 4 3 2 1 6 1 4 1 6 
320 5 6 5 5 5 5 4 3 2 1 4 1 3 4 3 2 6 
315 5 6 5 5 5 5 4 3 2 1 6 3 2 2 1 
315 5 6 5 5 5 5 4 3 2 1 6 6 6 
315 5 6 5 5 5 5 4 3 2 1 6 6 6 
315 5 6 5 5 5 5 4 3 2 1 6 6 6 
310 5 6 5 5 5 5 4 3 2 1 6 3 3 2 6 
310 5 6 5 5 5 5 4 3 2 1 6 1 4 2 1 
310 5 6 5 5 5 5 4 3 2 1 6 1 2 2 
310 5 6 5 5 5 5 4 3 2 1 6 1 4 2 4 
310 5 6 5 5 5 5 4 3 2 1 2 1 6 2 
310 5 6 5 5 5 5 4 3 2 1 6 1 4 2 4 
310 5 6 5 5 5 5 4 3 2 1 6 1 4 2 1 
310 5 6 5 5 5 5 4 3 2 1 6 1 4 1 5 
310 5 6 5 5 5 5 4 3 2 1 6 1 4 2 1 
310 5 6 5 5 5 5 4 3 2 1 6 1 4 2 1 
310 5 6 5 5 5 5 4 3 2 1 6 1 5 2 
310 5 6 5 5 5 5 4 3 2 1 6 1 5 4 1 
310 5 6 5 5 5 5 4 3 2 1 6 1 4 2 4 
310 5 6 5 5 5 5 4 3 2 1 6 1 2 5 
310 5 6 5 5 5 5 4 3 2 1 6 1 4 2 1 
310 5 6 5 5 5 5 4 3 2 1 6 1 5 2 
310 5 6 5 5 5 5 4 3 2 1 6 2 1 4 4 
310 5 6 5 5 5 5 4 3 2 1 5 6 1 5 
310 5 6 5 5 5 5 4 3 2 1 6 4 2 5 
305 5 6 5 5 5 5 4 3 2 1 6 2 3 6 
305 5 6 5 5 5 5 4 3 2 1 6 1 1 3 6 
300 5 6 5 5 5 5 4 3 2 1 6 6 2 
300 5 6 5 5 5 5 4 3 2 1 6 1 4 6 
300 5 6 5 5 5 5 4 3 2 1 6 4 1 6 
300 5 6 5 5 5 5 4 3 2 1 6 6 2 
300 5 6 5 5 5 5 4 3 2 1 6 1 4 6 
300 5 6 5 5 5 5 4 3 2 1 6 1 4 6 
300 5 6 5 5 5 5 4 3 2 1 6 6 5 
300 5 6 5 5 5 5 4 3 2 1 6 2 6 
300 5 6 5 5 5 5 4 3 2 1 6 6 2 
300 5 6 5 5 5 5 4 3 2 1 6 1 4 6 
300 5 6 5 5 5 5 4 3 2 1 6 6 5 
300 5 6 5 5 5 5 4 3 2 1 6 6 2 
300 5 6 5 5 5 5 4 3 2 1 6 1 4 6 
295 5 6 5 5 5 5 4 3 2 1 5 6 3 3 5 
295 5 6 5 5 5 5 4 3 2 1 5 1 2 4 1 
295 5 6 5 5 5 5 4 3 2 1 6 1 1 3 3 5 
295 5 6 5 5 5 5 4 3 2 1 4 5 2 5 
290 5 6 5 5 5 5 4 3 2 1 6 1 4 3 2 
290 5 6 5 5 5 5 4 3 2 1 1 4 2 3 3 3 3 2 
290 5 6 5 5 5 5 4 3 2 1 6 1 4 3 5 
290 5 6 5 5 5 5 4 3 2 1 6 1 4 3 2 
290 5 6 5 5 5 5 4 3 2 1 6 1 4 3 2 
290 5 6 5 5 5 5 4 3 2 1 4 1 5 3 6 
290 5 6 5 5 5 5 4 3 2 1 3 5 5 6 
290 5 6 5 5 5 5 4 3 2 1 3 2 2 6 
290 5 6 5 5 5 5 4 3 2 1 6 4 3 1 5 
285 5 6 5 5 5 5 4 3 2 1 6 2 5 
285 5 6 5 5 5 5 4 3 2 1 6 1 4 5 
285 5 6 5 5 5 5 4 3 2 1 6 2 2 
285 5 6 5 5 5 5 4 3 2 1 6 1 4 4 1 
285 5 6 5 5 5 5 4 3 2 1 6 1 4 4 4 
285 5 6 5 5 5 5 4 3 2 1 6 1 4 1 4 
285 5 6 5 5 5 5 4 3 2 1 6 1 4 1 1 
285 5 6 5 5 5 5 4 3 2 1 6 1 4 5 
285 5 6 5 5 5 5 4 3 2 1 6 1 1 4 4 
285 5 6 5 5 5 5 4 3 2 1 6 1 1 5 
285 5 6 5 5 5 5 4 3 2 1 6 1 4 5 
285 5 6 5 5 5 5 4 3 2 1 6 1 4 5 
285 5 6 5 5 5 5 4 3 2 1 6 3 4 3 6 
285 5 6 5 5 5 5 4 3 2 1 2 5 6 
285 5 6 5 5 5 5 4 3 2 1 6 5 2 
280 5 6 5 5 5 5 4 3 2 1 3 3 5 5 1 4 
280 5 6 5 5 5 5 4 3 2 1 6 1 3 6 
280 5 6 5 5 5 5 4 3 2 1 3 4 2 3 4 2 
280 5 6 5 5 5 5 4 3 2 1 3 2 3 1 4 1 1 
280 5 6 5 5 5 5 4 3 2 1 3 4 3 5 4 5 
280 5 6 5 5 5 5 4 3 2 1 2 3 5 3 4 4 
280 5 6 5 5 5 5 4 3 2 1 6 3 4 6 
275 5 6 5 5 5 5 4 3 2 1 6 6 4 
275 5 6 5 5 5 5 4 3 2 1 6 1 6 
275 5 6 5 5 5 5 4 3 2 1 1 6 6 
275 5 6 5 5 5 5 4 3 2 1 6 6 1 
275 5 6 5 5 5 5 4 3 2 1 6 1 6 
275 5 6 5 5 5 5 4 3 2 1 2 5 5 3 
275 5 6 5 5 5 5 4 3 2 1 6 4 6 
270 5 6 5 5 5 5 4 3 2 1 6 3 3 2 4 
265 5 6 5 5 5 5 4 3 2 1 6 3 5 1 
265 5 6 5 5 5 5 4 3 2 1 6 4 3 2 
265 5 6 5 5 5 5 4 3 2 1 6 1 4 4 3 
265 5 6 5 5 5 5 4 3 2 1 6 1 3 1 4 
265 5 6 5 5 5 5 4 3 2 1 6 1 5 3 
265 5 6 5 5 5 5 4 3 2 1 6 1 4 3 1 
265 5 6 5 5 5 5 4 3 2 1 6 1 2 3 
265 5 6 5 5 5 5 4 3 2 1 6 1 5 3 
265 5 6 5 5 5 5 4 3 2 1 6 3 4 5 
265 5 6 5 5 5 5 4 3 2 1 6 3 4 5 
265 5 6 5 5 5 5 4 3 2 1 6 2 1 3 
255 5 6 5 5 5 5 4 3 2 1 6 6 3 
255 5 6 5 5 5 5 4 3 2 1 6 6 3 
255 5 6 5 5 5 5 4 3 2 1 6 6 3 
250 5 6 5 5 5 5 4 3 2 1 3 5 3 3 6 
250 5 6 5 5 5 5 4 3 2 1 3 3 3 6 1 4 
250 5 6 5 5 5 5 4 3 2 1 6 3 3 2 3 
250 5 6 5 5 5 5 4 3 2 1 5 3 3 3 6 
130 5 6 5 5 5 5 4 4 6 2 
130 5 6 5 5 5 5 4 4 6 
115 5 6 5 5 5 5 1 1 5 3 4 4 2 
-25 5 6 5 5 5 5 4 3 2 1 5 3 3 4 3 6 
