-135 6 5 5 3 4 4 5 2 1 
-135 6 5 5 3 4 4 5 
-135 6 5 5 3 4 4 5 2 
-135 6 5 5 3 4 4 5 2 
-135 6 5 5 3 4 4 5 2 
-135 6 5 5 3 4 4 5 2 
-135 6 5 5 3 4 4 5 2 1 
-135 6 5 5 3 4 4 5 2 1 
-135 6 5 5 3 4 4 5 2 1 
-135 6 5 5 3 4 4 5 2 1 
-135 6 5 5 3 4 4 5 2 1 
-135 6 5 5 3 4 4 5 2 1 
-135 6 5 5 3 4 4 5 2 
-135 6 5 5 3 4 4 5 2 1 
-135 6 5 5 3 4 4 5 2 
-135 6 5 5 3 4 4 5 
-135 6 5 5 3 4 4 5 
-135 6 5 5 3 4 4 5 
-135 6 5 5 3 4 4 5 2 
-135 6 5 5 3 4 4 5 
-135 6 5 5 3 4 4 5 
-135 6 5 5 3 4 4 5 2 
-135 6 5 5 3 4 4 5 2 1 
-135 6 5 5 3 4 4 5 
-135 6 5 5 3 4 4 5 
-135 6 5 5 3 4 4 5 2 1 
-135 6 5 5 3 4 4 5 
-135 6 5 5 3 4 4 5 2 1 
-135 6 5 5 3 4 4 5 
-135 6 5 5 3 4 4 5 
-135 6 5 5 3 4 4 5 
-135 6 5 5 3 4 4 5 2 
-135 6 5 5 3 4 4 5 2 1 
-135 6 5 5 3 4 4 5 2 
-135 6 5 5 3 4 4 5 
-135 6 5 5 3 4 4 5 4 5 
-135 6 5 5 3 4 4 5 
-135 6 5 5 3 4 4 5 
-135 6 5 5 3 4 4 5 2 4 
-135 6 5 5 3 4 4 5 
-135 6 5 5 3 4 4 5 2 
-135 6 5 5 3 4 4 5 2 
-135 6 5 5 3 4 4 5 2 1 
-135 6 5 5 3 4 4 5 4 
-135 6 5 5 3 4 4 5 2 4 
-135 6 5 5 3 4 4 5 1 4 1 
-135 6 5 5 3 4 4 5 4 
-135 6 5 5 3 4 4 5 2 
-135 6 5 5 3 4 4 5 2 
-135 6 5 5 3 4 4 5 1 1 3 
-135 6 5 5 3 4 4 5 2 
-135 6 5 5 3 4 4 
-135 6 5 5 3 4 4 5 2 
-135 6 5 5 3 4 4 5 2 
-135 6 5 5 3 4 4 5 
-135 6 5 5 3 4 4 
-135 6 5 5 3 4 4 5 2 
-135 6 5 5 3 4 4 
-135 6 5 5 3 4 4 
-135 6 5 5 3 4 4 5 2 4 
-135 6 5 5 3 4 4 5 2 
-135 6 5 5 3 4 4 5 4 1 
-135 6 5 5 3 4 4 5 2 
-135 6 5 5 3 4 4 5 3 3 
