330 4 5 5 5 5 3 5 1 4 3 6 6 4 1 2 6 
330 4 5 5 5 5 3 5 1 4 3 6 6 4 2 4 6 
315 4 5 5 5 5 3 5 1 4 3 6 6 4 2 4 2 
310 4 5 5 5 5 3 5 1 4 3 6 6 4 2 3 6 
310 4 5 5 5 5 3 5 1 4 3 6 6 4 2 3 6 
310 4 5 5 5 5 3 5 1 4 3 6 6 4 2 3 6 
310 4 5 5 5 5 3 5 1 4 3 6 6 4 2 3 6 
305 4 5 5 5 5 3 5 1 4 3 6 6 4 2 6 
305 4 5 5 5 5 3 5 1 4 3 6 6 4 2 6 
305 4 5 5 5 5 3 5 1 4 3 6 6 4 2 6 
295 4 5 5 5 5 3 5 1 4 3 6 6 4 2 3 5 
295 4 5 5 5 5 3 5 1 4 3 6 6 4 2 3 5 
295 4 5 5 5 5 3 5 1 4 3 6 6 4 2 3 2 1 
295 4 5 5 5 5 3 5 1 4 3 6 6 4 2 3 2 4 
290 4 5 5 5 5 3 5 1 4 3 6 6 4 2 2 
290 4 5 5 5 5 3 5 1 4 3 6 6 4 2 2 
290 4 5 5 5 5 3 5 1 4 3 6 6 4 5 5 
280 4 5 5 5 5 3 5 1 4 3 6 6 4 1 6 
270 4 5 5 5 5 3 5 1 4 3 6 6 4 4 3 2 5 
270 4 5 5 5 5 3 5 1 4 3 6 6 4 2 3 1 
270 4 5 5 5 5 3 5 1 4 3 6 6 4 2 3 1 
270 4 5 5 5 5 3 5 1 4 3 6 6 4 2 3 1 
270 4 5 5 5 5 3 5 1 4 3 6 6 4 2 3 1 
250 4 5 5 5 5 3 5 1 4 3 6 6 4 2 3 3 2 
250 4 5 5 5 5 3 5 1 4 3 6 6 4 2 3 3 6 
145 4 5 5 5 5 3 5 5 4 4 6 
145 4 5 5 5 5 3 5 5 5 6 
130 4 5 5 5 5 3 5 5 4 4 2 
105 4 5 5 5 5 3 5 4 2 2 
105 4 5 5 5 5 3 5 1 5 2 
105 4 5 5 5 5 3 5 5 1 5 
105 4 5 5 5 5 3 4 5 4 5 4 
105 4 5 5 5 5 3 5 5 2 1 
100 4 5 5 5 5 3 5 2 3 6 
95 4 5 5 5 5 3 6 4 4 5 
95 4 5 5 5 5 3 6 4 4 2 
95 4 5 5 5 5 3 5 5 6 
90 4 5 5 5 5 3 5 3 4 5 3 4 
85 4 5 5 5 5 3 5 5 4 4 3 
85 4 5 5 5 5 3 5 5 5 3 
85 4 5 5 5 5 3 5 5 5 3 
80 4 5 5 5 5 3 5 2 4 4 
80 4 5 5 5 5 3 5 2 2 
80 4 5 5 5 5 3 5 2 2 
75 4 5 5 5 5 3 5 1 6 3 
75 4 5 5 5 5 6 3 4 4 3 1 
50 4 5 5 5 5 3 5 6 3 
-65 4 5 5 5 5 3 3 
