275 6 5 5 3 6 4 1 4 4 3 3 3 4 2 4 5 5 4 2 
130 6 5 5 3 6 4 1 4 3 2 6 
130 6 5 5 3 6 4 1 4 3 2 6 
125 6 5 5 3 6 4 1 4 2 6 
110 6 5 5 3 6 4 1 4 2 2 
110 6 5 5 3 6 4 1 4 5 2 
110 6 5 5 3 6 4 1 4 5 5 
110 6 5 5 3 6 4 1 4 2 2 
110 6 5 5 3 6 4 1 4 5 2 
110 6 5 5 3 6 4 1 4 2 2 
110 6 5 5 3 6 4 1 4 5 2 
110 6 5 5 3 6 4 1 4 5 5 
110 6 5 5 3 6 4 4 4 5 2 
110 6 5 5 3 6 4 5 5 2 
100 6 5 5 3 6 4 1 2 6 
100 6 5 5 3 6 4 1 6 2 
100 6 5 5 3 6 4 1 6 2 
100 6 5 5 3 6 4 1 6 5 
85 6 5 5 3 6 4 1 4 5 1 
85 6 5 5 3 6 4 1 5 5 
85 6 5 5 3 6 4 1 4 5 4 
85 6 5 5 3 6 4 1 4 1 5 
85 6 5 5 3 6 4 1 4 5 1 
85 6 5 5 3 6 4 1 1 1 2 
85 6 5 5 3 6 4 1 4 5 1 
85 6 5 5 3 6 4 1 4 4 2 
85 6 5 5 3 6 4 1 4 2 1 
85 6 5 5 3 6 4 1 4 5 4 
85 6 5 5 3 6 4 1 4 5 1 
85 6 5 5 3 6 4 1 4 4 4 1 
85 6 5 5 3 6 4 1 4 5 1 
85 6 5 5 3 6 4 1 2 2 
80 6 5 5 3 6 4 3 2 6 
75 6 5 5 3 6 4 1 4 6 
75 6 5 5 3 6 4 1 4 6 
75 6 5 5 3 6 4 1 4 6 
65 6 5 5 3 6 4 1 4 5 3 
60 6 5 5 3 6 4 1 4 1 4 
60 6 5 5 3 6 4 1 5 4 
60 6 5 5 3 6 4 1 4 1 4 
60 6 5 5 3 6 4 1 2 1 
60 6 5 5 3 6 4 1 1 4 4 
60 6 5 5 3 6 4 1 1 1 1 
60 6 5 5 3 6 4 1 1 5 
60 6 5 5 3 6 4 3 3 6 4 
40 6 5 5 3 6 4 1 5 3 
-10 6 5 5 3 6 4 1 3 
-10 6 5 5 3 6 4 1 3 
