700 4 4 6 5 5 6 4 5 5 1 2 1 3 5 3 6 4 5 6 4 6 1 2 6 
685 4 4 6 5 5 6 4 5 5 1 2 1 3 5 3 6 4 5 6 4 6 1 2 5 
675 4 4 6 5 5 6 4 5 5 1 2 1 3 5 3 6 4 5 6 4 6 1 1 6 
675 4 4 6 5 5 6 4 5 5 1 2 1 3 5 3 6 4 5 6 4 6 1 1 6 
675 4 4 6 5 5 6 4 5 5 1 2 1 3 5 3 6 4 5 6 4 6 1 1 6 
660 4 4 6 5 5 6 4 5 5 1 2 1 3 5 3 6 4 5 6 4 6 1 1 2 6 
650 4 4 6 5 5 6 4 5 5 1 2 1 3 5 3 6 4 5 6 4 6 1 6 
635 4 4 6 5 5 6 4 5 5 1 2 1 3 5 3 6 4 5 6 4 6 1 1 4 
635 4 4 6 5 5 6 4 5 5 1 2 1 3 5 3 6 4 5 6 4 6 1 1 4 
635 4 4 6 5 5 6 4 5 5 1 2 1 3 5 3 6 4 5 6 4 6 1 5 
635 4 4 6 5 5 6 4 5 5 1 2 1 3 5 3 6 4 5 6 4 6 1 5 
610 4 4 6 5 5 6 4 5 5 1 2 1 3 5 3 6 4 5 6 4 6 1 4 
610 4 4 6 5 5 6 4 5 5 1 2 1 3 5 3 6 4 5 6 4 6 1 4 
610 4 4 6 5 5 6 4 5 5 1 2 1 3 5 3 6 4 5 6 4 6 1 4 
610 4 4 6 5 5 6 4 5 5 1 2 1 3 5 3 6 4 5 6 4 6 1 4 
565 4 4 6 5 5 6 4 5 5 1 2 1 3 5 3 6 4 5 6 4 6 3 
380 4 4 6 5 5 6 4 5 5 1 2 1 1 5 5 1 1 
305 4 4 6 5 5 6 4 5 5 1 2 1 1 4 2 
285 4 4 6 5 5 6 4 5 5 1 6 1 6 
285 4 4 6 5 5 6 4 5 5 1 2 1 1 4 3 4 
280 4 4 6 5 5 6 4 5 5 1 2 1 1 2 
275 4 4 6 5 5 6 4 5 5 1 3 4 1 1 6 
270 4 4 6 5 5 6 4 5 5 1 2 4 6 
270 4 4 6 5 5 6 4 5 5 1 2 4 6 
270 4 4 6 5 5 6 4 5 5 1 2 1 6 
255 4 4 6 5 5 6 4 5 5 1 2 1 4 1 
245 4 4 6 5 5 6 4 5 5 1 2 6 
245 4 4 6 5 5 6 4 5 5 1 2 6 
235 4 4 6 5 5 6 4 5 5 1 4 5 3 1 
235 4 4 6 5 5 6 4 5 5 1 2 1 3 4 
