120 4 1 6 5 5 6 4 2 6 
110 4 1 6 5 5 6 6 6 
100 4 1 6 5 5 6 3 6 5 
100 4 1 6 5 5 6 3 6 5 
95 4 1 6 5 5 6 6 2 
95 4 1 6 5 5 6 2 6 
95 4 1 6 5 5 6 2 6 
95 4 1 6 5 5 6 6 2 
85 4 1 6 5 5 6 3 4 2 1 
85 4 1 6 5 5 6 3 2 5 
85 4 1 6 5 5 6 3 4 1 5 
85 4 1 6 5 5 6 3 4 1 2 
85 4 1 6 5 5 6 3 2 5 
85 4 1 6 5 5 6 3 4 5 4 
80 4 1 6 5 5 6 2 5 
70 4 1 6 5 5 6 4 6 
65 4 1 6 5 5 6 4 3 5 3 
60 4 1 6 5 5 6 3 2 1 
60 4 1 6 5 5 6 3 1 2 
60 4 1 6 5 5 6 3 4 4 4 6 
60 4 1 6 5 5 6 3 1 2 
55 4 1 6 5 5 6 3 6 3 
55 4 1 6 5 5 6 3 6 3 
40 4 1 6 5 5 6 3 1 1 3 
20 4 1 6 5 5 6 3 1 3 3 5 
20 4 1 6 5 5 6 3 1 3 3 1 
-10 4 1 6 5 5 6 3 3 1 4 5 
-10 4 1 6 5 5 6 3 3 
-10 4 1 6 5 5 6 3 3 1 5 5 
-15 4 1 6 5 5 6 3 3 5 
-15 4 1 6 5 5 6 3 3 3 
-15 4 1 6 5 5 6 3 3 5 
-15 4 1 6 5 5 6 3 3 3 6 
-15 4 1 6 5 5 6 3 3 1 3 
-15 4 1 6 5 5 6 3 3 1 4 
-15 4 1 6 5 5 6 3 3 1 2 
-15 4 1 6 5 5 6 3 3 1 2 
-15 4 1 6 5 5 6 3 3 1 1 
-15 4 1 6 5 5 6 3 3 3 5 
-15 4 1 6 5 5 6 3 3 3 
-30 4 1 6 5 5 3 2 
-65 4 1 6 5 5 1 4 
-390 4 1 6 5 5 6 3 3 
-390 4 1 6 5 5 6 3 3 
-390 4 1 6 5 5 6 3 
-390 4 1 6 5 5 6 3 
-390 4 1 6 5 5 6 3 3 
-390 4 1 6 5 5 6 3 
-390 4 1 6 5 5 6 3 
-390 4 1 6 5 5 6 3 3 
-390 4 1 6 5 5 6 3 
-390 4 1 6 5 5 6 3 3 
-390 4 1 6 5 5 6 3 3 
-390 4 1 6 5 5 6 3 
-390 4 1 6 5 5 6 3 
-390 4 1 6 5 5 6 3 
-390 4 1 6 5 5 6 3 3 
-390 4 1 6 5 5 6 3 
-390 4 1 6 5 5 6 3 3 
-390 4 1 6 5 5 6 3 3 
-390 4 1 6 5 5 6 3 3 
-390 4 1 6 5 5 6 3 
-390 4 1 6 5 5 6 3 3 
-390 4 1 6 5 5 6 3 3 
