345 2 1 5 5 5 5 5 5 2 6 4 1 3 2 2 
330 2 1 5 5 5 5 5 5 2 6 4 1 1 6 
330 2 1 5 5 5 5 5 5 2 6 4 1 1 6 
330 2 1 5 5 5 5 5 5 2 6 4 1 1 6 
330 2 1 5 5 5 5 5 5 2 6 4 1 1 6 
330 2 1 5 5 5 5 5 5 2 6 4 1 1 6 
315 2 1 5 5 5 5 5 5 2 6 4 1 1 5 
315 2 1 5 5 5 5 5 5 2 6 4 1 1 5 
315 2 1 5 5 5 5 5 5 2 6 4 1 1 2 
315 2 1 5 5 5 5 5 5 2 6 4 1 4 5 
315 2 1 5 5 5 5 5 5 2 6 4 1 1 5 
315 2 1 5 5 5 5 5 5 2 6 4 1 1 5 
315 2 1 5 5 5 5 5 5 2 6 4 1 1 2 
315 2 1 5 5 5 5 5 5 2 6 4 1 1 2 
315 2 1 5 5 5 5 5 5 2 6 4 1 1 2 
315 2 1 5 5 5 5 5 5 2 6 4 1 1 5 
315 2 1 5 5 5 5 5 5 2 6 4 1 1 5 
305 2 1 5 5 5 5 5 5 2 6 4 1 6 
305 2 1 5 5 5 5 5 5 2 6 4 1 6 
305 2 1 5 5 5 5 5 5 2 6 4 1 6 
305 2 1 5 5 5 5 5 5 2 6 4 1 6 
295 6 5 5 3 6 4 1 4 3 2 5 3 1 5 1 4 2 4 
290 2 1 5 5 5 5 5 5 2 6 4 1 2 
290 2 1 5 5 5 5 5 5 2 6 4 1 1 4 
290 2 1 5 5 5 5 5 5 2 6 4 1 1 4 
290 2 1 5 5 5 5 5 5 2 6 4 1 1 1 
290 2 1 5 5 5 5 5 5 2 6 4 1 1 4 
290 2 1 5 5 5 5 5 5 2 6 4 1 5 
290 2 1 5 5 5 5 5 5 2 6 4 1 5 
290 2 1 5 5 5 5 5 5 2 6 4 1 4 4 
290 2 1 5 5 5 5 5 5 2 6 4 1 2 
290 2 1 5 5 5 5 5 5 2 6 4 1 1 4 
290 2 1 5 5 5 5 5 5 2 6 4 1 2 
290 2 1 5 5 5 5 5 5 2 6 4 1 2 
290 2 1 5 5 5 5 5 5 2 6 4 1 5 
290 2 1 5 5 5 5 5 5 2 6 4 1 1 1 
275 2 1 5 5 5 5 5 5 2 6 4 1 3 1 3 
270 2 1 5 5 5 5 5 5 2 6 4 1 1 3 
270 2 1 5 5 5 5 5 5 2 6 4 1 1 3 
270 2 1 5 5 5 5 5 5 2 6 4 1 1 3 
270 2 1 5 5 5 5 5 5 2 6 4 1 1 3 
270 2 1 5 5 5 5 5 5 2 6 4 1 1 3 
270 2 1 5 5 5 5 5 5 2 6 4 1 1 3 
270 2 1 5 5 5 5 5 5 2 6 4 1 1 3 
270 2 1 5 5 5 5 5 5 2 6 4 1 1 3 
270 2 1 5 5 5 5 5 5 2 6 4 1 1 3 
270 2 1 5 5 5 5 5 5 2 6 4 1 1 3 
270 2 1 5 5 5 5 5 5 2 6 4 1 1 3 
270 2 1 5 5 5 5 5 5 2 6 4 1 4 3 
270 2 1 5 5 5 5 5 5 2 6 4 1 1 3 
270 2 1 5 5 5 5 5 5 2 6 4 1 1 3 
270 2 1 5 5 5 5 5 5 2 6 4 1 1 3 
270 2 1 5 5 5 5 5 5 2 6 4 1 1 3 
270 2 1 5 5 5 5 5 5 2 6 4 1 1 3 
270 2 1 5 5 5 5 5 5 2 6 4 1 1 3 
270 2 1 5 5 5 5 5 5 2 6 4 1 1 3 
270 2 1 5 5 5 5 5 5 2 6 4 1 1 3 
270 2 1 5 5 5 5 5 5 2 6 4 1 1 3 
270 2 1 5 5 5 5 5 5 2 6 4 1 1 3 
270 2 1 5 5 5 5 5 5 2 6 4 1 1 3 
270 2 1 5 5 5 5 5 5 2 6 4 1 1 3 
270 2 1 5 5 5 5 5 5 2 6 4 1 1 3 
270 2 1 5 5 5 5 5 5 2 6 4 1 1 3 
270 2 1 5 5 5 5 5 5 2 6 4 1 1 3 
270 2 1 5 5 5 5 5 5 2 6 4 1 1 3 
270 6 5 5 3 6 4 1 4 3 2 5 3 1 5 1 5 
270 6 5 5 3 6 4 1 4 3 2 5 3 1 5 1 5 
270 2 1 5 5 5 5 5 5 2 6 4 1 4 3 
260 6 5 5 3 6 4 1 4 3 2 5 3 1 6 5 
260 6 5 5 3 6 4 1 4 3 2 5 3 2 6 4 
250 6 5 5 3 6 4 1 4 3 2 5 3 1 5 3 4 1 6 
115 6 5 5 3 6 4 1 6 6 
100 6 5 5 3 6 4 4 6 5 
100 6 5 5 3 6 5 2 6 
100 6 5 5 3 4 5 6 4 6 
90 6 5 5 3 6 4 3 2 4 2 
85 6 5 5 3 6 4 1 2 5 
85 6 5 5 3 6 4 1 2 5 
85 6 5 5 3 6 4 2 3 3 6 
80 5 4 5 5 5 6 6 4 
80 6 5 5 3 6 4 3 6 5 
75 6 5 5 3 6 4 1 1 6 
75 6 5 5 3 6 4 6 2 
75 6 5 5 3 4 5 4 5 3 2 
75 6 5 5 3 6 6 1 2 
75 6 5 5 3 6 5 4 6 
75 6 5 5 3 6 4 6 2 
75 6 5 5 3 6 6 1 2 
75 6 5 5 3 6 4 6 5 
75 6 5 5 3 6 4 2 3 3 3 5 
70 6 5 5 3 4 5 4 5 1 4 
65 6 5 5 3 6 4 3 4 2 1 
65 6 5 5 3 6 4 3 2 2 
65 6 5 5 3 6 3 5 4 2 
65 6 5 5 3 6 5 4 2 3 
60 6 5 5 3 6 4 4 5 4 
60 6 5 5 3 6 4 1 5 1 
60 6 5 5 3 5 6 4 4 4 
60 6 5 5 3 6 4 2 4 1 
55 6 5 5 3 6 3 5 6 
55 6 5 5 3 6 4 1 6 3 
55 6 5 5 3 4 5 3 5 2 3 
50 6 5 5 3 6 4 6 1 
50 6 5 5 3 6 6 2 
40 6 5 5 3 6 4 5 3 4 
40 6 5 5 3 6 4 2 4 3 
40 6 5 5 3 6 4 3 5 1 
0 6 5 5 3 4 1 4 3 2 
-10 6 5 5 3 6 3 2 
-10 6 5 5 3 6 4 3 1 
-10 6 5 5 3 6 3 2 
-10 6 5 5 3 6 5 3 
-10 6 5 5 3 6 5 3 
-10 6 5 5 3 6 3 2 
-15 6 5 5 3 6 2 
-15 6 5 5 3 6 2 
-15 6 5 5 3 6 2 
-35 6 5 5 3 6 3 1 
-35 6 5 5 3 6 3 1 
-40 6 5 5 3 6 1 
-40 6 5 5 3 6 1 
-40 6 5 5 3 6 1 
-40 6 5 5 3 6 1 
-55 6 5 5 3 4 2 
-75 6 5 5 3 5 3 
-105 6 5 5 3 1 
-105 6 5 5 3 1 
-105 6 5 5 3 1 
