115 5 6 5 5 5 4 4 2 2 
115 5 6 5 5 5 4 4 2 5 
115 5 6 5 5 5 4 4 2 5 
115 5 6 5 5 5 4 4 5 2 
90 5 6 5 5 5 4 4 5 1 
90 5 6 5 5 5 4 4 4 5 
90 5 6 5 5 5 4 2 5 
80 5 6 5 5 5 4 4 6 
70 5 6 5 5 5 4 4 2 3 
70 5 6 5 5 5 4 2 3 4 
70 5 6 5 5 5 4 4 2 3 
70 5 6 5 5 5 4 4 3 2 4 
70 5 6 5 5 5 4 4 5 3 
70 5 6 5 5 5 4 4 5 3 
65 5 6 5 5 5 4 4 4 4 5 5 2 1 1 
65 5 6 5 5 5 4 4 4 4 5 5 2 1 
65 5 6 5 5 5 4 4 4 4 5 5 2 1 1 
65 5 6 5 5 5 4 4 4 4 5 5 2 
65 5 6 5 5 5 4 4 4 4 5 5 2 1 
65 5 6 5 5 5 4 4 4 4 5 5 2 1 
65 5 6 5 5 5 4 4 4 4 5 5 2 1 1 
65 5 6 5 5 5 4 4 4 4 5 5 2 
65 5 6 5 5 5 4 4 4 4 5 5 2 1 
65 5 6 5 5 5 4 4 4 4 5 5 2 1 1 
65 5 6 5 5 5 4 4 4 4 5 5 2 1 1 
65 5 6 5 5 5 4 4 4 4 5 5 2 1 1 
65 5 6 5 5 5 4 4 4 4 5 5 2 
65 5 6 5 5 5 4 4 4 4 5 5 2 1 1 
65 5 6 5 5 5 4 4 4 4 5 5 2 1 
65 5 6 5 5 5 4 4 4 4 5 5 2 1 
65 5 6 5 5 5 4 4 4 4 5 5 2 1 
65 5 6 5 5 5 4 4 4 4 5 5 2 1 
65 5 6 5 5 5 4 4 4 4 5 6 5 
65 5 6 5 5 5 4 5 4 
65 5 6 5 5 5 4 5 1 
65 5 6 5 5 5 4 4 4 4 5 
65 5 6 5 5 5 4 4 4 1 4 
65 5 6 5 5 5 4 2 4 
65 5 6 5 5 5 4 2 1 
65 5 6 5 5 5 4 4 4 4 5 5 2 
65 5 6 5 5 5 4 4 4 4 5 5 2 1 
65 5 6 5 5 5 4 4 4 4 5 5 2 1 
65 5 6 5 5 5 4 4 4 4 5 5 2 1 
65 5 6 5 5 5 4 4 4 4 5 5 2 
65 5 6 5 5 5 4 4 4 4 5 5 2 1 1 
65 5 6 5 5 5 4 4 4 4 5 5 2 1 
55 5 6 5 5 5 6 4 
-140 5 6 5 5 5 4 3 4 5 2 1 4 2 4 4 1 2 
