125 4 2 5 5 5 5 5 4 4 5 
95 4 2 5 5 5 6 4 4 3 5 
90 4 2 5 5 5 5 5 6 
80 4 2 5 5 5 6 4 6 
80 4 2 5 5 5 6 4 6 6 6 
80 4 2 5 5 5 6 4 6 
80 4 2 5 5 5 6 4 6 6 6 
80 4 2 5 5 5 6 4 6 6 
80 4 2 5 5 5 6 4 6 6 6 
80 4 2 5 5 5 6 4 6 6 6 
80 4 2 5 5 5 6 4 6 
80 4 2 5 5 5 6 4 6 6 
80 4 2 5 5 5 6 4 6 6 
80 4 2 5 5 5 6 4 6 
80 4 2 5 5 5 6 4 6 6 
80 4 2 5 5 5 6 4 6 6 
80 4 2 5 5 5 6 4 6 6 
80 4 2 5 5 5 6 4 6 
80 4 2 5 5 5 6 4 6 6 6 
80 4 2 5 5 5 6 4 6 6 
80 4 2 5 5 5 6 4 6 
80 4 2 5 5 5 6 4 6 
80 4 2 5 5 5 6 4 6 6 6 
80 4 2 5 5 5 6 4 6 
80 4 2 5 5 5 6 4 6 
80 4 2 5 5 5 6 4 6 
80 4 2 5 5 5 6 4 6 
80 4 2 5 5 5 6 4 6 6 
75 4 2 5 5 5 5 4 2 4 
70 4 2 5 5 5 6 4 3 4 4 3 
65 4 2 5 5 5 6 5 4 
50 4 2 5 5 5 4 3 6 1 3 
45 4 2 5 5 5 6 4 1 3 
0 4 2 5 5 5 4 2 
0 4 2 5 5 5 4 2 
-5 4 2 5 5 5 6 3 
-5 4 2 5 5 5 6 3 
-5 4 2 5 5 5 6 3 4 3 5 
-5 4 2 5 5 5 6 3 4 3 5 
-5 4 2 5 5 5 6 3 4 3 
-5 4 2 5 5 5 6 3 4 3 4 
-5 4 2 5 5 5 6 3 4 3 5 
-5 4 2 5 5 5 6 3 4 3 5 4 6 
-5 4 2 5 5 5 6 3 4 3 5 
-20 4 2 5 5 5 4 1 3 
-25 4 2 5 5 5 2 
-100 4 2 5 5 1 
-100 4 2 5 5 4 
