120 4 1 6 5 5 6 4 2 6 
120 4 1 6 5 5 6 4 2 6 
105 4 1 6 5 5 6 4 5 2 
105 4 1 6 5 5 6 4 2 5 
105 4 1 6 5 5 6 4 2 2 
105 4 1 6 5 5 6 4 2 5 
105 4 1 6 5 5 6 4 2 2 
95 4 1 6 5 5 6 6 5 
95 4 1 6 5 5 6 6 5 
95 4 1 6 5 5 6 5 6 
95 4 1 6 5 5 6 5 6 
95 4 1 6 5 5 6 2 6 
90 4 1 6 5 5 5 5 5 4 
80 4 1 6 5 5 6 4 2 1 
80 4 1 6 5 5 6 4 2 4 
80 4 1 6 5 5 6 4 1 2 
80 4 1 6 5 5 6 5 2 
80 4 1 6 5 5 6 4 4 2 
80 4 1 6 5 5 6 4 2 4 
80 4 1 6 5 5 6 2 2 
80 4 1 6 5 5 6 4 2 1 
80 4 1 6 5 5 6 4 2 1 
80 4 1 6 5 5 6 4 2 1 
80 4 1 6 5 5 6 4 5 1 
75 4 1 6 5 5 6 4 3 6 
70 4 1 6 5 5 6 4 6 
70 4 1 6 5 5 6 4 6 
70 4 1 6 5 5 6 4 6 
70 4 1 6 5 5 6 6 1 
60 4 1 6 5 5 6 4 5 3 
60 4 1 6 5 5 6 4 2 3 
55 4 1 6 5 5 6 4 1 4 
55 4 1 6 5 5 6 5 4 
35 4 1 6 5 5 6 4 3 1 5 
35 4 1 6 5 5 6 5 3 
35 4 1 6 5 5 6 5 3 
35 4 1 6 5 5 6 4 1 3 
15 4 1 6 5 5 5 2 
15 4 1 6 5 5 6 4 3 3 2 
5 4 1 6 5 5 6 1 
-15 4 1 6 5 5 6 3 
-15 4 1 6 5 5 6 3 
-15 4 1 6 5 5 6 3 4 4 4 
-15 4 1 6 5 5 6 3 
-15 4 1 6 5 5 6 3 3 1 1 
-15 4 1 6 5 5 6 3 3 3 6 
-15 4 1 6 5 5 6 3 3 1 2 
-15 4 1 6 5 5 6 3 3 1 3 
-15 4 1 6 5 5 6 3 1 3 3 
-15 4 1 6 5 5 6 3 1 3 2 
-20 4 1 6 5 5 6 3 3 
-20 4 1 6 5 5 6 3 6 4 
-20 4 1 6 5 5 6 3 2 
-20 4 1 6 5 5 6 3 1 
-20 4 1 6 5 5 6 3 4 3 
-20 4 1 6 5 5 6 3 2 2 
-20 4 1 6 5 5 6 3 5 
-20 4 1 6 5 5 6 3 1 2 
-20 4 1 6 5 5 6 3 2 6 
-20 4 1 6 5 5 6 3 5 
-20 4 1 6 5 5 6 3 3 
-20 4 1 6 5 5 6 3 3 5 
-20 4 1 6 5 5 6 3 4 
-60 4 1 6 5 5 1 
