-160 6 5 5 3 4 4 5 2 
-160 6 5 5 3 4 4 4 
-160 6 5 5 3 4 4 5 
-160 6 5 5 3 4 4 5 2 
-160 6 5 5 3 4 4 5 
-160 6 5 5 3 4 4 5 2 
-160 6 5 5 3 4 4 
-160 6 5 5 3 4 4 5 
-160 6 5 5 3 4 4 5 2 
-160 6 5 5 3 4 4 5 
-160 6 5 5 3 4 4 
-160 6 5 5 3 4 4 
-160 6 5 5 3 4 4 
-160 6 5 5 3 4 4 5 2 
-160 6 5 5 3 4 4 5 
-160 6 5 5 3 4 4 5 4 
-160 6 5 5 3 4 4 5 1 
-160 6 5 5 3 4 4 5 2 1 
-160 6 5 5 3 4 4 5 2 
-160 6 5 5 3 4 4 4 
-160 6 5 5 3 4 4 5 2 
-160 6 5 5 3 4 4 5 
-160 6 5 5 3 4 4 5 
-160 6 5 5 3 4 4 4 
-160 6 5 5 3 4 4 5 2 3 
-160 6 5 5 3 4 4 
-160 6 5 5 3 4 4 1 
-160 6 5 5 3 4 4 
-160 6 5 5 3 4 4 5 
-160 6 5 5 3 4 4 5 6 
-160 6 5 5 3 4 4 2 
-160 6 5 5 3 4 4 
-160 6 5 5 3 4 4 5 
-160 6 5 5 3 4 4 
-160 6 5 5 3 1 
-160 6 5 5 3 4 4 
-160 6 5 5 3 2 
-160 6 5 5 3 4 4 1 
-160 6 5 5 3 4 4 
-160 6 5 5 3 4 2 
-160 6 5 5 3 4 4 5 
-160 6 5 5 3 4 
-160 6 5 5 3 4 4 5 
-160 6 5 5 3 4 4 5 
-160 6 5 5 3 4 4 
-160 6 5 5 3 4 4 5 1 
-160 6 5 5 3 4 4 
-160 6 5 5 3 4 4 5 
-160 6 5 5 3 4 4 5 
-160 6 5 5 3 4 4 5 1 1 
-160 6 5 5 3 4 
-160 6 5 5 3 4 4 5 
-160 6 5 5 3 4 4 5 
-160 6 5 5 3 4 4 5 
-160 6 5 5 3 4 4 5 
-160 6 5 5 3 4 5 6 
-160 6 5 5 3 4 4 5 2 
-160 6 5 5 3 4 
-160 6 5 5 3 4 4 5 
-160 6 5 5 3 4 4 5 
-160 6 5 5 3 4 4 5 
-185 6 5 5 1 2 
-185 6 5 5 3 4 1 2 
-185 6 5 5 3 4 2 
