1000064 2 4 5 5 5 6 4 4 6 6 5 5 6 3 3 5 5 2 3 2 2 1 1 2 2 5 6 1 3 5 1 4 5 6 
1000064 2 4 5 5 5 6 4 4 6 6 5 5 6 3 3 5 5 2 3 2 2 1 1 2 2 5 6 1 3 5 4 6 6 
1000049 2 4 5 5 5 6 4 4 6 6 5 5 6 3 3 5 5 2 3 2 2 1 1 2 2 5 6 1 3 5 1 4 5 4 5 
1000049 2 4 5 5 5 6 4 4 6 6 5 5 6 3 3 5 5 2 3 2 2 1 1 2 2 5 6 1 3 5 4 5 1 4 5 
999999 2 4 5 5 5 6 4 4 6 6 5 5 6 3 3 5 5 2 3 2 2 1 1 2 2 5 6 1 3 5 1 4 4 3 1 5 2 
1075 2 4 5 5 5 6 4 4 6 6 5 5 6 3 3 5 5 2 3 2 2 1 1 2 2 5 6 1 3 5 4 3 4 4 5 
1065 2 4 5 5 5 6 4 4 6 6 5 5 6 3 3 5 5 2 3 2 2 1 1 2 2 5 6 1 3 5 4 3 4 6 
1060 2 4 5 5 5 6 4 4 6 6 5 5 6 3 3 5 5 2 3 2 2 1 1 2 2 5 6 1 3 5 1 4 6 
1060 2 4 5 5 5 6 4 4 6 6 5 5 6 3 3 5 5 2 3 2 2 1 1 2 2 5 6 1 3 5 1 4 6 
1045 2 4 5 5 5 6 4 4 6 6 5 5 6 3 3 5 5 2 3 2 2 1 1 2 2 5 6 1 3 5 1 4 2 
1045 2 4 5 5 5 6 4 4 6 6 5 5 6 3 3 5 5 2 3 2 2 1 1 2 2 5 6 1 3 5 4 1 5 
1045 2 4 5 5 5 6 4 4 6 6 5 5 6 3 3 5 5 2 3 2 2 1 1 2 2 5 6 1 3 5 1 4 2 
1040 2 4 5 5 5 6 4 4 6 6 5 5 6 3 3 5 5 2 3 2 2 1 1 2 2 5 6 1 3 5 1 3 6 
1035 2 4 5 5 5 6 4 4 6 6 5 5 6 3 3 5 5 2 3 2 2 1 1 2 2 5 6 1 3 5 1 6 
1035 2 4 5 5 5 6 4 4 6 6 5 5 6 3 3 5 5 2 3 2 2 1 1 2 2 5 6 1 3 5 1 6 
1035 2 4 5 5 5 6 4 4 6 6 5 5 6 3 3 5 5 2 3 2 2 1 1 2 2 5 6 1 3 5 1 6 
1035 2 4 5 5 5 6 4 4 6 6 5 5 6 3 3 5 5 2 3 2 2 1 1 2 2 5 6 1 3 5 1 6 
1035 2 4 5 5 5 6 4 4 6 6 5 5 6 3 3 5 5 2 3 2 2 1 1 2 2 5 6 1 3 5 1 6 
1035 2 4 5 5 5 6 4 4 6 6 5 5 6 3 3 5 5 2 3 2 2 1 1 2 2 5 6 1 3 5 1 6 
1025 2 4 5 5 5 6 4 4 6 6 5 5 6 3 3 5 5 2 3 2 2 1 1 2 2 5 6 1 3 5 1 3 5 
1025 2 4 5 5 5 6 4 4 6 6 5 5 6 3 3 5 5 2 3 2 2 1 1 2 2 5 6 1 3 5 1 3 5 
1025 2 4 5 5 5 6 4 4 6 6 5 5 6 3 3 5 5 2 3 2 2 1 1 2 2 5 6 1 3 5 1 3 5 
1025 2 4 5 5 5 6 4 4 6 6 5 5 6 3 3 5 5 2 3 2 2 1 1 2 2 5 6 1 3 5 4 3 5 
1025 2 4 5 5 5 6 4 4 6 6 5 5 6 3 3 5 5 2 3 2 2 1 1 2 2 5 6 1 3 5 1 3 2 
1025 2 4 5 5 5 6 4 4 6 6 5 5 6 3 3 5 5 2 3 2 2 1 1 2 2 5 6 1 3 5 1 3 5 
1020 2 4 5 5 5 6 4 4 6 6 5 5 6 3 3 5 5 2 3 2 2 1 1 2 2 5 6 1 3 5 4 2 
1020 2 4 5 5 5 6 4 4 6 6 5 5 6 3 3 5 5 2 3 2 2 1 1 2 2 5 6 1 3 5 1 5 
1020 2 4 5 5 5 6 4 4 6 6 5 5 6 3 3 5 5 2 3 2 2 1 1 2 2 5 6 1 3 5 1 2 
1020 2 4 5 5 5 6 4 4 6 6 5 5 6 3 3 5 5 2 3 2 2 1 1 2 2 5 6 1 3 5 4 4 4 
1020 2 4 5 5 5 6 4 4 6 6 5 5 6 3 3 5 5 2 3 2 2 1 1 2 2 5 6 1 3 5 1 5 
1020 2 4 5 5 5 6 4 4 6 6 5 5 6 3 3 5 5 2 3 2 2 1 1 2 2 5 6 1 3 5 1 5 
1020 2 4 5 5 5 6 4 4 6 6 5 5 6 3 3 5 5 2 3 2 2 1 1 2 2 5 6 1 3 5 1 4 1 
1020 2 4 5 5 5 6 4 4 6 6 5 5 6 3 3 5 5 2 3 2 2 1 1 2 2 5 6 1 3 5 1 2 
1020 2 4 5 5 5 6 4 4 6 6 5 5 6 3 3 5 5 2 3 2 2 1 1 2 2 5 6 1 3 5 1 2 
1020 2 4 5 5 5 6 4 4 6 6 5 5 6 3 3 5 5 2 3 2 2 1 1 2 2 5 6 1 3 5 1 2 
1020 2 4 5 5 5 6 4 4 6 6 5 5 6 3 3 5 5 2 3 2 2 1 1 2 2 5 6 1 3 5 1 2 
1020 2 4 5 5 5 6 4 4 6 6 5 5 6 3 3 5 5 2 3 2 2 1 1 2 2 5 6 1 3 5 1 5 
1020 2 4 5 5 5 6 4 4 6 6 5 5 6 3 3 5 5 2 3 2 2 1 1 2 2 5 6 1 3 5 1 4 1 
1020 2 4 5 5 5 6 4 4 6 6 5 5 6 3 3 5 5 2 3 2 2 1 1 2 2 5 6 1 3 5 1 5 
1020 2 4 5 5 5 6 4 4 6 6 5 5 6 3 3 5 5 2 3 2 2 1 1 2 2 5 6 1 3 5 1 5 
1020 2 4 5 5 5 6 4 4 6 6 5 5 6 3 3 5 5 2 3 2 2 1 1 2 2 5 6 1 3 5 1 2 
1020 2 4 5 5 5 6 4 4 6 6 5 5 6 3 3 5 5 2 3 2 2 1 1 2 2 5 6 1 3 5 1 2 
1020 2 4 5 5 5 6 4 4 6 6 5 5 6 3 3 5 5 2 3 2 2 1 1 2 2 5 6 1 3 5 1 5 
1020 2 4 5 5 5 6 4 4 6 6 5 5 6 3 3 5 5 2 3 2 2 1 1 2 2 5 6 1 3 5 1 2 
1020 2 4 5 5 5 6 4 4 6 6 5 5 6 3 3 5 5 2 3 2 2 1 1 2 2 5 6 1 3 5 1 2 
1020 2 4 5 5 5 6 4 4 6 6 5 5 6 3 3 5 5 2 3 2 2 1 1 2 2 5 6 1 3 5 1 2 
1020 2 4 5 5 5 6 4 4 6 6 5 5 6 3 3 5 5 2 3 2 2 1 1 2 2 5 6 1 3 5 1 5 
1020 2 4 5 5 5 6 4 4 6 6 5 5 6 3 3 5 5 2 3 2 2 1 1 2 2 5 6 1 3 5 1 2 
1020 2 4 5 5 5 6 4 4 6 6 5 5 6 3 3 5 5 2 3 2 2 1 1 2 2 5 6 1 3 5 1 2 
1020 2 4 5 5 5 6 4 4 6 6 5 5 6 3 3 5 5 2 3 2 2 1 1 2 2 5 6 1 3 5 1 2 
1010 2 4 5 5 5 6 4 4 6 6 5 5 6 3 3 5 5 2 3 2 2 1 1 2 2 5 6 1 3 5 6 
1010 2 4 5 5 5 6 4 4 6 6 5 5 6 3 3 5 5 2 3 2 2 1 1 2 2 5 6 1 3 5 6 
1010 2 4 5 5 5 6 4 4 6 6 5 5 6 3 3 5 5 2 3 2 2 1 1 2 2 5 6 1 3 5 6 
1010 2 4 5 5 5 6 4 4 6 6 5 5 6 3 3 5 5 2 3 2 2 1 1 2 2 5 6 1 3 5 6 
1010 2 4 5 5 5 6 4 4 6 6 5 5 6 3 3 5 5 2 3 2 2 1 1 2 2 5 6 1 3 5 6 
1010 2 4 5 5 5 6 4 4 6 6 5 5 6 3 3 5 5 2 3 2 2 1 1 2 2 5 6 1 3 5 6 
1010 2 4 5 5 5 6 4 4 6 6 5 5 6 3 3 5 5 2 3 2 2 1 1 2 2 5 6 1 3 5 6 
1010 2 4 5 5 5 6 4 4 6 6 5 5 6 3 3 5 5 2 3 2 2 1 1 2 2 5 6 1 3 5 6 
1010 2 4 5 5 5 6 4 4 6 6 5 5 6 3 3 5 5 2 3 2 2 1 1 2 2 5 6 1 3 5 6 
1010 2 4 5 5 5 6 4 4 6 6 5 5 6 3 3 5 5 2 3 2 2 1 1 2 2 5 6 1 3 5 6 
1000 2 4 5 5 5 6 4 4 6 6 5 5 6 3 3 5 5 2 3 2 2 1 1 2 2 5 6 1 3 5 1 3 1 
1000 2 4 5 5 5 6 4 4 6 6 5 5 6 3 3 5 5 2 3 2 2 1 1 2 2 5 6 1 3 5 1 3 1 
1000 2 4 5 5 5 6 4 4 6 6 5 5 6 3 3 5 5 2 3 2 2 1 1 2 2 5 6 1 3 5 1 3 4 
1000 2 4 5 5 5 6 4 4 6 6 5 5 6 3 3 5 5 2 3 2 2 1 1 2 2 5 6 1 3 5 1 3 4 
995 2 4 5 5 5 6 4 4 6 6 5 5 6 3 3 5 5 2 3 2 2 1 1 2 2 5 6 1 3 5 2 
995 2 4 5 5 5 6 4 4 6 6 5 5 6 3 3 5 5 2 3 2 2 1 1 2 2 5 6 1 3 5 1 1 
995 2 4 5 5 5 6 4 4 6 6 5 5 6 3 3 5 5 2 3 2 2 1 1 2 2 5 6 1 3 5 1 1 
995 2 4 5 5 5 6 4 4 6 6 5 5 6 3 3 5 5 2 3 2 2 1 1 2 2 5 6 1 3 5 2 
995 2 4 5 5 5 6 4 4 6 6 5 5 6 3 3 5 5 2 3 2 2 1 1 2 2 5 6 1 3 5 5 
995 2 4 5 5 5 6 4 4 6 6 5 5 6 3 3 5 5 2 3 2 2 1 1 2 2 5 6 1 3 5 5 
995 2 4 5 5 5 6 4 4 6 6 5 5 6 3 3 5 5 2 3 2 2 1 1 2 2 5 6 1 3 5 5 
995 2 4 5 5 5 6 4 4 6 6 5 5 6 3 3 5 5 2 3 2 2 1 1 2 2 5 6 1 3 5 5 
995 2 4 5 5 5 6 4 4 6 6 5 5 6 3 3 5 5 2 3 2 2 1 1 2 2 5 6 1 3 5 1 1 
995 2 4 5 5 5 6 4 4 6 6 5 5 6 3 3 5 5 2 3 2 2 1 1 2 2 5 6 1 3 5 1 1 
995 2 4 5 5 5 6 4 4 6 6 5 5 6 3 3 5 5 2 3 2 2 1 1 2 2 5 6 1 3 5 2 
995 2 4 5 5 5 6 4 4 6 6 5 5 6 3 3 5 5 2 3 2 2 1 1 2 2 5 6 1 3 5 2 
995 2 4 5 5 5 6 4 4 6 6 5 5 6 3 3 5 5 2 3 2 2 1 1 2 2 5 6 1 3 5 5 
995 2 4 5 5 5 6 4 4 6 6 5 5 6 3 3 5 5 2 3 2 2 1 1 2 2 5 6 1 3 5 5 
995 2 4 5 5 5 6 4 4 6 6 5 5 6 3 3 5 5 2 3 2 2 1 1 2 2 5 6 1 3 5 1 1 
995 2 4 5 5 5 6 4 4 6 6 5 5 6 3 3 5 5 2 3 2 2 1 1 2 2 5 6 1 3 5 1 1 
995 2 4 5 5 5 6 4 4 6 6 5 5 6 3 3 5 5 2 3 2 2 1 1 2 2 5 6 1 3 5 2 
995 2 4 5 5 5 6 4 4 6 6 5 5 6 3 3 5 5 2 3 2 2 1 1 2 2 5 6 1 3 5 1 1 
995 2 4 5 5 5 6 4 4 6 6 5 5 6 3 3 5 5 2 3 2 2 1 1 2 2 5 6 1 3 5 5 
995 2 4 5 5 5 6 4 4 6 6 5 5 6 3 3 5 5 2 3 2 2 1 1 2 2 5 6 1 3 5 2 
995 2 4 5 5 5 6 4 4 6 6 5 5 6 3 3 5 5 2 3 2 2 1 1 2 2 5 6 1 3 5 1 1 
995 2 4 5 5 5 6 4 4 6 6 5 5 6 3 3 5 5 2 3 2 2 1 1 2 2 5 6 1 3 5 2 
995 2 4 5 5 5 6 4 4 6 6 5 5 6 3 3 5 5 2 3 2 2 1 1 2 2 5 6 1 3 5 2 
995 2 4 5 5 5 6 4 4 6 6 5 5 6 3 3 5 5 2 3 2 2 1 1 2 2 5 6 1 3 5 1 1 
995 2 4 5 5 5 6 4 4 6 6 5 5 6 3 3 5 5 2 3 2 2 1 1 2 2 5 6 1 3 5 2 
995 2 4 5 5 5 6 4 4 6 6 5 5 6 3 3 5 5 2 3 2 2 1 1 2 2 5 6 1 3 5 1 1 
995 2 4 5 5 5 6 4 4 6 6 5 5 6 3 3 5 5 2 3 2 2 1 1 2 2 5 6 1 3 5 5 
995 2 4 5 5 5 6 4 4 6 6 5 5 6 3 3 5 5 2 3 2 2 1 1 2 2 5 6 1 3 5 1 1 
995 2 4 5 5 5 6 4 4 6 6 5 5 6 3 3 5 5 2 3 2 2 1 1 2 2 5 6 1 3 5 5 
985 2 4 5 5 5 6 4 4 6 6 5 5 6 3 3 5 5 2 3 2 2 1 1 2 2 5 6 1 3 4 6 
985 2 4 5 5 5 6 4 4 6 6 5 5 6 3 3 5 5 2 3 2 2 1 1 2 2 5 6 1 3 4 6 
985 2 4 5 5 5 6 4 4 6 6 5 5 6 3 3 5 5 2 3 2 2 1 1 2 2 5 6 1 3 4 6 
985 2 4 5 5 5 6 4 4 6 6 5 5 6 3 3 5 5 2 3 2 2 1 1 2 2 5 6 1 3 4 6 
985 2 4 5 5 5 6 4 4 6 6 5 5 6 3 3 5 5 2 3 2 2 1 1 2 2 4 6 6 3 4 5 
980 2 4 5 5 5 6 4 4 6 6 5 5 6 3 3 5 5 2 3 2 2 1 1 2 2 5 6 1 3 4 3 3 2 
980 2 4 5 5 5 6 4 4 6 6 5 5 6 3 3 5 5 2 3 2 2 1 1 2 2 5 6 1 3 5 1 3 3 
980 2 4 5 5 5 6 4 4 6 6 5 5 6 3 3 5 5 2 3 2 2 1 1 2 2 5 6 1 3 4 3 5 3 
980 2 4 5 5 5 6 4 4 6 6 5 5 6 3 3 5 5 2 3 2 2 1 1 2 2 5 6 1 3 5 1 3 3 
975 2 4 5 5 5 6 4 4 6 6 5 5 6 3 3 5 5 2 3 2 2 1 1 2 2 5 6 1 3 4 3 2 
970 2 4 5 5 5 6 4 4 6 6 5 5 6 3 3 5 5 2 3 2 2 1 1 2 2 5 6 1 3 4 2 
970 2 4 5 5 5 6 4 4 6 6 5 5 6 3 3 5 5 2 3 2 2 1 1 2 2 5 6 1 3 4 5 
970 2 4 5 5 5 6 4 4 6 6 5 5 6 3 3 5 5 2 3 2 2 1 1 2 2 5 6 1 3 4 5 
970 2 4 5 5 5 6 4 4 6 6 5 5 6 3 3 5 5 2 3 2 2 1 1 2 2 5 6 1 3 4 5 
960 2 4 5 5 5 6 4 4 6 6 5 5 6 3 3 5 5 2 3 2 2 1 1 2 2 5 6 1 3 6 
960 2 4 5 5 5 6 4 4 6 6 5 5 6 3 3 5 5 2 3 2 2 1 1 2 2 5 6 1 3 6 
960 2 4 5 5 5 6 4 4 6 6 5 5 6 3 3 5 5 2 3 2 2 1 1 2 2 5 6 1 3 6 
960 2 4 5 5 5 6 4 4 6 6 5 5 6 3 3 5 5 2 3 2 2 1 1 2 2 5 6 1 3 6 
960 2 4 5 5 5 6 4 4 6 6 5 5 6 3 3 5 5 2 3 2 2 1 1 2 2 5 6 1 3 6 
960 2 4 5 5 5 6 4 4 6 6 5 5 6 3 3 5 5 2 3 2 2 1 1 2 2 5 6 1 3 6 
960 2 4 5 5 5 6 4 4 6 6 5 5 6 3 3 5 5 2 3 2 2 1 1 2 2 5 6 1 3 6 
950 2 4 5 5 5 6 4 4 6 6 5 5 6 3 3 5 5 2 3 2 2 1 1 2 2 5 6 1 3 4 4 3 
950 2 4 5 5 5 6 4 4 6 6 5 5 6 3 3 5 5 2 3 2 2 1 1 2 2 5 6 1 3 5 3 
950 2 4 5 5 5 6 4 4 6 6 5 5 6 3 3 5 5 2 3 2 2 1 1 2 2 5 6 1 3 5 3 
950 2 4 5 5 5 6 4 4 6 6 5 5 6 3 3 5 5 2 3 2 2 1 1 2 2 5 6 1 3 5 3 
950 2 4 5 5 5 6 4 4 6 6 5 5 6 3 3 5 5 2 3 2 2 1 1 2 2 5 6 1 3 5 3 
950 2 4 5 5 5 6 4 4 6 6 5 5 6 3 3 5 5 2 3 2 2 1 1 2 2 5 6 1 3 5 3 
950 2 4 5 5 5 6 4 4 6 6 5 5 6 3 3 5 5 2 3 2 2 1 1 2 2 5 6 1 3 5 3 
950 2 4 5 5 5 6 4 4 6 6 5 5 6 3 3 5 5 2 3 2 2 1 1 2 2 5 6 1 3 4 4 3 
950 2 4 5 5 5 6 4 4 6 6 5 5 6 3 3 5 5 2 3 2 2 1 1 2 2 5 6 1 3 5 3 
950 2 4 5 5 5 6 4 4 6 6 5 5 6 3 3 5 5 2 3 2 2 1 1 2 2 5 6 1 3 5 3 
945 2 4 5 5 5 6 4 4 6 6 5 5 6 3 3 5 5 2 3 2 2 1 1 2 2 5 6 1 3 4 1 
945 2 4 5 5 5 6 4 4 6 6 5 5 6 3 3 5 5 2 3 2 2 1 1 2 2 5 6 1 3 2 
945 2 4 5 5 5 6 4 4 6 6 5 5 6 3 3 5 5 2 3 2 2 1 1 2 2 5 6 1 3 2 
945 2 4 5 5 5 6 4 4 6 6 5 5 6 3 3 5 5 2 3 2 2 1 1 2 2 5 6 1 3 2 
945 2 4 5 5 5 6 4 4 6 6 5 5 6 3 3 5 5 2 3 2 2 1 1 2 2 5 6 1 3 4 1 
945 2 4 5 5 5 6 4 4 6 6 5 5 6 3 3 5 5 2 3 2 2 1 1 2 2 5 6 1 3 2 
945 2 4 5 5 5 6 4 4 6 6 5 5 6 3 3 5 5 2 3 2 2 1 1 2 2 5 6 1 3 2 
945 2 4 5 5 5 6 4 4 6 6 5 5 6 3 3 5 5 2 3 2 2 1 1 2 2 5 6 1 3 2 
945 2 4 5 5 5 6 4 4 6 6 5 5 6 3 3 5 5 2 3 2 2 1 1 2 2 5 6 1 3 2 
945 2 4 5 5 5 6 4 4 6 6 5 5 6 3 3 5 5 2 3 2 2 1 1 2 2 5 6 1 3 2 
945 2 4 5 5 5 6 4 4 6 6 5 5 6 3 3 5 5 2 3 2 2 1 1 2 2 5 6 1 3 2 
945 2 4 5 5 5 6 4 4 6 6 5 5 6 3 3 5 5 2 3 2 2 1 1 2 2 5 6 1 3 4 1 
945 2 4 5 5 5 6 4 4 6 6 5 5 6 3 3 5 5 2 3 2 2 1 1 2 2 5 6 1 3 2 
920 2 4 5 5 5 6 4 4 6 6 5 5 6 3 3 5 5 2 3 2 2 1 1 2 2 5 6 1 3 1 
920 2 4 5 5 5 6 4 4 6 6 5 5 6 3 3 5 5 2 3 2 2 1 1 2 2 5 6 1 3 1 
920 2 4 5 5 5 6 4 4 6 6 5 5 6 3 3 5 5 2 3 2 2 1 1 2 2 5 6 1 3 1 
920 2 4 5 5 5 6 4 4 6 6 5 5 6 3 3 5 5 2 3 2 2 1 1 2 2 5 6 1 3 1 
920 2 4 5 5 5 6 4 4 6 6 5 5 6 3 3 5 5 2 3 2 2 1 1 2 2 5 6 1 3 1 
920 2 4 5 5 5 6 4 4 6 6 5 5 6 3 3 5 5 2 3 2 2 1 1 2 2 5 6 1 3 1 
920 2 4 5 5 5 6 4 4 6 6 5 5 6 3 3 5 5 2 3 2 2 1 1 2 2 5 6 1 3 1 
915 2 4 5 5 5 6 4 4 6 6 5 5 6 3 3 5 5 2 3 2 2 1 1 2 2 5 6 2 
915 2 4 5 5 5 6 4 4 6 6 5 5 6 3 3 5 5 2 3 2 2 1 1 2 1 1 6 1 4 2 
900 2 4 5 5 5 6 4 4 6 6 5 5 6 3 3 5 5 2 3 2 2 1 1 2 2 5 6 1 3 3 
900 2 4 5 5 5 6 4 4 6 6 5 5 6 3 3 5 5 2 3 2 2 1 1 2 2 5 6 1 3 3 
900 2 4 5 5 5 6 4 4 6 6 5 5 6 3 3 5 5 2 3 2 2 1 1 2 2 5 6 1 3 3 
900 2 4 5 5 5 6 4 4 6 6 5 5 6 3 3 5 5 2 3 2 2 1 1 2 2 5 6 1 3 3 
900 2 4 5 5 5 6 4 4 6 6 5 5 6 3 3 5 5 2 3 2 2 1 1 2 2 5 6 1 3 3 
900 2 4 5 5 5 6 4 4 6 6 5 5 6 3 3 5 5 2 3 2 2 1 1 2 2 5 6 1 3 3 
900 2 4 5 5 5 6 4 4 6 6 5 5 6 3 3 5 5 2 3 2 2 1 1 2 2 5 6 1 3 3 
900 2 4 5 5 5 6 4 4 6 6 5 5 6 3 3 5 5 2 3 2 2 1 1 2 2 5 6 1 3 3 
870 2 4 5 5 5 6 4 4 6 6 5 5 6 3 3 5 5 2 3 2 2 1 1 2 2 3 6 2 
855 2 4 5 5 5 6 4 4 6 6 5 5 6 3 3 5 5 2 3 2 2 1 1 2 2 2 3 4 4 
855 2 4 5 5 5 6 4 4 6 6 5 5 6 3 3 5 5 2 3 2 2 1 1 2 2 3 5 5 
855 2 4 5 5 5 6 4 4 6 6 5 5 6 3 3 5 5 2 3 2 2 1 1 2 2 1 1 3 2 
855 2 4 5 5 5 6 4 4 6 6 5 5 6 3 3 5 5 2 3 2 2 1 1 2 2 5 2 3 
825 2 4 5 5 5 6 4 4 6 6 5 5 6 3 3 5 5 2 3 2 2 1 1 2 2 5 1 
825 2 4 5 5 5 6 4 4 6 6 5 5 6 3 3 5 5 2 3 2 2 1 1 2 1 2 4 1 
825 2 4 5 5 5 6 4 4 6 6 5 5 6 3 3 5 5 2 3 2 2 2 2 2 5 4 
815 2 4 5 5 5 6 4 4 6 6 5 5 6 3 3 5 5 2 3 2 2 1 1 2 2 6 
805 2 4 5 5 5 6 4 4 6 6 5 5 6 3 3 5 5 2 3 2 2 1 1 2 1 1 2 3 
790 2 4 5 5 5 6 4 4 6 6 5 5 6 3 3 5 5 2 3 2 2 1 1 2 1 6 
790 2 4 5 5 5 6 4 4 6 6 5 5 6 3 3 5 5 2 3 2 2 1 1 2 1 6 
780 2 4 5 5 5 6 4 4 6 6 5 5 6 3 3 5 5 2 3 2 2 1 1 2 2 3 4 
780 2 4 5 5 5 6 4 4 6 6 5 5 6 3 3 5 5 2 3 2 2 1 1 2 2 3 1 
780 2 4 5 5 5 6 4 4 6 6 5 5 6 3 3 5 5 2 3 2 2 1 1 2 2 1 3 
775 2 4 5 5 5 6 4 4 6 6 5 5 6 3 3 5 5 2 3 2 2 1 1 2 1 5 
765 2 4 5 5 5 6 4 4 6 6 5 5 6 3 3 5 5 2 3 2 2 1 1 2 6 
765 2 4 5 5 5 6 4 4 6 6 5 5 6 3 3 5 5 2 3 2 2 1 1 2 6 
765 2 4 5 5 5 6 4 4 6 6 5 5 6 3 3 5 5 2 3 2 2 1 1 2 6 
765 2 4 5 5 5 6 4 4 6 6 5 5 6 3 3 5 5 2 3 2 2 1 1 1 1 6 
765 2 4 5 5 5 6 4 4 6 6 5 5 6 3 3 5 5 2 3 2 2 1 1 1 1 6 
765 2 4 5 5 5 6 4 4 6 6 5 5 6 3 3 5 5 2 3 2 2 1 1 2 6 
765 2 4 5 5 5 6 4 4 6 6 5 5 6 3 3 5 5 2 3 2 2 1 2 1 6 
765 2 4 5 5 5 6 4 4 6 6 5 5 6 3 3 5 5 2 3 2 2 1 1 2 6 
765 2 4 5 5 5 6 4 4 6 6 5 5 6 3 3 5 5 2 3 2 2 1 1 2 6 
765 2 4 5 5 5 6 4 4 6 6 5 5 6 3 3 5 5 2 3 2 2 1 2 1 6 
750 2 4 5 5 5 6 4 4 6 6 5 5 6 3 3 5 5 2 3 2 2 1 1 2 1 4 
750 2 4 5 5 5 6 4 4 6 6 5 5 6 3 3 5 5 2 3 2 2 1 2 2 4 
750 2 4 5 5 5 6 4 4 6 6 5 5 6 3 3 5 5 2 3 2 2 1 1 2 5 
750 2 4 5 5 5 6 4 4 6 6 5 5 6 3 3 5 5 2 3 2 2 1 1 2 1 4 
750 2 4 5 5 5 6 4 4 6 6 5 5 6 3 3 5 5 2 3 2 2 1 1 2 5 
740 2 4 5 5 5 6 4 4 6 6 5 5 6 3 3 5 5 2 3 2 2 1 2 6 
740 2 4 5 5 5 6 4 4 6 6 5 5 6 3 3 5 5 2 3 2 2 1 1 1 6 
740 2 4 5 5 5 6 4 4 6 6 5 5 6 3 3 5 5 2 3 2 2 1 1 1 6 
730 2 4 5 5 5 6 4 4 6 6 5 5 6 3 3 5 5 2 3 2 2 1 1 2 1 3 
725 2 4 5 5 5 6 4 4 6 6 5 5 6 3 3 5 5 2 3 2 2 2 1 5 
725 2 4 5 5 5 6 4 4 6 6 5 5 6 3 3 5 5 2 3 2 2 1 2 5 
725 2 4 5 5 5 6 4 4 6 6 5 5 6 3 3 5 5 2 3 2 2 1 1 2 4 
725 2 4 5 5 5 6 4 4 6 6 5 5 6 3 3 5 5 2 3 2 2 1 1 2 4 
725 2 4 5 5 5 6 4 4 6 6 5 5 6 3 3 5 5 2 3 2 2 1 2 5 
725 2 4 5 5 5 6 4 4 6 6 5 5 6 3 3 5 5 2 3 2 2 1 2 5 
725 2 4 5 5 5 6 4 4 6 6 5 5 6 3 3 5 5 2 3 2 2 1 1 2 4 
725 2 4 5 5 5 6 4 4 6 6 5 5 6 3 3 5 5 2 3 2 2 1 1 1 5 
725 2 4 5 5 5 6 4 4 6 6 5 5 6 3 3 5 5 2 3 2 2 1 1 1 5 
725 2 4 5 5 5 6 4 4 6 6 5 5 6 3 3 5 5 2 3 2 2 1 2 5 
725 2 4 5 5 5 6 4 4 6 6 5 5 6 3 3 5 5 2 3 2 2 1 2 1 4 
715 2 4 5 5 5 6 4 4 6 6 5 5 6 3 3 5 5 2 3 2 2 1 1 6 
715 2 4 5 5 5 6 4 4 6 6 5 5 6 3 3 5 5 2 3 2 2 2 6 
715 2 4 5 5 5 6 4 4 6 6 5 5 6 3 3 5 5 2 3 2 2 1 1 6 
715 2 4 5 5 5 6 4 4 6 6 5 5 6 3 3 5 5 2 3 2 2 2 6 
715 2 4 5 5 5 6 4 4 6 6 5 5 6 3 3 5 5 2 3 2 2 1 1 6 
715 2 4 5 5 5 6 4 4 6 6 5 5 6 3 3 5 5 2 3 2 2 1 1 6 
715 2 4 5 5 5 6 4 4 6 6 5 5 6 3 3 5 5 2 3 2 2 1 1 6 
715 2 4 5 5 5 6 4 4 6 6 5 5 6 3 3 5 5 2 3 2 2 1 1 6 
715 2 4 5 5 5 6 4 4 6 6 5 5 6 3 3 5 5 2 3 2 2 1 1 6 
715 2 4 5 5 5 6 4 4 6 6 5 5 6 3 3 5 5 2 3 2 2 1 1 6 
715 2 4 5 5 5 6 4 4 6 6 5 5 6 3 3 5 5 2 3 2 2 1 1 6 
705 2 4 5 5 5 6 4 4 6 6 5 5 6 3 3 5 5 2 3 2 2 1 1 2 3 
705 2 4 5 5 5 6 4 4 6 6 5 5 6 3 3 5 5 2 3 2 2 1 1 2 3 
705 2 4 5 5 5 6 4 4 6 6 5 5 6 3 3 5 5 2 3 2 2 1 1 2 3 
705 2 4 5 5 5 6 4 4 6 6 5 5 6 3 3 5 5 2 3 2 2 1 1 2 3 
705 2 4 5 5 5 6 4 4 6 6 5 5 6 3 3 5 5 2 3 2 2 1 2 1 3 
705 2 4 5 5 5 6 4 4 6 6 5 5 6 3 3 5 5 2 3 2 2 1 2 1 3 
705 2 4 5 5 5 6 4 4 6 6 5 5 6 3 3 5 5 2 3 2 2 1 1 1 1 3 
700 2 4 5 5 5 6 4 4 6 6 5 5 6 3 3 5 5 2 3 2 2 1 1 5 
700 2 4 5 5 5 6 4 4 6 6 5 5 6 3 3 5 5 2 3 2 2 1 1 5 
700 2 4 5 5 5 6 4 4 6 6 5 5 6 3 3 5 5 2 3 2 2 1 1 5 
700 2 4 5 5 5 6 4 4 6 6 5 5 6 3 3 5 5 2 3 2 2 1 1 5 
700 2 4 5 5 5 6 4 4 6 6 5 5 6 3 3 5 5 2 3 2 2 1 2 4 
690 2 4 5 5 5 6 4 4 6 6 5 5 6 3 3 5 5 2 3 2 2 1 6 
690 2 4 5 5 5 6 4 4 6 6 5 5 6 3 3 5 5 2 3 2 2 1 6 
690 2 4 5 5 5 6 4 4 6 6 5 5 6 3 3 5 5 2 3 2 2 1 6 
690 2 4 5 5 5 6 4 4 6 6 5 5 6 3 3 5 5 2 3 2 2 1 6 
690 2 4 5 5 5 6 4 4 6 6 5 5 6 3 3 5 5 2 3 2 2 1 6 
690 2 4 5 5 5 6 4 4 6 6 5 5 6 3 3 5 5 2 3 2 2 1 6 
690 2 4 5 5 5 6 4 4 6 6 5 5 6 3 3 5 5 2 3 2 2 1 6 
690 2 4 5 5 5 6 4 4 6 6 5 5 6 3 3 5 5 2 3 2 2 1 6 
690 2 4 5 5 5 6 4 4 6 6 5 5 6 3 3 5 5 2 3 2 2 1 6 
680 2 4 5 5 5 6 4 4 6 6 5 5 6 3 3 5 5 2 3 2 2 1 2 3 
680 2 4 5 5 5 6 4 4 6 6 5 5 6 3 3 5 5 2 3 2 2 1 2 3 
680 2 4 5 5 5 6 4 4 6 6 5 5 6 3 3 5 5 2 3 2 2 1 1 1 3 
680 2 4 5 5 5 6 4 4 6 6 5 5 6 3 3 5 5 2 3 2 2 1 1 1 3 
680 2 4 5 5 5 6 4 4 6 6 5 5 6 3 3 5 5 2 3 2 2 1 2 3 
675 2 4 5 5 5 6 4 4 6 6 5 5 6 3 3 5 5 2 3 2 2 1 5 
675 2 4 5 5 5 6 4 4 6 6 5 5 6 3 3 5 5 2 3 2 2 1 5 
675 2 4 5 5 5 6 4 4 6 6 5 5 6 3 3 5 5 2 3 2 2 1 1 4 
675 2 4 5 5 5 6 4 4 6 6 5 5 6 3 3 5 5 2 3 2 2 1 1 4 
675 2 4 5 5 5 6 4 4 6 6 5 5 6 3 3 5 5 2 3 2 2 2 4 
675 2 4 5 5 5 6 4 4 6 6 5 5 6 3 3 5 5 2 3 2 2 1 1 4 
675 2 4 5 5 5 6 4 4 6 6 5 5 6 3 3 5 5 2 3 2 2 1 1 4 
675 2 4 5 5 5 6 4 4 6 6 5 5 6 3 3 5 5 2 3 2 2 1 5 
675 2 4 5 5 5 6 4 4 6 6 5 5 6 3 3 5 5 2 3 2 2 1 5 
675 2 4 5 5 5 6 4 4 6 6 5 5 6 3 3 5 5 2 3 2 2 1 5 
675 2 4 5 5 5 6 4 4 6 6 5 5 6 3 3 5 5 2 3 2 2 1 5 
675 2 4 5 5 5 6 4 4 6 6 5 5 6 3 3 5 5 2 3 2 2 1 5 
665 2 4 5 5 5 6 4 4 6 6 5 5 6 3 3 5 5 2 3 2 2 6 
665 2 4 5 5 5 6 4 4 6 6 5 5 6 3 3 5 5 2 3 2 1 1 6 
665 2 4 5 5 5 6 4 4 6 6 5 5 6 3 3 5 5 2 3 2 2 6 
665 2 4 5 5 5 6 4 4 6 6 5 5 6 3 3 5 5 2 3 2 2 6 
665 2 4 5 5 5 6 4 4 6 6 5 5 6 3 3 5 5 2 3 2 2 6 
655 2 4 5 5 5 6 4 4 6 6 5 5 6 3 3 5 5 2 3 2 2 2 3 
655 2 4 5 5 5 6 4 4 6 6 5 5 6 3 3 5 5 2 3 2 2 1 1 3 
655 2 4 5 5 5 6 4 4 6 6 5 5 6 3 3 5 5 2 3 2 2 1 1 3 
655 2 4 5 5 5 6 4 4 6 6 5 5 6 3 3 5 5 2 3 2 2 1 1 3 
655 2 4 5 5 5 6 4 4 6 6 5 5 6 3 3 5 5 2 3 2 2 1 1 3 
655 2 4 5 5 5 6 4 4 6 6 5 5 6 3 3 5 5 2 3 2 2 1 1 3 
655 2 4 5 5 5 6 4 4 6 6 5 5 6 3 3 5 5 2 3 2 2 1 1 3 
650 2 4 5 5 5 6 4 4 6 6 5 5 6 3 3 5 5 2 3 2 2 1 4 
650 2 4 5 5 5 6 4 4 6 6 5 5 6 3 3 5 5 2 3 2 2 1 4 
650 2 4 5 5 5 6 4 4 6 6 5 5 6 3 3 5 5 2 3 2 2 1 4 
650 2 4 5 5 5 6 4 4 6 6 5 5 6 3 3 5 5 2 3 2 2 5 
650 2 4 5 5 5 6 4 4 6 6 5 5 6 3 3 5 5 2 3 2 2 1 4 
650 2 4 5 5 5 6 4 4 6 6 5 5 6 3 3 5 5 2 3 2 2 1 4 
650 2 4 5 5 5 6 4 4 6 6 5 5 6 3 3 5 5 2 3 2 2 1 4 
650 2 4 5 5 5 6 4 4 6 6 5 5 6 3 3 5 5 2 3 2 2 1 4 
650 2 4 5 5 5 6 4 4 6 6 5 5 6 3 3 5 5 2 3 2 2 1 4 
650 2 4 5 5 5 6 4 4 6 6 5 5 6 3 3 5 5 2 3 2 2 1 4 
650 2 4 5 5 5 6 4 4 6 6 5 5 6 3 3 5 5 2 3 2 2 1 4 
650 2 4 5 5 5 6 4 4 6 6 5 5 6 3 3 5 5 2 3 2 2 1 4 
650 2 4 5 5 5 6 4 4 6 6 5 5 6 3 3 5 5 2 3 2 2 1 4 
650 2 4 5 5 5 6 4 4 6 6 5 5 6 3 3 5 5 2 3 2 2 1 4 
640 2 4 5 5 5 6 4 4 6 6 5 5 3 5 5 6 4 3 2 3 1 1 6 
635 2 4 5 5 5 6 4 4 6 6 5 5 6 6 3 3 6 4 3 3 5 2 4 
630 2 4 5 5 5 6 4 4 6 6 5 5 6 3 3 5 5 2 3 2 2 1 3 
630 2 4 5 5 5 6 4 4 6 6 5 5 6 3 3 5 5 2 3 2 2 1 3 
630 2 4 5 5 5 6 4 4 6 6 5 5 6 3 3 5 5 2 3 2 2 1 3 
625 2 4 5 5 5 6 4 4 6 6 5 5 6 3 3 5 5 2 3 2 2 4 
625 2 4 5 5 5 6 4 4 6 6 5 5 6 3 3 5 5 2 3 2 2 4 
625 2 4 5 5 5 6 4 4 6 6 5 5 6 3 3 5 5 2 3 2 2 4 
625 2 4 5 5 5 6 4 4 6 6 5 5 6 3 3 5 5 2 3 2 2 4 
620 2 4 5 5 5 6 4 4 6 6 5 5 6 3 3 6 6 4 3 5 6 
615 2 4 5 5 5 6 4 4 6 6 5 5 6 3 3 5 5 2 3 2 6 
615 2 4 5 5 5 6 4 4 6 6 5 5 6 3 3 5 5 2 3 2 6 
615 2 4 5 5 5 6 4 4 6 6 5 5 6 3 3 5 5 2 3 2 6 
605 2 4 5 5 5 6 4 4 6 6 5 5 6 3 3 5 5 2 3 2 2 3 
605 2 4 5 5 5 6 4 4 6 6 5 5 6 3 3 5 5 2 3 2 2 3 
605 2 4 5 5 5 6 4 4 6 6 5 5 6 3 3 5 5 2 3 2 2 3 
600 2 4 5 5 5 6 4 4 6 6 5 5 6 3 3 5 5 2 3 2 5 
600 2 4 5 5 5 6 4 4 6 6 5 5 6 3 3 5 5 2 3 2 5 
600 2 4 5 5 5 6 4 4 6 6 5 5 3 6 3 5 4 5 2 4 1 1 3 
585 2 4 5 5 5 6 4 4 6 6 5 5 6 4 6 5 5 3 3 5 
575 2 4 5 5 5 6 4 4 6 6 5 5 6 3 3 5 5 2 3 2 4 
575 2 4 5 5 5 6 4 4 6 6 5 5 6 3 3 5 5 2 3 2 4 
560 2 4 5 5 5 6 4 4 6 6 5 5 3 6 6 4 3 5 5 4 
555 2 4 5 5 5 6 4 4 6 6 5 5 6 3 3 5 5 2 3 2 3 
530 2 4 5 5 5 6 4 4 6 6 5 5 6 4 6 6 3 1 3 3 
