700 4 4 6 5 5 6 4 5 5 1 2 1 3 5 3 6 4 5 6 4 6 1 2 6 
685 4 4 6 5 5 6 4 5 5 1 2 1 3 5 3 6 4 5 6 4 6 1 2 2 5 
685 4 4 6 5 5 6 4 5 5 1 2 1 3 5 3 6 4 5 6 4 6 1 2 5 
685 4 4 6 5 5 6 4 5 5 1 2 1 3 5 3 6 4 5 6 4 6 1 2 2 3 
675 4 4 6 5 5 6 4 5 5 1 2 1 3 5 3 6 4 5 6 4 6 1 1 6 
660 4 4 6 5 5 6 4 5 5 1 2 1 3 5 3 6 4 5 6 4 6 1 1 2 5 
660 4 4 6 5 5 6 4 5 5 1 2 1 3 5 3 6 4 5 6 4 6 1 1 2 4 
660 4 4 6 5 5 6 4 5 5 1 2 1 3 5 3 6 4 5 6 4 6 1 2 4 
660 4 4 6 5 5 6 4 5 5 1 2 1 3 5 3 6 4 5 6 4 6 1 1 5 
635 4 4 6 5 5 6 4 5 5 1 2 1 3 5 3 6 4 5 6 4 6 1 1 4 
625 4 4 6 5 5 6 4 5 5 1 2 1 3 5 3 6 4 5 6 4 6 6 
625 4 4 6 5 5 6 4 5 5 1 2 1 3 5 3 6 4 5 6 4 6 6 
610 4 4 6 5 5 6 4 5 5 1 2 1 3 5 3 6 4 5 6 4 6 5 
610 4 4 6 5 5 6 4 5 5 1 2 1 3 5 3 6 4 5 6 4 6 1 4 
610 4 4 6 5 5 6 4 5 5 1 2 1 3 5 3 6 4 5 6 4 6 5 
610 4 4 6 5 5 6 4 5 5 1 2 1 3 5 3 6 4 5 6 4 6 1 4 
610 4 4 6 5 5 6 4 5 5 1 2 1 3 5 3 6 4 5 6 4 6 5 
610 4 4 6 5 5 6 4 5 5 1 2 1 3 5 3 6 4 5 6 4 6 1 4 
610 4 4 6 5 5 6 4 5 5 1 2 1 3 5 3 6 4 5 6 4 6 5 
610 4 4 6 5 5 6 4 5 5 1 2 1 3 5 3 6 4 5 6 4 6 1 4 
610 4 4 6 5 5 6 4 5 5 1 2 1 3 5 3 6 4 5 6 4 5 6 
600 4 4 6 5 5 6 4 5 5 1 2 1 3 5 3 6 4 5 6 4 5 1 1 3 
600 4 4 6 5 5 6 4 5 5 1 2 1 3 5 3 6 4 5 6 4 5 2 3 
595 4 4 6 5 5 6 4 5 5 1 2 1 3 5 3 6 4 5 6 4 2 5 
590 4 4 6 5 5 6 4 5 5 1 2 1 3 5 3 6 4 5 6 4 6 1 3 
585 4 4 6 5 5 6 4 5 5 1 2 1 3 5 3 6 4 5 6 4 6 4 
585 4 4 6 5 5 6 4 5 5 1 2 1 3 5 3 6 4 5 6 4 6 4 
585 4 4 6 5 5 6 4 5 5 1 2 1 3 5 3 6 4 5 6 4 6 4 
585 4 4 6 5 5 6 4 5 5 1 2 1 3 5 3 6 4 5 6 4 6 4 
565 4 4 6 5 5 6 4 5 5 1 2 1 3 5 3 6 4 5 6 4 6 3 
