-135 6 5 5 3 6 4 1 4 4 3 3 3 4 2 4 5 
-135 6 5 5 3 6 4 1 4 4 3 3 3 4 2 4 5 5 
-135 6 5 5 3 6 4 1 4 4 3 3 3 4 2 4 5 5 
-135 6 5 5 3 6 4 1 4 4 3 3 3 4 2 4 5 5 4 
-135 6 5 5 3 6 4 1 4 4 3 3 3 4 2 4 5 5 
-135 6 5 5 3 6 4 1 4 4 3 3 3 4 2 4 5 5 
-135 6 5 5 3 6 4 1 4 4 3 3 3 4 2 4 5 5 
-135 6 5 5 3 6 4 1 4 4 3 3 3 4 2 4 5 5 4 
-135 6 5 5 3 6 4 1 4 4 3 3 3 4 2 4 5 5 
-135 6 5 5 3 6 4 1 4 4 3 3 3 4 2 4 5 
-135 6 5 5 3 6 4 1 4 4 3 3 3 4 2 4 5 5 
-135 6 5 5 3 6 4 1 4 4 3 3 3 4 2 4 5 5 4 
-135 6 5 5 3 6 4 1 4 4 3 3 3 4 2 4 5 
-135 6 5 5 3 6 4 1 4 4 3 3 3 4 2 4 5 5 
-135 6 5 5 3 6 4 1 4 4 3 3 3 4 2 4 5 5 4 
-135 6 5 5 3 6 4 1 4 4 3 3 3 4 2 4 5 5 
-135 6 5 5 3 6 4 1 4 4 3 3 3 4 2 4 5 5 4 
-135 6 5 5 3 6 4 1 4 4 3 3 3 4 2 4 5 5 4 
-135 6 5 5 3 6 4 1 4 4 3 3 3 4 2 4 5 5 
-135 6 5 5 3 6 4 1 4 4 3 3 3 4 2 4 5 
-135 6 5 5 3 6 4 1 4 4 3 3 3 4 2 4 5 5 4 
-135 6 5 5 3 6 4 1 4 4 3 3 3 4 2 4 5 5 
-135 6 5 5 3 6 4 1 4 4 3 3 3 4 2 4 5 
-135 6 5 5 3 6 4 1 4 4 3 3 3 4 2 4 5 5 
-135 6 5 5 3 6 4 1 4 4 3 3 3 4 2 4 5 5 4 
-135 6 5 5 3 6 4 1 4 3 2 
-135 6 5 5 3 6 4 1 4 3 
-135 6 5 5 3 6 4 1 4 2 
-135 6 5 5 3 6 4 
-135 6 5 5 3 6 4 4 4 
-135 6 5 5 3 6 4 1 
-135 6 5 5 3 6 4 1 4 5 
-135 6 5 5 3 6 4 1 4 2 
-135 6 5 5 3 6 4 1 4 
-135 6 5 5 3 6 4 1 4 
-135 6 5 5 3 6 4 1 
-135 6 5 5 3 6 4 1 4 
-135 6 5 5 3 6 4 1 4 
-135 6 5 5 3 6 4 1 
-135 6 5 5 3 6 4 1 
-135 6 5 5 3 6 4 1 
-135 6 5 5 3 6 4 1 
-135 6 5 5 3 6 4 1 2 
-135 6 5 5 3 6 4 1 
-135 6 5 5 3 6 4 1 4 
-135 6 5 5 3 6 4 1 4 
-135 6 5 5 3 6 4 1 4 
-135 6 5 5 3 6 4 1 4 
