1165 5 6 5 5 3 4 6 4 6 3 1 3 1 2 5 6 6 6 2 3 6 2 2 2 2 2 3 6 6 4 6 6 2 6 
1070 5 6 5 5 3 4 6 4 6 3 1 3 1 2 5 6 6 6 2 3 6 2 2 2 2 2 3 4 5 6 5 5 
1050 5 6 5 5 3 4 6 4 6 3 1 3 1 2 5 6 6 6 2 3 6 2 2 2 2 2 2 3 5 3 6 5 
925 5 6 5 5 3 4 6 4 6 3 1 3 1 2 5 6 6 6 2 3 6 2 2 2 2 2 5 2 
925 5 6 5 5 3 4 6 4 6 3 1 3 1 2 5 6 6 6 2 3 6 2 2 2 2 1 1 5 2 
925 5 6 5 5 3 4 6 4 6 3 1 3 1 2 5 6 6 6 2 3 6 2 2 2 2 1 4 2 2 
920 5 6 5 5 3 4 6 4 6 3 1 3 1 2 5 6 6 6 2 3 6 2 2 2 2 1 3 6 2 
910 5 6 5 5 3 4 6 4 6 3 1 3 1 2 5 6 6 6 2 3 6 2 2 2 1 2 4 3 2 4 3 
885 5 6 5 5 3 4 6 4 6 3 1 3 1 2 5 6 6 6 2 3 6 2 2 2 2 1 1 3 3 2 
855 5 6 5 5 3 4 6 4 6 3 1 3 1 2 5 6 6 6 2 3 6 2 2 2 2 1 1 3 4 
855 5 6 5 5 3 4 6 4 6 3 1 3 1 2 5 6 6 6 2 3 6 2 2 2 2 1 3 4 1 
855 5 6 5 5 3 4 6 4 6 3 1 3 1 2 5 6 6 6 2 3 6 2 2 2 2 1 3 4 1 
850 5 6 5 5 3 4 6 4 6 3 1 3 1 2 5 6 6 6 2 3 6 2 2 2 2 1 2 
850 5 6 5 5 3 4 6 4 6 3 1 3 1 2 5 6 6 6 2 3 6 2 2 2 2 2 4 
850 5 6 5 5 3 4 6 4 6 3 1 3 1 2 5 6 6 6 2 3 6 2 2 2 2 1 4 4 
850 5 6 5 5 3 4 6 4 6 3 1 3 1 2 5 6 6 6 2 3 6 2 2 2 2 1 1 4 
850 5 6 5 5 3 4 6 4 6 3 1 3 1 2 5 6 6 6 2 3 6 2 2 2 2 2 1 
850 5 6 5 5 3 4 6 4 6 3 1 3 1 2 5 6 6 6 2 3 6 2 2 2 2 2 1 
850 5 6 5 5 3 4 6 4 6 3 1 3 1 2 5 6 6 6 2 3 6 2 2 2 2 2 1 
850 5 6 5 5 3 4 6 4 6 3 1 3 1 2 5 6 6 6 2 3 6 2 2 2 2 1 1 1 
850 5 6 5 5 3 4 6 4 6 3 1 3 1 2 5 6 6 6 2 3 6 2 2 2 2 1 4 1 
850 5 6 5 5 3 4 6 4 6 3 1 3 1 2 5 6 6 6 2 3 6 2 2 2 2 1 1 1 
840 5 6 5 5 3 4 6 4 6 3 1 3 1 2 5 6 6 6 2 3 6 2 2 2 2 6 
840 5 6 5 5 3 4 6 4 6 3 1 3 1 2 5 6 6 6 2 3 6 2 2 2 2 6 
840 5 6 5 5 3 4 6 4 6 3 1 3 1 2 5 6 6 6 2 3 6 2 2 2 2 6 
840 5 6 5 5 3 4 6 4 6 3 1 3 1 2 5 6 6 6 2 3 6 2 2 2 2 6 
840 5 6 5 5 3 4 6 4 6 3 1 3 1 2 5 6 6 6 2 3 6 2 2 2 2 6 
840 5 6 5 5 3 4 6 4 6 3 1 3 1 2 5 6 6 6 2 3 6 2 2 2 2 6 
840 5 6 5 5 3 4 6 4 6 3 1 3 1 2 5 6 6 6 2 3 6 2 2 2 2 6 
825 5 6 5 5 3 4 6 4 6 3 1 3 1 2 5 6 6 6 2 3 6 2 2 2 2 5 
825 5 6 5 5 3 4 6 4 6 3 1 3 1 2 5 6 6 6 2 3 6 2 2 2 2 5 
825 5 6 5 5 3 4 6 4 6 3 1 3 1 2 5 6 6 6 2 3 6 2 2 2 2 5 
825 5 6 5 5 3 4 6 4 6 3 1 3 1 2 5 6 6 6 2 3 6 2 2 2 2 5 
825 5 6 5 5 3 4 6 4 6 3 1 3 1 2 5 6 6 6 2 3 6 2 2 2 2 5 
825 5 6 5 5 3 4 6 4 6 3 1 3 1 2 5 6 6 6 2 3 6 2 2 2 2 5 
825 5 6 5 5 3 4 6 4 6 3 1 3 1 2 5 6 6 6 2 3 6 2 2 2 2 5 
800 5 6 5 5 3 4 6 4 6 3 1 3 1 2 5 6 6 6 2 3 6 2 2 2 2 4 
800 5 6 5 5 3 4 6 4 6 3 1 3 1 2 5 6 6 6 2 3 6 2 2 2 2 4 
800 5 6 5 5 3 4 6 4 6 3 1 3 1 2 5 6 6 6 2 3 6 2 2 2 2 4 
800 5 6 5 5 3 4 6 4 6 3 1 3 1 2 5 6 6 6 2 3 6 2 2 2 2 4 
800 5 6 5 5 3 4 6 4 6 3 1 3 1 2 5 6 6 6 2 3 6 2 2 2 2 4 
800 5 6 5 5 3 4 6 4 6 3 1 3 1 2 5 6 6 6 2 3 6 2 2 2 2 4 
800 5 6 5 5 3 4 6 4 6 3 1 3 1 2 5 6 6 6 2 3 6 2 2 2 2 4 
800 5 6 5 5 3 4 6 4 6 3 1 3 1 2 5 6 6 6 2 3 6 2 2 2 1 5 
800 5 6 5 5 3 4 6 4 6 3 1 3 1 2 5 6 6 6 2 3 6 2 2 2 2 4 
800 5 6 5 5 3 4 6 4 6 3 1 3 1 2 5 6 6 6 2 3 6 2 2 2 1 5 
800 5 6 5 5 3 4 6 4 6 3 1 3 1 2 5 6 6 6 2 3 6 2 2 2 2 4 
800 5 6 5 5 3 4 6 4 6 3 1 3 1 2 5 6 6 6 2 3 6 2 2 2 2 4 
800 5 6 5 5 3 4 6 4 6 3 1 3 1 2 5 6 6 6 2 3 6 2 2 2 2 4 
800 5 6 5 5 3 4 6 4 6 3 1 3 1 2 5 6 6 6 2 3 6 2 2 2 2 4 
790 5 6 5 5 3 4 6 4 6 3 1 3 1 2 5 6 6 6 2 3 6 2 2 2 6 
790 5 6 5 5 3 4 6 4 6 3 1 3 1 2 5 6 6 6 2 3 6 2 2 2 6 
790 5 6 5 5 3 4 6 4 6 3 1 3 1 2 5 6 6 6 2 3 6 2 2 2 6 
790 5 6 5 5 3 4 6 4 6 3 1 3 1 2 5 6 6 6 2 3 6 2 2 2 6 
790 5 6 5 5 3 4 6 4 6 3 1 3 1 2 5 6 6 6 2 3 6 2 2 2 6 
790 5 6 5 5 3 4 6 4 6 3 1 3 1 2 5 6 6 6 2 3 6 2 2 2 6 
790 5 6 5 5 3 4 6 4 6 3 1 3 1 2 5 6 6 6 2 3 6 2 2 2 6 
790 5 6 5 5 3 4 6 4 6 3 1 3 1 2 5 6 6 6 2 3 6 2 2 2 6 
785 5 6 5 5 3 4 6 4 6 3 1 3 1 2 5 6 4 4 4 5 3 6 6 2 2 2 5 
780 5 6 5 5 3 4 6 4 6 3 1 3 1 2 5 6 6 6 2 3 6 2 2 2 2 3 
780 5 6 5 5 3 4 6 4 6 3 1 3 1 2 5 6 6 6 2 3 6 2 2 2 2 3 
780 5 6 5 5 3 4 6 4 6 3 1 3 1 2 5 6 6 6 2 3 6 2 2 2 2 3 
780 5 6 5 5 3 4 6 4 6 3 1 3 1 2 5 6 6 6 2 3 6 2 2 2 2 3 
780 5 6 5 5 3 4 6 4 6 3 1 3 1 2 5 6 6 6 2 3 6 2 2 2 2 3 
780 5 6 5 5 3 4 6 4 6 3 1 3 1 2 5 6 6 6 2 3 6 2 2 2 2 3 
780 5 6 5 5 3 4 6 4 6 3 1 3 1 2 5 6 6 6 2 3 6 2 2 2 2 3 
775 5 6 5 5 3 4 6 4 6 3 1 3 1 2 5 6 6 6 2 3 6 2 2 2 1 4 
775 5 6 5 5 3 4 6 4 6 3 1 3 1 2 5 6 6 6 2 3 6 2 2 2 5 
775 5 6 5 5 3 4 6 4 6 3 1 3 1 2 5 6 6 6 2 3 6 2 2 2 5 
775 5 6 5 5 3 4 6 4 6 3 1 3 1 2 5 6 6 6 2 3 6 2 2 2 5 
775 5 6 5 5 3 4 6 4 6 3 1 3 1 2 5 6 6 6 2 3 6 2 2 2 5 
775 5 6 5 5 3 4 6 4 6 3 1 3 1 2 5 6 6 6 2 3 6 2 2 2 5 
775 5 6 5 5 3 4 6 4 6 3 1 3 1 2 5 6 6 6 2 3 6 2 2 2 5 
775 5 6 5 5 3 4 6 4 6 3 1 3 1 2 5 6 6 6 2 3 6 2 2 2 5 
775 5 6 5 5 3 4 6 4 6 3 1 3 1 2 5 6 6 6 2 3 6 2 2 2 5 
775 5 6 5 5 3 4 6 4 6 3 1 3 1 2 5 6 6 6 2 3 6 2 2 2 5 
775 5 6 5 5 3 4 6 4 6 3 1 3 1 2 5 6 6 6 2 3 6 2 2 2 5 
775 5 6 5 5 3 4 6 4 6 3 1 3 1 2 5 6 6 6 2 3 6 2 2 2 5 
775 5 6 5 5 3 4 6 4 6 3 1 3 1 2 5 6 6 6 2 3 6 2 2 2 5 
765 5 6 5 5 3 4 6 4 6 3 1 3 1 2 5 6 6 6 2 3 6 2 2 1 6 
765 5 6 5 5 3 4 6 4 6 3 1 3 1 2 5 6 6 6 2 3 6 2 2 1 6 
755 5 6 5 5 3 4 6 4 6 3 1 3 1 2 5 6 6 6 2 3 6 2 2 2 1 3 
750 5 6 5 5 3 4 6 4 6 3 1 3 1 2 5 6 6 6 2 3 6 2 2 2 4 
750 5 6 5 5 3 4 6 4 6 3 1 3 1 2 5 6 6 6 2 3 6 2 2 2 4 
750 5 6 5 5 3 4 6 4 6 3 1 3 1 2 5 6 6 6 2 3 6 2 2 2 4 
750 5 6 5 5 3 4 6 4 6 3 1 3 1 2 5 6 6 6 2 3 6 2 2 2 4 
750 5 6 5 5 3 4 6 4 6 3 1 3 1 2 5 6 6 6 2 3 6 2 2 2 4 
750 5 6 5 5 3 4 6 4 6 3 1 3 1 2 5 6 6 6 2 3 6 2 2 2 4 
750 5 6 5 5 3 4 6 4 6 3 1 3 1 2 5 6 6 6 2 3 6 2 2 1 5 
750 5 6 5 5 3 4 6 4 6 3 1 3 1 2 5 6 6 6 2 3 6 2 2 2 4 
745 5 6 5 5 3 4 6 4 6 3 1 3 1 2 5 6 6 6 2 2 2 1 2 6 
740 5 6 5 5 3 4 6 4 6 3 1 3 1 2 5 6 6 6 2 3 6 2 2 6 
740 5 6 5 5 3 4 6 4 6 3 1 3 1 2 5 6 6 6 2 3 6 2 2 6 
740 5 6 5 5 3 4 6 4 6 3 1 3 1 2 5 6 6 6 2 3 6 2 2 6 
735 5 6 5 5 3 4 6 4 6 3 1 3 1 2 5 6 6 6 2 6 2 2 6 
730 5 6 5 5 3 4 6 4 6 3 1 3 1 2 5 6 6 6 2 3 6 2 2 2 3 
730 5 6 5 5 3 4 6 4 6 3 1 3 1 2 5 6 6 6 2 3 6 2 2 2 3 
730 5 6 5 5 3 4 6 4 6 3 1 3 1 2 5 6 6 6 2 3 6 2 2 2 3 
730 5 6 5 5 3 4 6 4 6 3 1 3 1 2 5 6 6 6 2 3 6 2 2 2 3 
730 5 6 5 5 3 4 6 4 6 3 1 3 1 2 5 6 6 6 2 3 6 2 2 2 3 
730 5 6 5 5 3 4 6 4 6 3 1 3 1 2 5 6 6 6 2 3 6 2 2 2 3 
730 5 6 5 5 3 4 6 4 6 3 1 3 1 2 5 6 6 6 2 3 6 2 2 2 3 
730 5 6 5 5 3 4 6 4 6 3 1 3 1 2 5 6 6 6 2 3 6 2 2 2 3 
730 5 6 5 5 3 4 6 4 6 3 1 3 1 2 5 6 6 5 2 6 2 2 2 4 
730 5 6 5 5 3 4 6 4 6 3 1 3 1 2 5 6 6 6 2 3 6 2 2 2 3 
730 5 6 5 5 3 4 6 4 6 3 1 3 1 2 5 6 6 6 2 3 6 2 2 2 3 
725 5 6 5 5 3 4 6 4 6 3 1 3 1 2 5 6 6 6 2 3 6 2 2 1 4 
725 5 6 5 5 3 4 6 4 6 3 1 3 1 2 5 6 6 6 2 3 6 2 2 5 
725 5 6 5 5 3 4 6 4 6 3 1 3 1 2 5 6 6 6 2 3 6 2 2 1 4 
725 5 6 5 5 3 4 6 4 6 3 1 3 1 2 5 6 6 6 2 3 6 2 2 5 
725 5 6 5 5 3 4 6 4 6 3 1 3 1 2 5 6 6 6 2 3 6 2 2 5 
725 5 6 5 5 3 4 6 4 6 3 1 3 1 2 5 6 6 6 2 3 6 2 2 1 4 
725 5 6 5 5 3 4 6 4 6 3 1 3 1 2 5 6 6 6 2 6 2 2 2 3 
725 5 6 5 5 3 4 6 4 6 3 1 3 1 2 5 6 6 6 2 3 6 2 2 5 
725 5 6 5 5 3 4 6 4 6 3 1 3 1 2 5 6 6 6 2 3 6 2 2 5 
725 5 6 5 5 3 4 6 4 6 3 1 3 1 2 5 6 6 6 2 3 6 2 2 5 
725 5 6 5 5 3 4 6 4 6 3 1 3 1 2 5 6 6 6 2 3 6 2 2 5 
725 5 6 5 5 3 4 6 4 6 3 1 3 1 2 5 6 6 6 2 3 6 2 2 5 
725 5 6 5 5 3 4 6 4 6 3 1 3 1 2 5 6 6 6 2 3 6 2 2 1 4 
710 5 6 5 5 3 4 6 4 6 3 1 3 1 2 5 6 6 6 2 6 1 2 6 
710 5 6 5 5 3 4 6 4 6 3 1 3 1 2 5 6 6 6 2 6 2 1 6 
710 5 6 5 5 3 4 6 4 6 3 1 3 1 2 5 6 6 6 2 6 1 2 6 
700 5 6 5 5 3 4 6 4 6 3 1 3 1 2 5 6 6 6 2 3 6 2 2 4 
700 5 6 5 5 3 4 6 4 6 3 1 3 1 2 5 6 6 6 2 6 2 1 2 3 
700 5 6 5 5 3 4 6 4 6 3 1 3 1 2 5 6 6 6 2 3 6 2 2 4 
700 5 6 5 5 3 4 6 4 6 3 1 3 1 2 5 6 6 6 2 3 6 2 2 4 
700 5 6 5 5 3 4 6 4 6 3 1 3 1 2 5 6 6 6 2 3 6 2 2 4 
700 5 6 5 5 3 4 6 4 6 3 1 3 1 2 5 6 6 6 2 3 6 2 2 4 
695 5 6 5 5 3 4 6 4 6 3 1 3 1 2 5 6 6 6 2 6 2 1 5 
695 5 6 5 5 3 4 6 4 6 3 1 3 1 2 5 6 6 4 5 2 3 1 2 2 5 
695 5 6 5 5 3 4 6 4 6 3 1 3 1 2 5 6 6 6 2 6 2 2 4 
695 5 6 5 5 3 4 6 4 6 3 1 3 1 2 5 6 6 6 2 6 1 2 5 
685 5 6 5 5 3 4 6 4 6 3 1 3 1 2 5 6 6 6 2 6 2 6 
680 5 6 5 5 3 4 6 4 6 3 1 3 1 2 5 6 6 6 2 3 6 2 2 3 
680 5 6 5 5 3 4 6 4 6 3 1 3 1 2 5 6 6 6 2 3 6 2 2 3 
680 5 6 5 5 3 4 6 4 6 3 1 3 1 2 5 6 6 6 2 3 6 2 2 3 
680 5 6 5 5 3 4 6 4 6 3 1 3 1 2 5 6 6 6 2 3 6 2 2 3 
680 5 6 5 5 3 4 6 4 6 3 1 3 1 2 5 6 6 6 2 3 6 2 2 3 
680 5 6 5 5 3 4 6 4 6 3 1 3 1 2 5 6 6 6 2 3 6 2 2 3 
680 5 6 5 5 3 4 6 4 6 3 1 3 1 2 5 6 6 6 2 3 6 2 2 3 
680 5 6 5 5 3 4 6 4 6 3 1 3 1 2 5 6 6 6 2 3 6 2 2 3 
680 5 6 5 5 3 4 6 4 6 3 1 3 1 2 5 6 6 6 2 3 6 2 2 3 
680 5 6 5 5 3 4 6 4 6 3 1 3 1 2 5 6 6 6 2 3 6 2 2 3 
675 5 6 5 5 3 4 6 4 6 3 1 3 1 2 5 6 6 6 2 6 2 2 3 
675 5 6 5 5 3 4 6 4 6 3 1 3 1 2 5 6 6 6 3 5 5 2 6 
670 5 6 5 5 3 4 6 4 6 3 1 3 1 2 5 6 6 6 2 6 2 1 4 
670 5 6 5 5 3 4 6 4 6 3 1 3 1 2 5 6 6 6 2 2 2 6 
670 5 6 5 5 3 4 6 4 6 3 1 3 1 2 5 6 6 6 2 5 2 6 
670 5 6 5 5 3 4 6 4 6 3 1 3 1 2 5 6 6 6 2 6 2 5 
670 5 6 5 5 3 4 6 4 6 3 1 3 1 2 5 6 6 6 2 6 2 1 4 
670 5 6 5 5 3 4 6 4 6 3 1 3 1 2 5 6 3 4 6 4 2 1 5 2 5 
670 5 6 5 5 3 4 6 4 6 3 1 3 1 2 5 6 6 6 2 6 2 5 
670 5 6 5 5 3 4 6 4 6 3 1 3 1 2 5 6 6 6 2 6 2 5 
670 5 6 5 5 3 4 6 4 6 3 1 3 1 2 5 6 6 6 2 6 2 5 
670 5 6 5 5 3 4 6 4 6 3 1 3 1 2 5 6 6 6 2 6 2 5 
665 5 6 5 5 3 4 6 4 6 3 1 3 1 2 5 6 6 3 5 1 3 4 1 4 2 6 
660 5 6 5 5 3 4 6 4 6 3 1 3 1 2 5 6 6 6 3 4 4 5 2 1 4 
660 5 6 5 5 3 4 6 4 6 3 1 3 1 2 5 6 6 6 2 6 1 6 
655 5 6 5 5 3 4 6 4 6 3 1 3 1 2 5 6 6 6 2 5 1 1 5 
655 5 6 5 5 3 4 6 4 6 3 1 3 1 2 5 6 6 4 5 4 6 2 5 
655 5 6 5 5 3 4 6 4 6 3 1 3 1 2 5 6 6 6 2 2 1 1 5 
655 5 6 5 5 3 4 6 4 6 3 1 3 1 2 5 6 6 6 2 1 2 1 5 
655 5 6 5 5 3 4 6 4 6 3 1 3 1 2 5 6 6 6 2 5 2 5 
655 5 6 5 5 3 4 6 4 6 3 1 3 1 2 5 6 6 6 2 1 5 2 4 
655 5 6 5 5 3 4 6 4 6 3 1 3 1 2 5 6 6 6 2 2 2 1 4 
655 5 6 5 5 3 4 6 4 6 3 1 3 1 2 5 6 6 6 2 3 3 6 1 1 4 
655 5 6 5 5 3 4 6 4 6 3 1 3 1 2 5 6 5 5 6 5 2 6 
650 5 6 5 5 3 4 6 4 6 3 1 3 1 2 5 6 6 6 2 6 2 1 3 
650 5 6 5 5 3 4 6 4 6 3 1 3 1 2 5 6 6 6 2 6 1 2 3 
650 5 6 5 5 3 4 6 4 6 3 1 3 1 2 5 6 6 6 2 6 2 1 3 
650 5 6 5 5 3 4 6 4 6 3 1 3 1 2 5 6 6 6 2 6 2 1 3 
650 5 6 5 5 3 4 6 4 6 3 1 3 1 2 5 6 6 4 5 3 4 6 1 6 
645 5 6 5 5 3 4 6 4 6 3 1 3 1 2 5 6 6 6 2 6 2 4 
645 5 6 5 5 3 4 6 4 6 3 1 3 1 2 5 6 6 6 2 6 1 5 
645 5 6 5 5 3 4 6 4 6 3 1 3 1 2 5 6 6 6 2 6 2 4 
645 5 6 5 5 3 4 6 4 6 3 1 3 1 2 5 6 6 6 2 6 2 4 
645 5 6 5 5 3 4 6 4 6 3 1 3 1 2 5 6 6 6 2 1 6 5 
645 5 6 5 5 3 4 6 4 6 3 1 3 1 2 5 6 6 6 2 6 1 5 
645 5 6 5 5 3 4 6 4 6 3 1 3 1 2 5 6 6 6 2 6 2 4 
640 5 6 5 5 3 4 6 4 6 3 1 3 1 2 5 6 6 3 6 1 2 2 2 3 
635 5 6 5 5 3 4 6 4 6 3 1 3 1 2 5 6 6 6 2 6 6 
635 5 6 5 5 3 4 6 4 6 3 1 3 1 2 5 6 6 6 2 6 6 
635 5 6 5 5 3 4 6 4 6 3 1 3 1 2 5 6 6 6 2 6 6 
635 5 6 5 5 3 4 6 4 6 3 1 3 1 2 5 6 6 6 1 4 4 1 2 1 3 
635 5 6 5 5 3 4 6 4 6 3 1 3 1 2 5 6 6 6 2 6 6 
630 5 6 5 5 3 4 6 4 6 3 1 3 1 2 5 6 6 5 1 4 4 5 6 
630 5 6 5 5 3 4 6 4 6 3 1 3 1 2 5 6 6 6 2 5 2 4 
630 5 6 5 5 3 4 6 4 6 3 1 3 1 2 5 6 1 4 5 5 3 1 4 2 5 
625 5 6 5 5 3 4 6 4 6 3 1 3 1 2 5 6 6 6 2 6 2 3 
625 5 6 5 5 3 4 6 4 6 3 1 3 1 2 5 6 6 6 2 6 2 3 
625 5 6 5 5 3 4 6 4 6 3 1 3 1 2 5 6 6 6 2 6 2 3 
625 5 6 5 5 3 4 6 4 6 3 1 3 1 2 5 6 6 6 2 6 2 3 
625 5 6 5 5 3 4 6 4 6 3 1 3 1 2 5 6 6 6 2 6 2 3 
620 5 6 5 5 3 4 6 4 6 3 1 3 1 2 5 6 6 6 2 2 6 
620 5 6 5 5 3 4 6 4 6 3 1 3 1 2 5 6 6 6 2 5 6 
620 5 6 5 5 3 4 6 4 6 3 1 3 1 2 5 6 6 6 2 6 5 
620 5 6 5 5 3 4 6 4 6 3 1 3 1 2 5 6 6 6 2 6 5 
620 5 6 5 5 3 4 6 4 6 3 1 3 1 2 5 6 6 6 2 6 5 
620 5 6 5 5 3 4 6 4 6 3 1 3 1 2 5 6 6 6 2 2 6 
620 5 6 5 5 3 4 6 4 6 3 1 3 1 2 5 6 6 6 2 6 1 4 
620 5 6 5 5 3 4 6 4 6 3 1 3 1 2 5 6 6 6 2 2 6 
620 5 6 5 5 3 4 6 4 6 3 1 3 1 2 5 6 6 6 2 4 6 4 
620 5 6 5 5 3 4 6 4 6 3 1 3 1 2 5 6 6 6 2 4 1 6 
615 5 6 5 5 3 4 6 4 6 3 1 3 1 2 5 6 6 6 4 4 3 3 2 5 
615 5 6 5 5 3 4 6 4 6 3 1 3 1 2 5 6 6 6 2 3 3 2 5 
610 5 6 5 5 3 4 6 4 6 3 1 3 1 2 5 6 6 6 2 5 2 3 
610 5 6 5 5 3 4 6 4 6 3 1 3 1 2 5 6 6 5 3 5 2 6 
610 5 6 5 5 3 4 6 4 6 3 1 3 1 2 5 6 6 6 2 5 2 3 
610 5 6 5 5 3 4 6 4 6 3 1 3 1 2 5 6 6 6 2 4 3 2 4 
610 5 6 5 5 3 4 6 4 6 3 1 3 1 2 5 6 6 4 3 5 4 6 5 
605 5 6 5 5 3 4 6 4 6 3 1 3 1 2 5 6 6 6 2 2 5 
605 5 6 5 5 3 4 6 4 6 3 1 3 1 2 5 6 6 6 2 4 2 4 
605 5 6 5 5 3 4 6 4 6 3 1 3 1 2 5 6 6 6 2 2 1 4 
605 5 6 5 5 3 4 6 4 6 3 1 3 1 2 5 6 6 6 2 1 4 5 
605 5 6 5 5 3 4 6 4 6 3 1 3 1 2 5 6 6 6 2 2 5 
605 5 6 5 5 3 4 6 4 6 3 1 3 1 2 5 6 6 3 3 4 1 6 6 4 
600 5 6 5 5 3 4 6 4 6 3 1 3 1 2 5 6 6 6 2 6 1 3 
600 5 6 5 5 3 4 6 4 6 3 1 3 1 2 5 6 6 6 2 6 1 3 
600 5 6 5 5 3 4 6 4 6 3 1 3 1 2 5 6 6 6 4 3 6 5 
595 5 6 5 5 3 4 6 4 6 3 1 3 1 2 5 6 6 6 2 6 4 
595 5 6 5 5 3 4 6 4 6 3 1 3 1 2 5 6 6 4 4 3 5 4 1 5 
595 5 6 5 5 3 4 6 4 6 3 1 3 1 2 5 6 6 6 2 6 4 
595 5 6 5 5 3 4 6 4 6 3 1 3 1 2 5 6 6 6 6 4 5 
595 5 6 5 5 3 4 6 4 6 3 1 3 1 2 5 6 6 6 2 6 4 
595 5 6 5 5 3 4 6 4 6 3 1 3 1 2 5 6 6 6 2 6 4 
595 5 6 5 5 3 4 6 4 6 3 1 3 1 2 5 6 6 6 2 6 4 
595 5 6 5 5 3 4 6 4 6 3 1 3 1 2 5 6 6 6 2 6 4 
595 5 6 5 5 3 4 6 4 6 3 1 3 1 2 5 6 6 6 2 6 4 
595 5 6 5 5 3 4 6 4 6 3 1 3 1 2 5 6 6 6 2 6 4 
595 5 6 5 5 3 4 6 4 6 3 1 3 1 2 5 6 6 6 2 6 4 
590 5 6 5 5 3 4 6 4 6 3 1 3 1 2 5 6 6 6 6 6 3 
590 5 6 5 5 3 4 6 4 6 3 1 3 1 2 5 6 6 6 2 3 3 2 4 
585 5 6 5 5 3 4 6 4 6 3 1 3 1 2 5 6 6 6 2 1 5 3 
585 5 6 5 5 3 4 6 4 6 3 1 3 1 2 5 6 6 6 1 2 5 3 
585 5 6 5 5 3 4 6 4 6 3 1 3 1 2 5 6 6 6 2 5 1 3 
585 5 6 5 5 3 4 6 4 6 3 1 3 1 2 5 6 6 6 2 4 5 3 
580 5 6 5 5 3 4 6 4 6 3 1 3 1 2 5 6 6 6 2 5 4 
580 5 6 5 5 3 4 6 4 6 3 1 3 1 2 5 6 6 6 2 2 4 
575 5 6 5 5 3 4 6 4 6 3 1 3 1 2 5 6 6 5 3 1 3 2 1 4 
575 5 6 5 5 3 4 6 4 6 3 1 3 1 2 5 6 6 6 2 6 3 
575 5 6 5 5 3 4 6 4 6 3 1 3 1 2 5 6 6 6 2 6 3 
575 5 6 5 5 3 4 6 4 6 3 1 3 1 2 5 6 6 6 2 6 3 
575 5 6 5 5 3 4 6 4 6 3 1 3 1 2 5 6 3 6 4 5 4 1 3 4 4 
570 5 6 5 5 3 4 6 4 6 3 1 3 1 2 5 6 6 4 3 6 3 4 3 5 
570 5 6 5 5 3 4 6 4 6 3 1 3 1 2 5 6 6 3 5 1 1 2 4 
565 5 6 5 5 3 4 6 4 6 3 1 3 1 2 5 6 5 6 1 4 2 4 
560 5 6 5 5 3 4 6 4 6 3 1 3 1 2 5 6 6 6 2 2 3 
560 5 6 5 5 3 4 6 4 6 3 1 3 1 2 5 6 6 6 2 5 3 
560 5 6 5 5 3 4 6 4 6 3 1 3 1 2 5 6 6 6 2 5 3 
560 5 6 5 5 3 4 6 4 6 3 1 3 1 2 5 6 6 6 2 5 3 
555 5 6 5 5 3 4 6 4 6 3 1 3 1 2 5 6 6 6 1 3 6 3 
550 5 6 5 5 3 4 6 4 6 3 1 3 1 2 5 6 6 5 3 4 1 2 3 
545 5 6 5 5 3 4 6 4 6 3 1 3 1 2 5 6 6 5 4 1 5 3 
535 5 6 5 5 3 4 6 4 6 3 1 3 1 2 5 6 6 6 4 4 4 3 
525 5 6 5 5 3 4 6 4 6 3 1 3 1 2 5 6 4 6 6 3 3 3 4 3 
430 5 6 5 5 3 4 6 4 6 3 1 3 1 2 5 3 3 6 5 5 6 5 1 2 4 
