755 6 5 5 5 6 4 3 4 6 2 2 3 6 5 5 5 5 4 3 4 6 2 2 6 
735 6 5 5 5 6 4 3 4 6 2 2 3 6 5 5 6 4 2 5 2 1 2 5 
700 6 5 5 5 6 4 3 4 6 2 2 3 6 5 5 5 4 5 6 2 1 6 
665 6 5 5 5 6 4 3 4 6 2 2 3 6 5 5 5 5 3 1 5 5 6 
665 6 5 5 5 6 4 3 4 6 2 2 3 6 5 5 5 5 3 4 4 4 5 6 
650 6 5 5 5 6 4 3 4 6 2 2 3 6 5 5 5 4 4 4 4 1 3 1 1 2 4 
650 6 5 5 5 6 4 3 4 6 2 2 3 6 5 5 5 5 6 6 5 
650 6 5 5 5 6 4 3 4 6 2 2 3 6 5 5 5 5 4 3 4 2 2 4 
635 6 5 5 5 6 4 3 4 6 2 2 3 6 5 5 5 5 5 6 5 
635 6 5 5 5 6 4 3 4 6 2 2 3 6 5 5 5 5 2 6 5 
630 6 5 5 5 6 4 3 4 6 2 2 3 6 5 5 5 6 5 3 1 6 
625 6 5 5 5 6 4 3 4 6 2 2 3 6 5 5 5 4 6 2 6 
620 6 5 5 5 6 4 3 4 6 2 2 3 6 5 5 5 5 5 2 5 
610 6 5 5 5 6 4 3 4 6 2 2 3 6 5 3 1 5 6 6 3 1 5 
605 6 5 5 5 6 4 3 4 6 2 2 3 6 5 5 5 4 3 5 4 3 5 4 
585 6 5 5 5 6 4 3 4 6 2 2 3 6 5 5 5 5 4 6 4 
585 6 5 5 5 6 4 3 4 6 2 2 3 6 5 5 3 6 3 6 5 4 
575 6 5 5 5 6 4 3 4 6 2 2 3 6 5 5 5 6 6 4 
570 6 5 5 5 6 4 3 4 6 2 2 3 6 5 5 5 4 3 6 2 3 
550 6 5 5 5 6 4 3 4 6 2 2 3 6 5 5 5 6 3 3 2 3 
495 6 5 5 5 6 4 3 4 6 2 2 3 6 5 5 5 4 2 
495 6 5 5 5 6 4 3 4 6 2 2 3 6 5 5 5 4 2 
485 6 5 5 5 6 4 3 4 6 2 2 3 6 5 5 6 2 
485 6 5 5 5 6 4 3 4 6 2 2 3 6 5 5 6 2 
470 6 5 5 5 6 4 3 4 6 2 2 3 6 5 5 5 2 
470 6 5 5 5 6 4 3 4 6 2 2 3 6 5 5 5 2 
470 6 5 5 5 6 4 3 4 6 2 2 3 6 5 5 5 4 1 
470 6 5 5 5 6 4 3 4 6 2 2 3 6 5 5 5 2 
460 6 5 5 5 6 4 3 4 6 2 2 3 6 5 1 6 2 
440 6 5 5 5 6 4 3 4 6 2 2 3 6 5 5 3 4 3 3 3 1 
425 6 5 5 5 6 4 3 4 6 2 2 3 6 5 5 5 3 
425 6 5 5 5 6 4 3 4 6 2 2 3 6 5 5 5 3 
425 6 5 5 5 6 4 3 4 6 2 2 3 6 5 5 5 3 
420 6 5 5 5 6 4 3 4 6 2 2 3 6 5 5 2 
420 6 5 5 5 6 4 3 4 6 2 2 3 6 5 5 2 
420 6 5 5 5 6 4 3 4 6 2 2 3 6 5 5 2 
420 6 5 5 5 6 4 3 4 6 2 2 3 6 5 5 2 
400 6 5 5 5 6 4 3 4 6 2 2 3 6 5 3 4 2 
400 6 5 5 5 6 4 3 4 6 2 2 3 6 5 4 3 4 1 
400 6 5 5 5 6 4 3 4 6 2 2 3 6 5 5 3 1 
395 6 5 5 5 6 4 3 4 6 2 2 3 6 5 4 5 
395 6 5 5 5 6 4 3 4 6 2 2 3 6 5 5 1 
395 6 5 5 5 6 4 3 4 6 2 2 3 6 5 5 1 
395 6 5 5 5 6 4 3 4 6 2 2 3 6 5 5 4 
395 6 5 5 5 6 4 3 4 6 2 2 3 6 5 5 1 
395 6 5 5 5 6 4 3 4 6 2 2 3 6 5 5 4 
395 6 5 5 5 6 4 3 4 6 2 2 3 6 5 5 1 
395 6 5 5 5 6 4 3 4 6 2 2 3 6 5 5 1 
395 6 5 5 5 6 4 3 4 6 2 2 3 6 5 4 2 
395 6 5 5 5 6 4 3 4 6 5 3 2 5 6 1 5 
395 6 5 5 5 6 4 3 4 6 2 2 3 6 5 4 4 4 
395 6 5 5 5 6 4 3 4 6 2 2 3 6 5 5 1 
395 6 5 5 5 5 4 4 5 5 2 4 1 6 6 1 1 
395 6 5 5 5 6 4 3 4 6 2 2 3 6 5 5 4 
385 6 5 5 5 6 4 3 4 6 2 2 3 6 5 6 
385 6 5 5 5 6 4 3 4 6 2 2 3 6 5 6 
385 6 5 5 5 6 4 3 4 6 2 2 3 6 5 6 
375 6 5 5 5 6 4 3 4 6 2 2 3 6 5 1 3 1 
370 6 5 5 5 6 4 3 4 6 2 2 3 6 5 2 
370 6 5 5 5 6 4 3 4 6 2 2 3 6 5 2 
370 6 5 5 5 6 4 3 4 6 2 2 3 6 5 2 
370 6 5 5 5 6 4 3 4 6 2 2 3 6 5 2 
370 6 5 5 5 6 4 3 4 6 2 2 3 6 5 2 
370 6 5 5 5 6 4 3 4 6 2 2 3 6 5 2 
370 6 5 5 5 6 4 3 4 6 2 2 3 6 5 2 
370 6 5 5 5 6 4 3 4 6 2 2 3 6 5 2 
370 6 5 5 5 6 4 3 4 6 2 2 3 6 5 2 
370 6 5 5 5 6 4 3 4 6 2 3 2 6 5 4 1 
315 6 5 5 5 6 4 3 4 6 6 1 1 5 2 
310 6 5 5 5 6 4 3 4 6 2 1 3 3 4 5 2 
305 6 5 5 5 6 4 3 4 6 2 5 3 5 5 
305 6 5 5 5 6 4 3 4 6 2 4 2 5 3 4 
300 6 5 5 5 6 4 3 4 6 1 5 5 5 1 
300 6 5 5 5 6 4 3 4 6 2 1 2 5 4 
295 6 5 5 5 6 4 3 4 6 3 2 6 4 2 
295 6 5 5 5 6 4 3 4 6 5 3 1 4 1 6 
295 6 5 5 5 6 4 3 4 6 3 5 5 6 4 
295 6 5 5 5 6 4 3 4 6 2 3 2 6 1 
290 6 5 5 5 6 4 3 4 6 5 1 2 6 
290 6 5 5 5 6 4 3 4 6 2 5 1 6 
285 6 5 5 5 6 4 3 4 6 3 6 1 4 6 
285 6 5 5 5 6 4 3 4 6 2 3 6 6 
280 6 5 5 5 6 4 3 4 6 2 4 1 3 1 5 
280 6 5 5 5 6 4 3 4 6 2 2 3 4 5 
280 6 5 5 5 6 4 3 4 6 2 3 1 4 4 5 
280 6 5 5 5 6 4 3 4 6 2 6 6 
280 6 5 5 5 6 4 3 4 6 2 3 1 2 5 
280 6 5 5 5 6 4 3 4 6 2 2 1 3 2 
280 6 5 5 5 6 4 3 4 6 2 6 6 
275 6 5 5 5 6 4 3 4 6 2 2 3 3 6 
275 6 5 5 5 6 4 3 4 6 2 1 5 2 
275 6 5 5 5 6 4 3 4 6 2 5 1 2 
275 6 5 5 5 6 4 3 4 6 2 6 3 5 3 
275 6 5 5 5 6 4 3 4 6 5 4 1 4 2 
270 6 5 5 5 6 4 3 4 6 5 1 4 3 6 
265 6 5 5 5 6 4 3 4 6 2 6 2 
265 6 5 5 5 6 4 3 4 6 2 6 2 
265 6 5 5 5 6 4 3 4 6 2 6 5 
265 6 5 5 5 6 4 3 4 6 2 5 6 
265 6 5 5 5 6 4 3 4 6 6 2 2 
255 6 5 5 5 6 4 3 4 6 2 1 4 3 2 
255 6 5 5 5 6 4 3 4 6 2 3 4 5 4 
255 6 5 5 5 6 4 3 4 6 3 1 4 5 5 
255 6 5 5 5 6 4 3 4 6 5 3 5 1 4 
250 6 5 5 5 6 4 3 4 6 2 2 2 
250 6 5 5 5 6 4 3 4 6 2 2 2 
250 6 5 5 5 6 4 3 4 6 2 1 2 1 
250 6 5 5 5 6 4 3 4 6 2 5 4 4 
250 6 5 5 5 6 4 3 4 6 2 1 1 4 4 
250 6 5 5 5 6 4 3 4 6 2 1 4 4 1 
250 6 5 5 5 6 4 3 4 6 4 2 5 4 
250 6 5 5 5 6 4 3 4 6 2 4 4 5 
250 6 5 5 5 6 4 3 4 6 2 1 2 1 
245 6 5 5 5 6 4 3 4 6 2 6 3 1 
245 6 5 5 5 6 4 3 4 6 4 2 3 6 
245 6 5 5 5 6 4 3 4 6 2 6 3 1 
240 6 5 5 5 6 4 3 4 6 2 6 1 
240 6 5 5 5 6 4 3 4 6 2 4 6 
240 6 5 5 5 6 4 3 4 6 4 5 6 
240 6 5 5 5 6 4 3 4 6 5 4 6 
240 6 5 5 5 6 4 3 4 6 2 4 6 
240 6 5 5 5 6 4 3 4 6 2 6 4 
240 6 5 5 5 6 4 3 4 6 2 6 4 
235 6 5 5 5 6 4 3 4 6 2 3 4 2 3 
235 6 5 5 5 6 4 3 4 6 2 4 3 5 3 
230 6 5 5 5 6 4 3 4 6 6 6 
225 6 5 5 5 6 4 3 4 6 2 6 3 3 
225 6 5 5 5 6 4 3 4 6 6 3 3 2 
