-20 4 5 5 5 5 3 5 1 4 3 6 6 4 1 
-20 4 5 5 5 5 3 5 1 4 3 6 6 4 
-20 4 5 5 5 5 3 5 1 4 3 6 6 4 1 
-20 4 5 5 5 5 3 5 1 4 3 6 6 4 
-20 4 5 5 5 5 3 5 1 4 3 6 6 4 1 2 
-20 4 5 5 5 5 3 5 1 4 3 6 6 4 
-20 4 5 5 5 5 3 5 1 4 3 6 6 4 1 2 
-20 4 5 5 5 5 3 5 1 4 3 6 6 4 1 2 
-20 4 5 5 5 5 3 5 1 4 3 6 6 4 1 2 
-20 4 5 5 5 5 3 5 1 4 3 6 6 4 1 
-20 4 5 5 5 5 3 5 1 4 3 6 6 4 1 
-20 4 5 5 5 5 3 5 1 4 3 6 6 4 1 
-20 4 5 5 5 5 3 5 1 4 3 6 6 4 1 
-20 4 5 5 5 5 3 5 1 4 3 6 6 4 1 
-20 4 5 5 5 5 3 5 1 4 3 6 6 4 1 2 
-20 4 5 5 5 5 3 5 1 4 3 6 6 4 1 
-20 4 5 5 5 5 3 5 1 4 3 6 6 4 1 2 
-20 4 5 5 5 5 3 5 1 4 3 6 6 4 1 2 
-20 4 5 5 5 5 3 5 1 4 3 6 6 4 1 2 
-20 4 5 5 5 5 3 5 1 4 3 6 6 4 1 2 
-20 4 5 5 5 5 3 5 1 4 3 6 6 4 
-20 4 5 5 5 5 3 5 1 4 3 6 6 4 1 
-20 4 5 5 5 5 3 5 1 4 3 6 6 4 
-20 4 5 5 5 5 3 5 1 4 3 6 6 4 
-20 4 5 5 5 5 3 5 1 4 3 6 6 4 
-20 4 5 5 5 5 3 5 1 4 3 6 6 4 2 4 
-20 4 5 5 5 5 3 5 1 4 3 6 6 4 2 
-20 4 5 5 5 5 3 5 1 4 3 6 6 4 
-20 4 5 5 5 5 3 5 1 4 3 6 6 4 
-20 4 5 5 5 5 3 5 1 4 3 6 6 4 2 
-20 4 5 5 5 5 3 5 1 4 3 6 6 4 2 
-20 4 5 5 5 5 3 5 1 4 3 6 6 4 2 
-20 4 5 5 5 5 3 5 1 4 3 6 6 
-20 4 5 5 5 5 3 5 1 4 3 6 6 4 2 
-20 4 5 5 5 5 3 5 1 4 3 6 6 4 2 3 
-20 4 5 5 5 5 3 5 1 4 3 6 6 4 2 3 2 
-20 4 5 5 5 5 3 5 1 4 3 6 6 4 
-20 4 5 5 5 5 3 5 1 4 3 6 6 4 2 
-20 4 5 5 5 5 3 5 1 4 3 6 6 
-20 4 5 5 5 5 3 5 1 4 3 6 6 4 
-20 4 5 5 5 5 3 5 1 4 3 6 6 
-20 4 5 5 5 5 3 5 1 4 3 6 6 4 
-20 4 5 5 5 5 3 5 1 4 3 6 6 4 4 
-20 4 5 5 5 5 3 5 1 4 3 6 6 4 2 
-20 4 5 5 5 5 3 5 1 4 3 6 6 4 2 
-20 4 5 5 5 5 3 5 1 4 3 6 6 4 2 3 
-20 4 5 5 5 5 3 5 1 4 3 6 6 4 
-20 4 5 5 5 5 3 5 1 4 3 6 6 4 2 3 3 
