615 5 6 5 5 5 5 4 3 2 1 6 1 4 2 5 5 6 5 5 6 
545 5 6 5 5 5 5 4 3 2 1 6 1 5 4 6 3 5 6 1 2 
525 5 6 5 5 5 5 4 3 2 1 6 1 4 2 5 4 6 5 5 
525 5 6 5 5 5 5 4 3 2 1 6 1 4 2 6 3 6 5 5 3 
505 5 6 5 5 5 5 4 3 2 1 5 4 6 6 5 6 6 
500 5 6 5 5 5 5 4 3 2 1 6 1 4 2 6 3 6 3 4 5 
490 5 6 5 5 5 5 4 3 2 1 6 1 4 2 6 3 6 6 3 
490 5 6 5 5 5 5 4 3 2 1 6 1 4 2 6 3 6 6 3 
490 5 6 5 5 5 5 4 3 2 1 6 1 4 2 6 3 6 6 3 
480 5 6 5 5 5 5 4 3 2 1 6 1 5 1 3 5 6 1 2 
470 5 6 5 5 5 5 4 3 2 1 6 1 4 2 6 3 6 2 
470 5 6 5 5 5 5 4 3 2 1 6 1 4 2 3 5 1 5 3 5 5 
460 5 6 5 5 5 5 4 3 2 1 6 1 4 2 6 3 4 4 3 2 
455 5 6 5 5 5 5 4 3 2 1 6 1 5 4 5 3 5 6 
455 5 6 5 5 5 5 4 3 2 1 6 1 4 2 5 3 5 6 
455 5 6 5 5 5 5 4 3 2 1 6 1 4 2 6 3 4 5 4 
455 5 6 5 5 5 5 4 3 2 1 6 1 4 2 3 5 6 2 
445 5 6 5 5 5 5 4 3 2 1 6 1 4 2 6 3 6 4 
435 5 6 5 5 5 5 4 3 2 1 6 1 2 1 5 5 2 
420 5 6 5 5 5 5 4 3 2 1 6 1 4 2 6 3 6 
420 5 6 5 5 5 5 4 3 2 1 6 1 4 2 6 3 6 
420 5 6 5 5 5 5 4 3 2 1 6 1 4 2 6 3 6 
420 5 6 5 5 5 5 4 3 2 1 6 1 4 2 6 3 6 
420 5 6 5 5 5 5 4 3 2 1 6 1 4 2 6 3 6 
420 5 6 5 5 5 5 4 3 2 1 6 1 4 2 6 3 6 6 
420 5 6 5 5 5 5 4 3 2 1 6 1 4 2 6 3 6 6 
420 5 6 5 5 5 5 4 3 2 1 6 1 4 2 6 3 6 6 
420 5 6 5 5 5 5 4 3 2 1 6 1 4 2 6 3 6 
420 5 6 5 5 5 5 4 3 2 1 6 1 4 2 6 3 6 
420 5 6 5 5 5 5 4 3 2 1 6 1 4 2 6 3 6 
420 5 6 5 5 5 5 4 3 2 1 6 1 4 2 6 3 6 
420 5 6 5 5 5 5 4 3 2 1 6 1 4 2 6 3 6 
420 5 6 5 5 5 5 4 3 2 1 6 1 4 2 6 3 6 6 
420 5 6 5 5 5 5 4 3 2 1 6 1 4 2 6 3 6 6 
420 5 6 5 5 5 5 4 3 2 1 6 1 4 2 6 3 6 6 
420 5 6 5 5 5 5 4 3 2 1 6 1 4 2 6 3 6 
420 5 6 5 5 5 5 4 3 2 1 6 1 4 2 6 3 6 6 
420 5 6 5 5 5 5 4 3 2 1 6 1 4 2 6 3 6 6 
420 5 6 5 5 5 5 4 3 2 1 6 1 4 2 6 3 6 
420 5 6 5 5 5 5 4 3 2 1 6 1 4 2 6 3 6 
420 5 6 5 5 5 5 4 3 2 1 6 1 4 2 6 3 6 
420 5 6 5 5 5 5 4 3 2 1 6 1 4 2 6 3 6 
420 5 6 5 5 5 5 4 3 2 1 6 1 4 2 6 3 6 6 
420 5 6 5 5 5 5 4 3 2 1 6 1 4 2 6 3 6 6 
420 5 6 5 5 5 5 4 3 2 1 6 1 4 2 6 3 6 6 
420 5 6 5 5 5 5 4 3 2 1 6 1 4 2 6 3 6 6 
420 5 6 5 5 5 5 4 3 2 1 6 1 4 2 6 3 6 6 
420 5 6 5 5 5 5 4 3 2 1 6 1 4 2 6 3 6 
420 5 6 5 5 5 5 4 3 2 1 6 1 4 2 6 3 6 
420 5 6 5 5 5 5 4 3 2 1 6 1 4 2 6 3 6 
420 5 6 5 5 5 5 4 3 2 1 6 1 4 2 6 3 6 6 
420 5 6 5 5 5 5 4 3 2 1 6 1 4 2 6 3 6 6 
420 5 6 5 5 5 5 4 3 2 1 6 1 4 2 6 3 6 
420 5 6 5 5 5 5 4 3 2 1 6 1 4 2 6 3 6 6 
420 5 6 5 5 5 5 4 3 2 1 6 1 4 2 6 3 6 
420 5 6 5 5 5 5 4 3 2 1 6 1 4 2 6 3 6 6 
420 5 6 5 5 5 5 4 3 2 1 6 1 4 2 6 3 6 6 
420 5 6 5 5 5 5 4 3 2 1 6 1 4 2 6 3 6 
420 5 6 5 5 5 5 4 3 2 1 6 1 4 2 6 3 6 
420 5 6 5 5 5 5 4 3 2 1 6 1 4 2 6 3 6 6 
420 5 6 5 5 5 5 4 3 2 1 6 1 4 2 6 3 6 6 
420 5 6 5 5 5 5 4 3 2 1 6 1 4 2 6 3 6 
410 5 6 5 5 5 5 4 3 2 1 6 1 4 2 5 5 1 
405 5 6 5 5 5 5 4 3 2 1 6 1 4 2 6 3 2 
405 5 6 5 5 5 5 4 3 2 1 6 1 4 2 6 3 2 
405 5 6 5 5 5 5 4 3 2 1 6 1 4 2 6 3 2 
405 5 6 5 5 5 5 4 3 2 1 6 1 4 2 6 3 2 
405 5 6 5 5 5 5 4 3 2 1 6 1 4 2 6 3 2 
400 5 6 5 5 5 5 4 3 2 1 6 1 4 2 6 2 
400 5 6 5 5 5 5 4 3 2 1 6 1 4 2 6 5 
400 5 6 5 5 5 5 4 3 2 1 6 1 5 6 4 5 
390 5 6 5 5 5 5 4 3 2 1 6 4 5 6 6 
385 5 6 5 5 5 5 4 3 2 1 2 5 2 6 2 
385 5 6 5 5 5 5 4 3 2 1 6 1 4 2 6 3 3 4 
385 5 6 5 5 5 5 4 3 2 1 6 1 4 2 6 3 4 3 
385 5 6 5 5 5 5 4 3 2 1 6 1 4 2 5 4 1 
380 5 6 5 5 5 5 4 3 2 1 6 1 4 2 6 3 1 
380 5 6 5 5 5 5 4 3 2 1 6 4 2 6 3 2 
380 5 6 5 5 5 5 4 3 2 1 6 1 4 2 6 3 1 
375 5 6 5 5 5 5 4 3 2 1 6 3 3 6 5 6 
375 5 6 5 5 5 5 4 3 2 1 6 1 4 2 6 1 
360 5 6 5 5 5 5 4 3 2 1 6 1 4 2 6 3 3 
360 5 6 5 5 5 5 4 3 2 1 6 1 4 2 6 3 3 
360 5 6 5 5 5 5 4 3 2 1 6 1 4 2 6 3 3 
360 5 6 5 5 5 5 4 3 2 1 6 1 4 2 6 3 3 
360 5 6 5 5 5 5 4 3 2 1 6 1 4 2 6 3 3 
335 5 6 5 5 5 5 4 3 2 1 6 2 1 4 2 
335 5 6 5 5 5 5 4 3 2 1 6 1 4 2 2 
335 5 6 5 5 5 5 4 3 2 1 6 1 4 2 2 
325 5 6 5 5 5 5 4 3 2 1 6 1 4 1 6 
325 5 6 5 5 5 5 4 3 2 1 6 1 4 4 6 
325 5 6 5 5 5 5 4 3 2 1 4 4 6 1 6 
315 5 6 5 5 5 5 4 3 2 1 6 3 2 2 1 
310 5 6 5 5 5 5 4 3 2 1 6 1 2 5 
310 5 6 5 5 5 5 4 3 2 1 6 2 1 4 1 
310 5 6 5 5 5 5 4 3 2 1 6 1 4 1 5 
310 5 6 5 5 5 5 4 3 2 1 4 5 1 1 6 
310 5 6 5 5 5 5 4 3 2 1 6 1 4 2 1 
310 5 6 5 5 5 5 4 3 2 1 6 3 3 2 6 
310 5 6 5 5 5 5 4 3 2 1 6 2 1 2 
310 5 6 5 5 5 5 4 3 2 1 6 1 5 4 1 
310 5 6 5 5 5 5 4 3 2 1 6 1 2 2 
305 5 6 5 5 5 5 4 3 2 1 6 2 3 6 
300 5 6 5 5 5 5 4 3 2 1 6 2 6 
300 5 6 5 5 5 5 4 3 2 1 6 1 4 6 
300 5 6 5 5 5 5 4 3 2 1 6 5 6 
300 5 6 5 5 5 5 4 3 2 1 6 6 2 
295 5 6 5 5 5 5 4 3 2 1 6 3 3 1 4 5 
290 5 6 5 5 5 5 4 3 2 1 6 1 4 3 2 
290 5 6 5 5 5 5 4 3 2 1 6 1 3 1 2 
290 5 6 5 5 5 5 4 3 2 1 6 1 4 3 2 
290 5 6 5 5 5 5 4 3 2 1 6 1 1 3 5 
285 5 6 5 5 5 5 4 3 2 1 6 5 5 
285 5 6 5 5 5 5 4 3 2 1 6 1 4 5 
285 5 6 5 5 5 5 4 3 2 1 6 1 4 5 
285 5 6 5 5 5 5 4 3 2 1 6 1 4 1 4 
280 5 6 5 5 5 5 4 3 2 1 4 1 3 4 3 3 3 6 
280 5 6 5 5 5 5 4 3 2 1 6 4 3 6 
275 5 6 5 5 5 5 4 3 2 1 6 1 6 
275 5 6 5 5 5 5 4 3 2 1 6 1 6 
275 5 6 5 5 5 5 4 3 2 1 5 1 1 1 1 3 
265 5 6 5 5 5 5 4 3 2 1 6 1 3 5 
265 5 6 5 5 5 5 4 3 2 1 2 1 6 3 
265 5 6 5 5 5 5 4 3 2 1 6 1 3 2 
265 5 6 5 5 5 5 4 3 2 1 6 1 3 2 
265 5 6 5 5 5 5 4 3 2 1 6 1 5 3 
255 5 6 5 5 5 5 4 3 2 1 6 6 3 
255 5 6 5 5 5 5 4 3 2 1 6 6 3 
