125 4 2 5 5 5 5 5 5 5 
115 4 2 5 5 5 5 5 4 6 
115 4 2 5 5 5 5 5 1 6 
115 4 2 5 5 5 6 4 2 2 
115 4 2 5 5 5 6 4 5 2 
105 4 2 5 5 5 6 5 6 
100 4 2 5 5 5 5 5 1 2 
100 4 2 5 5 5 5 5 4 5 
100 4 2 5 5 5 5 5 4 2 
100 4 2 5 5 5 5 5 4 5 
100 4 2 5 5 5 5 5 2 4 
100 4 2 5 5 5 5 5 4 2 
100 4 2 5 5 5 5 5 4 5 
100 4 2 5 5 5 5 5 1 2 
100 4 2 5 5 5 5 5 4 2 
90 4 2 5 5 5 5 5 6 
90 4 2 5 5 5 6 2 2 
90 4 2 5 5 5 6 4 1 2 
90 4 2 5 5 5 6 4 2 4 
80 4 2 5 5 5 5 5 3 5 4 
80 4 2 5 5 5 6 4 6 
80 4 2 5 5 5 6 4 6 
80 4 2 5 5 5 6 6 4 
80 4 2 5 5 5 6 4 6 
80 4 2 5 5 5 6 4 6 
75 4 2 5 5 5 5 5 4 4 6 
75 4 2 5 5 5 5 5 4 4 3 
75 4 2 5 5 5 5 5 4 4 6 
75 4 2 5 5 5 5 5 4 4 4 
75 4 2 5 5 5 5 5 4 1 4 
75 4 2 5 5 5 5 5 1 4 
75 4 2 5 5 5 5 5 4 1 6 
75 4 2 5 5 5 5 5 4 4 4 
75 4 2 5 5 5 5 5 4 4 1 
75 4 2 5 5 5 5 5 4 1 4 
75 4 2 5 5 5 5 5 4 4 6 
75 4 2 5 5 5 5 5 4 4 5 
75 4 2 5 5 5 5 5 4 1 2 
70 4 2 5 5 5 6 4 3 2 3 
70 4 2 5 5 5 6 4 3 5 1 
65 4 2 5 5 5 6 2 1 
60 4 2 5 5 5 6 6 3 
45 4 2 5 5 5 6 4 1 3 
45 4 2 5 5 5 6 4 4 3 5 
45 4 2 5 5 5 6 4 4 3 2 
25 4 2 5 5 5 6 4 3 3 4 
-25 4 2 5 5 5 2 
-25 4 2 5 5 5 2 
