630 5 6 5 5 5 5 4 3 2 1 6 1 4 2 5 5 6 5 6 6 
600 5 6 5 5 5 5 4 3 2 1 6 1 4 2 6 3 6 5 5 2 1 3 
590 5 6 5 5 5 5 4 3 2 1 6 1 4 2 5 5 6 5 6 4 
590 5 6 5 5 5 5 4 3 2 1 6 1 4 2 5 5 6 5 6 4 
590 5 6 5 5 5 5 4 3 2 1 6 1 4 2 6 3 4 4 6 3 6 5 
550 5 6 5 5 5 5 4 3 2 1 6 1 4 2 5 5 6 5 5 
550 5 6 5 5 5 5 4 3 2 1 6 1 4 2 5 5 6 5 5 
550 5 6 5 5 5 5 4 3 2 1 6 1 4 2 5 5 6 5 5 
550 5 6 5 5 5 5 4 3 2 1 6 1 4 2 5 5 6 5 5 
550 5 6 5 5 5 5 4 3 2 1 6 1 4 2 5 5 6 5 5 
550 5 6 5 5 5 5 4 3 2 1 6 1 4 2 5 5 6 5 5 
550 5 6 5 5 5 5 4 3 2 1 6 1 4 2 5 5 6 5 5 
550 5 6 5 5 5 5 4 3 2 1 6 1 4 2 5 5 6 5 5 
550 5 6 5 5 5 5 4 3 2 1 6 1 4 2 5 5 6 5 2 
550 5 6 5 5 5 5 4 3 2 1 6 1 4 2 5 5 6 5 5 
550 5 6 5 5 5 5 4 3 2 1 6 1 4 2 5 5 6 5 5 
550 5 6 5 5 5 5 4 3 2 1 6 1 4 2 5 5 6 5 5 
550 5 6 5 5 5 5 4 3 2 1 6 1 4 2 5 5 6 5 5 
550 5 6 5 5 5 5 4 3 2 1 6 1 4 2 5 5 6 5 5 
550 5 6 5 5 5 5 4 3 2 1 6 1 4 2 5 5 6 5 5 
550 5 6 5 5 5 5 4 3 2 1 6 1 4 2 5 5 6 5 5 
550 5 6 5 5 5 5 4 3 2 1 6 1 4 2 5 5 6 5 5 
550 5 6 5 5 5 5 4 3 2 1 6 1 4 2 5 5 6 5 2 
550 5 6 5 5 5 5 4 3 2 1 6 1 4 2 5 5 6 5 5 
550 5 6 5 5 5 5 4 3 2 1 6 1 4 2 5 5 6 5 5 
550 5 6 5 5 5 5 4 3 2 1 6 1 4 2 5 5 6 5 5 
550 5 6 5 5 5 5 4 3 2 1 6 1 4 2 5 5 6 5 5 
550 5 6 5 5 5 5 4 3 2 1 6 1 4 2 5 5 6 5 5 
550 5 6 5 5 5 5 4 3 2 1 6 1 4 2 5 5 6 5 2 
550 5 6 5 5 5 5 4 3 2 1 6 1 4 2 5 5 6 5 5 
550 5 6 5 5 5 5 4 3 2 1 6 1 4 2 5 5 6 5 5 
550 5 6 5 5 5 5 4 3 2 1 6 1 4 2 5 5 6 5 2 
550 5 6 5 5 5 5 4 3 2 1 6 1 4 2 5 5 6 5 5 
550 5 6 5 5 5 5 4 3 2 1 6 1 4 2 5 5 6 5 5 
550 5 6 5 5 5 5 4 3 2 1 6 1 4 2 5 5 6 5 5 
550 5 6 5 5 5 5 4 3 2 1 6 1 4 2 5 5 6 5 5 
550 5 6 5 5 5 5 4 3 2 1 6 1 4 2 5 5 6 5 2 
550 5 6 5 5 5 5 4 3 2 1 6 1 4 2 5 5 6 5 5 
550 5 6 5 5 5 5 4 3 2 1 6 1 4 2 5 4 6 5 5 4 
540 5 6 5 5 5 5 4 3 2 1 6 1 4 2 5 5 6 4 6 
540 5 6 5 5 5 5 4 3 2 1 6 1 4 2 5 5 6 4 6 
535 5 6 5 5 5 5 4 3 2 1 6 1 4 2 6 3 6 4 3 3 5 3 1 4 
530 5 6 5 5 5 5 4 3 2 1 6 1 4 2 5 5 6 3 1 5 
525 5 6 5 5 5 5 4 3 2 1 6 1 4 2 5 5 6 5 1 
525 5 6 5 5 5 5 4 3 2 1 6 1 4 2 5 5 6 5 1 
525 5 6 5 5 5 5 4 3 2 1 6 1 4 2 5 5 6 4 4 1 
525 5 6 5 5 5 5 4 3 2 1 6 1 4 2 5 5 6 5 1 
525 5 6 5 5 5 5 4 3 2 1 6 1 4 2 5 5 6 5 1 
525 5 6 5 5 5 5 4 3 2 1 6 1 4 2 5 5 6 5 1 
525 5 6 5 5 5 5 4 3 2 1 6 1 4 2 6 3 6 3 5 5 
520 5 6 5 5 5 5 4 3 2 1 6 1 4 2 6 3 3 3 4 3 4 5 2 
520 5 6 5 5 5 5 4 3 2 1 6 1 4 2 6 3 6 3 3 1 6 
515 5 6 5 5 5 5 4 3 2 1 6 1 4 2 5 5 6 6 
515 5 6 5 5 5 5 4 3 2 1 6 1 4 2 5 5 6 6 
515 5 6 5 5 5 5 4 3 2 1 6 1 4 2 5 5 6 6 
515 5 6 5 5 5 5 4 3 2 1 6 1 4 2 5 5 6 6 
515 5 6 5 5 5 5 4 3 2 1 6 1 4 2 5 5 6 6 
510 5 6 5 5 5 5 4 3 2 1 6 1 4 2 5 5 6 3 3 5 
510 5 6 5 5 5 5 4 3 2 1 6 1 4 2 5 5 6 3 3 1 4 
505 5 6 5 5 5 5 4 3 2 1 6 1 4 2 6 6 6 1 
505 5 6 5 5 5 5 4 3 2 1 6 1 4 2 5 5 6 3 5 
505 5 6 5 5 5 5 4 3 2 1 6 1 4 2 5 5 6 5 3 
505 5 6 5 5 5 5 4 3 2 1 6 1 4 2 5 5 6 5 3 
505 5 6 5 5 5 5 4 3 2 1 6 1 4 2 5 5 6 5 3 
505 5 6 5 5 5 5 4 3 2 1 6 1 4 2 5 5 6 5 3 
505 5 6 5 5 5 5 4 3 2 1 6 1 4 2 5 5 6 4 3 1 
505 5 6 5 5 5 5 4 3 2 1 6 1 4 2 5 5 6 5 3 
495 5 6 5 5 5 5 4 3 2 1 6 1 4 2 6 3 6 4 5 
495 5 6 5 5 5 5 4 3 2 1 6 1 4 2 6 6 3 4 1 4 
490 5 6 5 5 5 5 4 3 2 1 6 1 4 2 6 3 6 3 6 
490 5 6 5 5 5 5 4 3 2 1 6 1 4 2 6 3 6 3 6 
485 5 6 5 5 5 5 4 3 2 1 6 1 4 2 6 3 6 6 
485 5 6 5 5 5 5 4 3 2 1 6 1 4 2 6 3 6 6 
485 5 6 5 5 5 5 4 3 2 1 6 1 4 2 6 3 6 6 
480 5 6 5 5 5 5 4 3 2 1 6 1 4 2 6 3 4 5 2 
480 5 6 5 5 5 5 4 3 2 1 6 1 4 2 6 3 6 3 4 3 4 
475 5 6 5 5 5 5 4 3 2 1 6 1 4 2 5 5 6 1 
475 5 6 5 5 5 5 4 3 2 1 6 1 4 2 5 5 6 1 
475 5 6 5 5 5 5 4 3 2 1 6 1 4 2 5 5 6 1 
475 5 6 5 5 5 5 4 3 2 1 6 1 4 2 6 3 6 3 2 
475 5 6 5 5 5 5 4 3 2 1 6 1 4 2 5 5 6 1 
475 5 6 5 5 5 5 4 3 2 1 6 1 4 2 5 5 6 1 
475 5 6 5 5 5 5 4 3 2 1 6 1 4 2 5 5 6 1 
470 5 6 5 5 5 5 4 3 2 1 6 1 4 2 5 5 3 5 3 1 
465 5 6 5 5 5 5 4 3 2 1 6 1 4 2 6 6 2 
460 5 6 5 5 5 5 4 3 2 1 6 1 4 2 6 3 3 5 2 
445 5 6 5 5 5 5 4 3 2 1 6 1 4 2 6 3 6 1 
445 5 6 5 5 5 5 4 3 2 1 6 1 4 2 6 3 6 1 
430 5 6 5 5 5 5 4 3 2 1 6 1 4 2 6 3 5 1 
430 5 6 5 5 5 5 4 3 2 1 6 1 4 2 6 3 4 2 
430 5 6 5 5 5 5 4 3 2 1 6 1 4 2 5 3 6 1 
415 5 6 5 5 5 5 4 3 2 1 6 1 4 2 5 3 5 1 
410 5 6 5 5 5 5 4 3 2 1 6 1 4 2 6 3 3 2 
410 5 6 5 5 5 5 4 3 2 1 6 1 4 2 6 3 3 2 
405 5 6 5 5 5 5 4 3 2 1 6 1 4 2 6 3 4 1 
405 5 6 5 5 5 5 4 3 2 1 6 1 4 2 6 3 2 
400 5 6 5 5 5 5 4 3 2 1 6 1 4 2 6 5 
400 5 6 5 5 5 5 4 3 2 1 6 1 4 2 6 5 
400 5 6 5 5 5 5 4 3 2 1 6 1 4 2 6 5 
400 5 6 5 5 5 5 4 3 2 1 6 1 4 2 6 2 
400 5 6 5 5 5 5 4 3 2 1 6 1 4 2 6 2 
400 5 6 5 5 5 5 4 3 2 1 6 1 4 2 6 5 
400 5 6 5 5 5 5 4 3 2 1 6 1 4 2 6 4 4 
380 5 6 5 5 5 5 4 3 2 1 6 1 4 2 6 3 1 
380 5 6 5 5 5 5 4 3 2 1 6 1 4 2 6 3 1 
375 5 6 5 5 5 5 4 3 2 1 6 1 4 2 6 1 
375 5 6 5 5 5 5 4 3 2 1 6 1 4 2 6 1 
375 5 6 5 5 5 5 4 3 2 1 6 1 4 2 6 1 
375 5 6 5 5 5 5 4 3 2 1 6 1 4 2 6 1 
375 5 6 5 5 5 5 4 3 2 1 6 1 4 2 6 1 
375 5 6 5 5 5 5 4 3 2 1 6 1 4 2 6 1 
370 5 6 5 5 5 5 4 3 2 1 6 1 4 2 6 3 3 3 3 
335 5 6 5 5 5 5 4 3 2 1 6 1 4 2 2 
335 5 6 5 5 5 5 4 3 2 1 6 1 4 2 2 
310 5 6 5 5 5 5 4 3 2 1 6 1 4 2 4 
310 5 6 5 5 5 5 4 3 2 1 6 1 4 2 4 
310 5 6 5 5 5 5 4 3 2 1 6 1 4 2 4 
310 5 6 5 5 5 5 4 3 2 1 6 1 4 2 4 
310 5 6 5 5 5 5 4 3 2 1 6 1 4 2 1 
310 5 6 5 5 5 5 4 3 2 1 6 1 4 2 4 
290 5 6 5 5 5 5 4 3 2 1 6 1 4 2 3 
290 5 6 5 5 5 5 4 3 2 1 6 1 4 2 3 5 1 5 
290 5 6 5 5 5 5 4 3 2 1 6 1 4 2 3 5 6 
260 5 6 5 5 5 5 4 3 2 1 5 4 6 6 5 
260 5 6 5 5 5 5 4 3 2 1 6 1 2 1 5 
260 5 6 5 5 5 5 4 3 2 1 6 1 5 1 3 5 
260 5 6 5 5 5 5 4 3 2 1 6 1 5 4 6 3 5 
260 5 6 5 5 5 5 4 3 2 1 6 1 5 4 5 3 
