500 2 1 5 5 5 5 5 5 2 6 4 1 3 2 5 3 5 4 1 2 
475 2 1 5 5 5 5 5 5 2 6 4 1 3 2 3 5 3 3 6 5 2 
450 2 1 5 5 5 5 5 5 2 6 4 1 3 2 6 6 1 
445 2 1 5 5 5 5 5 5 2 6 4 1 3 2 3 6 4 4 3 1 
420 2 1 5 5 5 5 5 5 2 6 4 3 4 2 5 1 2 
420 2 1 5 5 5 5 5 5 2 6 4 1 3 2 5 1 2 
410 2 1 5 5 5 5 5 5 2 6 4 1 3 2 6 2 
410 2 1 5 5 5 5 5 5 2 6 4 1 3 2 6 2 
395 2 1 5 5 5 5 5 5 2 6 4 1 3 2 5 2 
395 2 1 5 5 5 5 5 5 2 6 4 1 3 2 5 5 
395 2 1 5 5 5 5 5 5 2 6 4 1 3 2 6 3 3 1 
395 2 1 5 5 5 5 5 5 2 6 4 1 3 2 5 2 
395 2 1 5 5 5 5 5 5 2 6 4 1 3 2 5 1 4 
385 2 1 5 5 5 5 5 5 2 6 4 1 3 2 6 4 
385 2 1 5 5 5 5 5 5 2 6 4 1 3 2 6 4 
385 2 1 5 5 5 5 5 5 2 6 4 1 3 2 6 4 
385 2 1 5 5 5 5 5 5 2 6 4 1 3 2 6 4 
385 2 1 5 5 5 5 5 5 2 6 4 2 3 6 4 1 
350 2 1 5 5 5 5 5 5 2 6 4 1 3 2 3 2 
345 2 1 5 5 5 5 5 5 2 6 4 1 3 2 2 
345 2 1 5 5 5 5 5 5 2 6 4 3 5 1 2 
345 2 1 5 5 5 5 5 5 2 6 4 1 3 2 2 
345 2 1 5 5 5 5 5 5 2 6 4 1 3 2 2 
345 2 1 5 5 5 5 5 5 2 6 4 1 3 2 2 
335 2 1 5 5 5 5 5 5 2 6 4 1 1 3 6 
335 2 1 5 5 5 5 5 5 2 6 4 1 3 4 6 
335 2 1 5 5 5 5 5 5 2 6 4 1 3 4 6 
335 2 1 5 5 5 5 5 5 2 6 4 1 1 3 6 
335 2 1 5 5 5 5 5 5 2 6 4 1 3 4 6 
330 2 1 5 5 5 5 5 5 2 6 4 4 1 6 
330 2 1 5 5 5 5 5 5 2 6 4 1 1 6 
330 2 1 5 5 5 5 5 5 2 6 4 1 1 6 
330 2 1 5 5 5 5 5 5 2 6 4 2 6 
330 2 1 5 5 5 5 5 5 2 6 4 1 4 6 
330 2 1 5 5 5 5 5 5 2 6 4 2 6 
330 2 1 5 5 5 5 5 5 2 6 4 1 1 6 
325 2 1 5 5 5 5 5 5 2 6 4 1 3 2 3 4 
320 2 1 5 5 5 5 5 5 2 6 4 1 3 2 4 
320 2 1 5 5 5 5 5 5 2 6 4 1 3 2 1 
320 2 1 5 5 5 5 5 5 2 6 4 1 3 2 1 
320 2 1 5 5 5 5 5 5 2 6 4 1 3 4 5 
320 2 1 5 5 5 5 5 5 2 6 4 1 3 1 2 
320 2 1 5 5 5 5 5 5 2 6 4 1 3 2 4 
320 2 1 5 5 5 5 5 5 2 6 4 1 3 2 1 
320 2 1 5 5 5 5 5 5 2 6 4 1 3 1 5 
320 2 1 5 5 5 5 5 5 2 6 4 1 3 2 4 
320 2 1 5 5 5 5 5 5 2 6 4 4 3 2 1 
320 2 1 5 5 5 5 5 5 2 6 4 1 4 3 5 
320 2 1 5 5 5 5 5 5 2 6 3 1 5 5 
315 2 1 5 5 5 5 5 5 2 6 4 1 3 3 6 
315 2 1 5 5 5 5 5 5 2 6 4 5 5 
315 2 1 5 5 5 5 5 5 2 6 4 1 4 5 
315 2 1 5 5 5 5 5 5 2 6 4 1 1 2 
315 2 1 5 5 5 5 5 5 2 6 4 2 2 
315 2 1 5 5 5 5 5 5 2 6 4 2 5 
315 2 1 5 5 5 5 5 5 2 6 4 5 5 
315 2 1 5 5 5 5 5 5 2 6 4 2 2 
315 2 1 5 5 5 5 5 5 2 6 4 1 4 2 
315 2 1 5 5 5 5 5 5 2 6 4 1 1 2 
315 2 1 5 5 5 5 5 5 2 6 4 1 4 2 
315 2 1 5 5 5 5 5 5 2 6 4 1 4 5 
315 2 1 5 5 5 5 5 5 2 6 4 1 1 2 
315 2 1 5 5 5 5 5 5 2 6 4 1 1 2 
315 2 1 5 5 5 5 5 5 2 6 4 1 1 2 
315 2 1 5 5 5 5 5 5 2 6 4 5 2 
315 2 1 5 5 5 5 5 5 2 6 4 1 4 2 
310 2 1 5 5 5 5 5 5 2 6 4 1 3 6 
310 2 1 5 5 5 5 5 5 2 6 4 1 3 6 
310 2 1 5 5 5 5 5 5 2 6 4 1 3 6 
310 2 1 5 5 5 5 5 5 2 6 4 1 3 6 
310 2 1 5 5 5 5 5 5 2 6 4 1 3 6 
310 2 1 5 5 5 5 5 5 2 6 4 1 3 6 
310 2 1 5 5 5 5 5 5 2 6 4 3 1 6 
305 2 1 5 5 5 5 5 5 2 6 4 1 6 
305 2 1 5 5 5 5 5 5 2 6 4 1 6 
305 2 1 5 5 5 5 5 5 2 6 4 1 6 
305 2 1 5 5 5 5 5 5 2 6 4 1 6 
305 2 1 5 5 5 5 5 5 2 6 4 1 6 
305 2 1 5 5 5 5 5 5 2 6 5 6 
300 2 1 5 5 5 5 5 5 2 6 4 1 3 3 2 
295 2 1 5 5 5 5 5 5 2 6 4 1 3 4 4 
295 2 1 5 5 5 5 5 5 2 6 4 1 3 5 
295 2 1 5 5 5 5 5 5 2 6 4 1 3 5 
295 2 1 5 5 5 5 5 5 2 6 4 1 3 5 
295 2 1 5 5 5 5 5 5 2 6 4 1 1 3 1 
295 2 1 5 5 5 5 5 5 2 6 4 1 4 3 4 
295 2 1 5 5 5 5 5 5 2 6 4 1 4 3 4 
295 2 1 5 5 5 5 5 5 2 6 4 1 3 1 4 
290 2 1 5 5 5 5 5 5 2 6 4 1 1 1 
290 2 1 5 5 5 5 5 5 2 6 4 1 4 1 
290 2 1 5 5 5 5 5 5 2 6 4 1 5 
290 2 1 5 5 5 5 5 5 2 6 4 1 2 
290 2 1 5 5 5 5 5 5 2 6 4 1 2 
290 2 1 5 5 5 5 5 5 2 6 4 1 5 
290 2 1 5 5 5 5 5 5 2 6 4 1 5 
290 2 1 5 5 5 5 5 5 2 6 4 1 1 4 
290 2 1 5 5 5 5 5 5 2 6 4 1 1 4 
290 2 1 5 5 5 5 5 5 2 6 4 1 5 
290 2 1 5 5 5 5 5 5 2 6 4 4 5 
290 2 1 5 5 5 5 5 5 2 6 4 1 1 1 
290 2 1 5 5 5 5 5 5 2 6 4 1 4 1 
290 2 1 5 5 5 5 5 5 2 6 4 1 1 1 
290 2 1 5 5 5 5 5 5 2 6 4 1 5 
290 2 1 5 5 5 5 5 5 2 6 4 1 2 
290 2 1 5 5 5 5 5 5 2 6 4 1 5 
290 2 1 5 5 5 5 5 5 2 6 4 1 5 
290 2 1 5 5 5 5 5 5 2 6 1 5 1 
290 2 1 5 5 5 5 5 5 2 6 4 1 2 
290 2 1 5 5 5 5 5 5 2 6 4 1 2 
290 2 1 5 5 5 5 5 5 2 6 4 1 4 1 
290 2 1 5 5 5 5 5 5 2 6 4 1 5 
290 2 1 5 5 5 5 5 5 2 6 2 2 
290 2 1 5 5 5 5 5 5 2 6 4 1 5 
290 2 1 5 5 5 5 5 5 2 6 4 1 4 4 
290 2 1 5 5 5 5 5 5 2 6 4 1 2 
290 2 1 5 5 5 5 5 5 2 6 4 1 1 4 
290 2 1 5 5 5 5 5 5 2 6 4 1 2 
290 2 1 5 5 5 5 5 5 2 6 4 1 2 
290 2 1 5 5 5 5 5 5 2 6 4 1 2 
290 2 1 5 5 5 5 5 5 2 6 4 2 4 
290 2 1 5 5 5 5 5 5 2 6 4 1 2 
280 2 1 5 5 5 5 5 5 2 6 4 6 
280 2 1 5 5 5 5 5 5 2 6 4 6 
280 2 1 5 5 5 5 5 5 2 6 4 6 
275 2 1 5 5 5 5 5 5 2 6 4 1 3 3 4 
-130 6 5 5 3 6 4 1 4 3 2 5 3 1 5 1 4 2 
-130 6 5 5 3 6 4 1 4 3 2 5 3 1 5 1 
-130 6 5 5 3 6 4 1 4 3 2 5 3 1 5 1 
