980 2 4 5 5 5 6 4 4 6 6 5 5 6 3 3 5 5 2 3 2 2 1 1 2 2 5 6 1 4 6 
965 2 4 5 5 5 6 4 4 6 6 5 5 6 3 3 5 5 2 3 2 2 1 1 2 2 5 6 1 4 5 
965 2 4 5 5 5 6 4 4 6 6 5 5 6 3 3 5 5 2 3 2 2 1 1 2 2 5 6 1 4 5 
955 2 4 5 5 5 6 4 4 6 6 5 5 6 3 3 5 5 2 3 2 2 1 1 2 2 5 6 1 6 
955 2 4 5 5 5 6 4 4 6 6 5 5 6 3 3 5 5 2 3 2 2 1 1 2 2 5 6 6 1 
955 2 4 5 5 5 6 4 4 6 6 5 5 6 3 3 5 5 2 3 2 2 1 1 2 2 5 6 1 6 
940 2 4 5 5 5 6 4 4 6 6 5 5 6 3 3 5 5 2 3 2 2 1 1 2 2 5 6 1 5 
940 2 4 5 5 5 6 4 4 6 6 5 5 6 3 3 5 5 2 3 2 2 1 1 2 2 5 6 1 2 
940 2 4 5 5 5 6 4 4 6 6 5 5 6 3 3 5 5 2 3 2 2 1 1 2 2 5 6 1 2 
940 2 4 5 5 5 6 4 4 6 6 5 5 6 3 3 5 5 2 3 2 2 1 1 2 2 5 6 1 4 1 
940 2 4 5 5 5 6 4 4 6 6 5 5 6 3 3 5 5 2 3 2 2 1 1 2 2 5 6 1 2 
940 2 4 5 5 5 6 4 4 6 6 5 5 6 3 3 5 5 2 3 2 2 1 1 2 2 5 6 1 5 
940 2 4 5 5 5 6 4 4 6 6 5 5 6 3 3 5 5 2 3 2 2 1 1 2 2 5 6 1 2 
940 2 4 5 5 5 6 4 4 6 6 5 5 6 3 3 5 5 2 3 2 2 1 1 2 2 5 6 1 2 
940 2 4 5 5 5 6 4 4 6 6 5 5 6 3 3 5 5 2 3 2 2 1 1 2 2 5 6 1 5 
940 2 4 5 5 5 6 4 4 6 6 5 5 6 3 3 5 5 2 3 2 2 1 1 2 2 5 6 1 2 
940 2 4 5 5 5 6 4 4 6 6 5 5 6 3 3 5 5 2 3 2 2 1 1 2 2 5 3 6 6 3 
940 2 4 5 5 5 6 4 4 6 6 5 5 6 3 3 5 5 2 3 2 2 1 1 2 2 5 6 1 2 
940 2 4 5 5 5 6 4 4 6 6 5 5 6 3 3 5 5 2 3 2 2 1 1 2 2 5 6 1 4 1 
940 2 4 5 5 5 6 4 4 6 6 5 5 6 3 3 5 5 2 3 2 2 1 1 2 2 5 6 1 5 
940 2 4 5 5 5 6 4 4 6 6 5 5 6 3 3 5 5 2 3 2 2 1 1 2 2 5 6 1 2 
940 2 4 5 5 5 6 4 4 6 6 5 5 6 3 3 5 5 2 3 2 2 1 1 2 2 5 6 1 5 
940 2 4 5 5 5 6 4 4 6 6 5 5 6 3 3 5 5 2 3 2 2 1 1 2 2 5 6 1 4 1 
935 2 4 5 5 5 6 4 4 6 6 5 5 6 3 3 5 5 2 3 2 2 1 1 2 2 4 6 6 3 4 2 
925 2 4 5 5 5 6 4 4 6 6 5 5 6 3 3 5 5 2 3 2 2 1 1 2 2 5 6 3 5 3 
915 2 4 5 5 5 6 4 4 6 6 5 5 6 3 3 5 5 2 3 2 2 1 1 2 2 5 6 2 
915 2 4 5 5 5 6 4 4 6 6 5 5 6 3 3 5 5 2 3 2 2 1 1 2 2 5 6 1 1 
915 2 4 5 5 5 6 4 4 6 6 5 5 6 3 3 5 5 2 3 2 2 1 1 2 2 5 6 1 1 
915 2 4 5 5 5 6 4 4 6 6 5 5 6 3 3 5 5 2 3 2 2 1 1 2 2 5 6 2 
915 2 4 5 5 5 6 4 4 6 6 5 5 6 3 3 5 5 2 3 2 2 1 1 2 2 5 6 1 1 
915 2 4 5 5 5 6 4 4 6 6 5 5 6 3 3 5 5 2 3 2 2 1 1 2 2 5 6 2 
915 2 4 5 5 5 6 4 4 6 6 5 5 6 3 3 5 5 2 3 2 2 1 1 2 2 5 6 1 1 
895 2 4 5 5 5 6 4 4 6 6 5 5 6 3 3 5 5 2 3 2 2 1 1 2 2 5 6 1 3 5 1 4 
895 2 4 5 5 5 6 4 4 6 6 5 5 6 3 3 5 5 2 3 2 2 1 1 2 2 5 6 1 3 5 1 4 
895 2 4 5 5 5 6 4 4 6 6 5 5 6 3 3 5 5 2 3 2 2 1 1 2 2 5 6 1 3 5 1 
895 2 4 5 5 5 6 4 4 6 6 5 5 6 3 3 5 5 2 3 2 2 1 1 2 2 5 6 1 3 5 1 4 
895 2 4 5 5 5 6 4 4 6 6 5 5 6 3 3 5 5 2 3 2 2 1 1 2 2 5 6 1 3 5 1 
895 2 4 5 5 5 6 4 4 6 6 5 5 6 3 3 5 5 2 3 2 2 1 1 2 2 5 6 1 3 5 1 4 5 
895 2 4 5 5 5 6 4 4 6 6 5 5 6 3 3 5 5 2 3 2 2 1 1 2 2 5 6 1 3 5 1 
895 2 4 5 5 5 6 4 4 6 6 5 5 6 3 3 5 5 2 3 2 2 1 1 2 2 5 6 1 3 5 1 4 5 
895 2 4 5 5 5 6 4 4 6 6 5 5 6 3 3 5 5 2 3 2 2 1 1 2 2 5 6 1 3 5 1 4 
895 2 4 5 5 5 6 4 4 6 6 5 5 6 3 3 5 5 2 3 2 2 1 1 2 2 5 6 1 3 5 1 4 
895 2 4 5 5 5 6 4 4 6 6 5 5 6 3 3 5 5 2 3 2 2 1 1 2 2 5 6 1 3 5 1 4 5 
895 2 4 5 5 5 6 4 4 6 6 5 5 6 3 3 5 5 2 3 2 2 1 1 2 2 5 6 1 3 5 1 
895 2 4 5 5 5 6 4 4 6 6 5 5 6 3 3 5 5 2 3 2 2 1 1 2 2 5 6 1 3 5 1 4 
895 2 4 5 5 5 6 4 4 6 6 5 5 6 3 3 5 5 2 3 2 2 1 1 2 2 5 6 1 3 5 1 4 5 
895 2 4 5 5 5 6 4 4 6 6 5 5 6 3 3 5 5 2 3 2 2 1 1 2 2 5 6 1 3 5 1 
895 2 4 5 5 5 6 4 4 6 6 5 5 6 3 3 5 5 2 3 2 2 1 1 2 2 5 6 1 3 5 1 4 
895 2 4 5 5 5 6 4 4 6 6 5 5 6 3 3 5 5 2 3 2 2 1 1 2 2 5 6 1 3 5 1 4 5 
895 2 4 5 5 5 6 4 4 6 6 5 5 6 3 3 5 5 2 3 2 2 1 1 2 2 5 6 1 3 5 1 
895 2 4 5 5 5 6 4 4 6 6 5 5 6 3 3 5 5 2 3 2 2 1 1 2 2 5 6 1 3 5 1 4 5 
895 2 4 5 5 5 6 4 4 6 6 5 5 6 3 3 5 5 2 3 2 2 1 1 2 2 5 6 1 3 5 1 4 5 
895 2 4 5 5 5 6 4 4 6 6 5 5 6 3 3 5 5 2 3 2 2 1 1 2 2 5 6 1 3 5 1 4 
895 2 4 5 5 5 6 4 4 6 6 5 5 6 3 3 5 5 2 3 2 2 1 1 2 2 5 6 1 3 5 1 4 5 
895 2 4 5 5 5 6 4 4 6 6 5 5 6 3 3 5 5 2 3 2 2 1 1 2 2 5 6 1 3 5 1 4 
895 2 4 5 5 5 6 4 4 6 6 5 5 6 3 3 5 5 2 3 2 2 1 1 2 2 5 6 1 3 5 1 4 5 
895 2 4 5 5 5 6 4 4 6 6 5 5 6 3 3 5 5 2 3 2 2 1 1 2 2 5 6 1 3 5 1 4 
895 2 4 5 5 5 6 4 4 6 6 5 5 6 3 3 5 5 2 3 2 2 1 1 2 2 5 6 1 3 5 1 4 
895 2 4 5 5 5 6 4 4 6 6 5 5 6 3 3 5 5 2 3 2 2 1 1 2 2 5 6 1 3 5 1 4 
895 2 4 5 5 5 6 4 4 6 6 5 5 6 3 3 5 5 2 3 2 2 1 1 2 2 5 6 1 3 5 1 
895 2 4 5 5 5 6 4 4 6 6 5 5 6 3 3 5 5 2 3 2 2 1 1 2 2 5 6 1 3 5 1 4 5 
895 2 4 5 5 5 6 4 4 6 6 5 5 6 3 3 5 5 2 3 2 2 1 1 2 2 5 6 1 3 5 1 
895 2 4 5 5 5 6 4 4 6 6 5 5 6 3 3 5 5 2 3 2 2 1 1 2 2 5 6 1 3 5 1 
895 2 4 5 5 5 6 4 4 6 6 5 5 6 3 3 5 5 2 3 2 2 1 1 2 2 5 6 1 3 5 1 4 
895 2 4 5 5 5 6 4 4 6 6 5 5 6 3 3 5 5 2 3 2 2 1 1 2 2 5 6 1 3 5 1 4 
895 2 4 5 5 5 6 4 4 6 6 5 5 6 3 3 5 5 2 3 2 2 1 1 2 2 5 6 1 3 5 1 4 5 
895 2 4 5 5 5 6 4 4 6 6 5 5 6 3 3 5 5 2 3 2 2 1 1 2 2 5 6 1 3 5 1 4 5 
895 2 4 5 5 5 6 4 4 6 6 5 5 6 3 3 5 5 2 3 2 2 1 1 2 2 5 6 1 3 5 1 4 
895 2 4 5 5 5 6 4 4 6 6 5 5 6 3 3 5 5 2 3 2 2 1 1 2 2 5 6 1 3 5 1 4 5 
895 2 4 5 5 5 6 4 4 6 6 5 5 6 3 3 5 5 2 3 2 2 1 1 2 2 5 6 1 3 5 1 4 
895 2 4 5 5 5 6 4 4 6 6 5 5 6 3 3 5 5 2 3 2 2 1 1 2 2 5 6 1 3 5 1 
895 2 4 5 5 5 6 4 4 6 6 5 5 6 3 3 5 5 2 3 2 2 1 1 2 2 5 6 1 3 5 1 4 5 
895 2 4 5 5 5 6 4 4 6 6 5 5 6 3 3 5 5 2 3 2 2 1 1 2 2 5 6 1 3 5 1 
895 2 4 5 5 5 6 4 4 6 6 5 5 6 3 3 5 5 2 3 2 2 1 1 2 2 5 6 1 3 5 1 
895 2 4 5 5 5 6 4 4 6 6 5 5 6 3 3 5 5 2 3 2 2 1 1 2 2 5 6 1 3 5 1 
895 2 4 5 5 5 6 4 4 6 6 5 5 6 3 3 5 5 2 3 2 2 1 1 2 2 5 6 1 3 5 1 4 
895 2 4 5 5 5 6 4 4 6 6 5 5 6 3 3 5 5 2 3 2 2 1 1 2 2 5 6 1 3 5 1 
895 2 4 5 5 5 6 4 4 6 6 5 5 6 3 3 5 5 2 3 2 2 1 1 2 2 5 6 1 3 5 1 
895 2 4 5 5 5 6 4 4 6 6 5 5 6 3 3 5 5 2 3 2 2 1 1 2 2 5 6 1 3 5 1 
895 2 4 5 5 5 6 4 4 6 6 5 5 6 3 3 5 5 2 3 2 2 1 1 2 2 5 6 1 3 5 1 
895 2 4 5 5 5 6 4 4 6 6 5 5 6 3 3 5 5 2 3 2 2 1 1 2 2 5 6 1 3 5 1 
895 2 4 5 5 5 6 4 4 6 6 5 5 6 3 3 5 5 2 3 2 2 1 1 2 2 5 6 1 3 5 1 
895 2 4 5 5 5 6 4 4 6 6 5 5 6 3 3 5 5 2 3 2 2 1 1 2 2 5 6 1 3 5 1 
895 2 4 5 5 5 6 4 4 6 6 5 5 6 3 3 5 5 2 3 2 2 1 1 2 2 5 6 1 3 5 1 
895 2 4 5 5 5 6 4 4 6 6 5 5 6 3 3 5 5 2 3 2 2 1 1 2 2 5 6 1 3 5 1 4 
895 2 4 5 5 5 6 4 4 6 6 5 5 6 3 3 5 5 2 3 2 2 1 1 2 2 5 6 1 3 5 1 4 
895 2 4 5 5 5 6 4 4 6 6 5 5 6 3 3 5 5 2 3 2 2 1 1 2 2 5 6 1 3 5 1 4 
895 2 4 5 5 5 6 4 4 6 6 5 5 6 3 3 5 5 2 3 2 2 1 1 2 2 5 6 1 3 5 1 4 
895 2 4 5 5 5 6 4 4 6 6 5 5 6 3 3 5 5 2 3 2 2 1 1 2 2 5 6 1 3 5 1 4 5 
895 2 4 5 5 5 6 4 4 6 6 5 5 6 3 3 5 5 2 3 2 2 1 1 2 2 5 6 1 3 5 1 4 
895 2 4 5 5 5 6 4 4 6 6 5 5 6 3 3 5 5 2 3 2 2 1 1 2 2 5 6 1 3 5 1 4 
895 2 4 5 5 5 6 4 4 6 6 5 5 6 3 3 5 5 2 3 2 2 1 1 2 2 5 6 1 3 5 1 4 5 
895 2 4 5 5 5 6 4 4 6 6 5 5 6 3 3 5 5 2 3 2 2 1 1 2 2 5 6 1 3 5 1 
895 2 4 5 5 5 6 4 4 6 6 5 5 6 3 3 5 5 2 3 2 2 1 1 2 2 5 6 1 3 5 1 4 
895 2 4 5 5 5 6 4 4 6 6 5 5 6 3 3 5 5 2 3 2 2 1 1 2 2 5 6 1 3 5 1 4 5 
895 2 4 5 5 5 6 4 4 6 6 5 5 6 3 3 5 5 2 3 2 2 1 1 2 2 5 6 1 3 5 1 
895 2 4 5 5 5 6 4 4 6 6 5 5 6 3 3 5 5 2 3 2 2 1 1 2 2 5 6 1 3 5 1 4 5 
895 2 4 5 5 5 6 4 4 6 6 5 5 6 3 3 5 5 2 3 2 2 1 1 2 2 5 6 1 3 5 1 
895 2 4 5 5 5 6 4 4 6 6 5 5 6 3 3 5 5 2 3 2 2 1 1 2 2 5 6 1 3 5 1 4 5 
895 2 4 5 5 5 6 4 4 6 6 5 5 6 3 3 5 5 2 3 2 2 1 1 2 2 5 6 1 3 5 1 4 5 
895 2 4 5 5 5 6 4 4 6 6 5 5 6 3 3 5 5 2 3 2 2 1 1 2 2 5 6 1 3 5 1 
895 2 4 5 5 5 6 4 4 6 6 5 5 6 3 3 5 5 2 3 2 2 1 1 2 2 5 6 1 3 5 1 4 5 
895 2 4 5 5 5 6 4 4 6 6 5 5 6 3 3 5 5 2 3 2 2 1 1 2 2 5 6 1 3 5 1 4 
895 2 4 5 5 5 6 4 4 6 6 5 5 6 3 3 5 5 2 3 2 2 1 1 2 2 5 6 1 3 5 1 4 
895 2 4 5 5 5 6 4 4 6 6 5 5 6 3 3 5 5 2 3 2 2 1 1 2 2 5 6 1 3 5 1 
895 2 4 5 5 5 6 4 4 6 6 5 5 6 3 3 5 5 2 3 2 2 1 1 2 2 5 6 1 3 5 1 
895 2 4 5 5 5 6 4 4 6 6 5 5 6 3 3 5 5 2 3 2 2 1 1 2 2 5 6 1 3 5 1 4 5 
895 2 4 5 5 5 6 4 4 6 6 5 5 6 3 3 5 5 2 3 2 2 1 1 2 2 5 6 1 3 5 1 
895 2 4 5 5 5 6 4 4 6 6 5 5 6 3 3 5 5 2 3 2 2 1 1 2 2 5 6 1 3 5 1 4 5 
895 2 4 5 5 5 6 4 4 6 6 5 5 6 3 3 5 5 2 3 2 2 1 1 2 2 5 6 1 3 5 1 4 
895 2 4 5 5 5 6 4 4 6 6 5 5 6 3 3 5 5 2 3 2 2 1 1 2 2 5 6 1 3 5 1 4 
895 2 4 5 5 5 6 4 4 6 6 5 5 6 3 3 5 5 2 3 2 2 1 1 2 2 5 6 1 3 5 1 
895 2 4 5 5 5 6 4 4 6 6 5 5 6 3 3 5 5 2 3 2 2 1 1 2 2 5 6 1 3 5 1 4 5 
895 2 4 5 5 5 6 4 4 6 6 5 5 6 3 3 5 5 2 3 2 2 1 1 2 2 5 6 1 3 5 1 
895 2 4 5 5 5 6 4 4 6 6 5 5 6 3 3 5 5 2 3 2 2 1 1 2 2 5 6 1 3 5 1 4 
895 2 4 5 5 5 6 4 4 6 6 5 5 6 3 3 5 5 2 3 2 2 1 1 2 2 5 6 1 3 5 1 4 
895 2 4 5 5 5 6 4 4 6 6 5 5 6 3 3 5 5 2 3 2 2 1 1 2 2 5 6 1 3 5 1 4 
895 2 4 5 5 5 6 4 4 6 6 5 5 6 3 3 5 5 2 3 2 2 1 1 2 2 5 6 1 3 5 1 
895 2 4 5 5 5 6 4 4 6 6 5 5 6 3 3 5 5 2 3 2 2 1 1 2 2 5 6 1 3 5 1 4 
895 2 4 5 5 5 6 4 4 6 6 5 5 6 3 3 5 5 2 3 2 2 1 1 2 2 5 6 1 3 5 1 4 
895 2 4 5 5 5 6 4 4 6 6 5 5 6 3 3 5 5 2 3 2 2 1 1 2 2 5 6 1 3 5 1 
895 2 4 5 5 5 6 4 4 6 6 5 5 6 3 3 5 5 2 3 2 2 1 1 2 2 5 6 1 3 5 1 4 5 
895 2 4 5 5 5 6 4 4 6 6 5 5 6 3 3 5 5 2 3 2 2 1 1 2 2 5 6 1 3 5 1 4 5 
895 2 4 5 5 5 6 4 4 6 6 5 5 6 3 3 5 5 2 3 2 2 1 1 2 2 5 6 1 3 5 1 
895 2 4 5 5 5 6 4 4 6 6 5 5 6 3 3 5 5 2 3 2 2 1 1 2 2 5 6 1 3 5 1 4 5 
895 2 4 5 5 5 6 4 4 6 6 5 5 6 3 3 5 5 2 3 2 2 1 1 2 2 5 6 1 3 5 1 
895 2 4 5 5 5 6 4 4 6 6 5 5 6 3 3 5 5 2 3 2 2 1 1 2 2 5 6 1 3 5 1 4 5 
895 2 4 5 5 5 6 4 4 6 6 5 5 6 3 3 5 5 2 3 2 2 1 1 2 2 5 6 1 3 5 1 4 5 
895 2 4 5 5 5 6 4 4 6 6 5 5 6 3 3 5 5 2 3 2 2 1 1 2 2 5 6 1 3 5 1 
895 2 4 5 5 5 6 4 4 6 6 5 5 6 3 3 5 5 2 3 2 2 1 1 2 2 5 6 1 3 5 1 
895 2 4 5 5 5 6 4 4 6 6 5 5 6 3 3 5 5 2 3 2 2 1 1 2 2 5 6 1 3 5 1 
895 2 4 5 5 5 6 4 4 6 6 5 5 6 3 3 5 5 2 3 2 2 1 1 2 2 5 6 1 3 5 1 4 5 
895 2 4 5 5 5 6 4 4 6 6 5 5 6 3 3 5 5 2 3 2 2 1 1 2 2 5 6 1 3 5 1 4 
895 2 4 5 5 5 6 4 4 6 6 5 5 6 3 3 5 5 2 3 2 2 1 1 2 2 5 6 1 3 5 1 4 
895 2 4 5 5 5 6 4 4 6 6 5 5 6 3 3 5 5 2 3 2 2 1 1 2 2 5 6 1 3 5 1 4 5 
895 2 4 5 5 5 6 4 4 6 6 5 5 6 3 3 5 5 2 3 2 2 1 1 2 2 5 6 1 3 5 1 4 
895 2 4 5 5 5 6 4 4 6 6 5 5 6 3 3 5 5 2 3 2 2 1 1 2 2 5 6 1 3 5 1 4 
895 2 4 5 5 5 6 4 4 6 6 5 5 6 3 3 5 5 2 3 2 2 1 1 2 2 5 6 1 3 5 1 
895 2 4 5 5 5 6 4 4 6 6 5 5 6 3 3 5 5 2 3 2 2 1 1 2 2 5 6 1 3 5 1 
895 2 4 5 5 5 6 4 4 6 6 5 5 6 3 3 5 5 2 3 2 2 1 1 2 2 5 6 1 3 5 1 4 
895 2 4 5 5 5 6 4 4 6 6 5 5 6 3 3 5 5 2 3 2 2 1 1 2 2 5 6 1 3 5 1 4 
895 2 4 5 5 5 6 4 4 6 6 5 5 6 3 3 5 5 2 3 2 2 1 1 2 2 5 6 1 3 5 1 
895 2 4 5 5 5 6 4 4 6 6 5 5 6 3 3 5 5 2 3 2 2 1 1 2 2 5 6 1 3 5 1 4 
895 2 4 5 5 5 6 4 4 6 6 5 5 6 3 3 5 5 2 3 2 2 1 1 2 2 5 6 1 3 5 1 4 5 
895 2 4 5 5 5 6 4 4 6 6 5 5 6 3 3 5 5 2 3 2 2 1 1 2 2 5 6 1 3 5 1 
895 2 4 5 5 5 6 4 4 6 6 5 5 6 3 3 5 5 2 3 2 2 1 1 2 2 5 6 1 3 5 1 
895 2 4 5 5 5 6 4 4 6 6 5 5 6 3 3 5 5 2 3 2 2 1 1 2 2 5 6 1 3 5 1 
895 2 4 5 5 5 6 4 4 6 6 5 5 6 3 3 5 5 2 3 2 2 1 1 2 2 5 6 1 3 5 1 4 
895 2 4 5 5 5 6 4 4 6 6 5 5 6 3 3 5 5 2 3 2 2 1 1 2 2 5 6 1 3 5 1 4 5 
895 2 4 5 5 5 6 4 4 6 6 5 5 6 3 3 5 5 2 3 2 2 1 1 2 2 5 6 1 3 5 1 
895 2 4 5 5 5 6 4 4 6 6 5 5 6 3 3 5 5 2 3 2 2 1 1 2 2 5 6 1 3 5 1 4 5 
895 2 4 5 5 5 6 4 4 6 6 5 5 6 3 3 5 5 2 3 2 2 1 1 2 2 5 6 1 3 5 1 4 5 
895 2 4 5 5 5 6 4 4 6 6 5 5 6 3 3 5 5 2 3 2 2 1 1 2 2 5 6 1 3 5 1 
895 2 4 5 5 5 6 4 4 6 6 5 5 6 3 3 5 5 2 3 2 2 1 1 2 2 5 6 1 3 5 1 4 
895 2 4 5 5 5 6 4 4 6 6 5 5 6 3 3 5 5 2 3 2 2 1 1 2 2 5 6 1 3 5 1 
895 2 4 5 5 5 6 4 4 6 6 5 5 6 3 3 5 5 2 3 2 2 1 1 2 2 5 6 1 3 5 1 
895 2 4 5 5 5 6 4 4 6 6 5 5 6 3 3 5 5 2 3 2 2 1 1 2 2 5 6 1 3 5 1 4 
895 2 4 5 5 5 6 4 4 6 6 5 5 6 3 3 5 5 2 3 2 2 1 1 2 2 5 6 1 3 5 1 4 
895 2 4 5 5 5 6 4 4 6 6 5 5 6 3 3 5 5 2 3 2 2 1 1 2 2 5 6 1 3 5 1 4 
895 2 4 5 5 5 6 4 4 6 6 5 5 6 3 3 5 5 2 3 2 2 1 1 2 2 5 6 1 3 5 1 
895 2 4 5 5 5 6 4 4 6 6 5 5 6 3 3 5 5 2 3 2 2 1 1 2 2 5 6 1 3 5 1 
895 2 4 5 5 5 6 4 4 6 6 5 5 6 3 3 5 5 2 3 2 2 1 1 2 2 5 6 1 3 5 1 4 
895 2 4 5 5 5 6 4 4 6 6 5 5 6 3 3 5 5 2 3 2 2 1 1 2 2 5 6 1 3 5 1 
895 2 4 5 5 5 6 4 4 6 6 5 5 6 3 3 5 5 2 3 2 2 1 1 2 2 5 6 1 3 5 1 4 
895 2 4 5 5 5 6 4 4 6 6 5 5 6 3 3 5 5 2 3 2 2 1 1 2 2 5 6 1 3 5 1 4 
895 2 4 5 5 5 6 4 4 6 6 5 5 6 3 3 5 5 2 3 2 2 1 1 2 2 5 6 1 3 5 1 4 5 
895 2 4 5 5 5 6 4 4 6 6 5 5 6 3 3 5 5 2 3 2 2 1 1 2 2 5 6 1 3 5 1 
895 2 4 5 5 5 6 4 4 6 6 5 5 6 3 3 5 5 2 3 2 2 1 1 2 2 5 6 1 3 5 1 
895 2 4 5 5 5 6 4 4 6 6 5 5 6 3 3 5 5 2 3 2 2 1 1 2 2 5 6 1 3 5 2 
895 2 4 5 5 5 6 4 4 6 6 5 5 6 3 3 5 5 2 3 2 2 1 1 2 2 5 6 1 3 5 1 
895 2 4 5 5 5 6 4 4 6 6 5 5 6 3 3 5 5 2 3 2 2 1 1 2 2 5 6 1 3 5 6 
895 2 4 5 5 5 6 4 4 6 6 5 5 6 3 3 5 5 2 3 2 2 1 1 2 2 5 6 1 3 5 5 
895 2 4 5 5 5 6 4 4 6 6 5 5 6 3 3 5 5 2 3 2 2 1 1 2 2 5 6 1 3 5 1 4 
895 2 4 5 5 5 6 4 4 6 6 5 5 6 3 3 5 5 2 3 2 2 1 1 2 2 5 6 1 3 5 1 
895 2 4 5 5 5 6 4 4 6 6 5 5 6 3 3 5 5 2 3 2 2 1 1 2 2 5 6 1 3 5 5 
895 2 4 5 5 5 6 4 4 6 6 5 5 6 3 3 5 5 2 3 2 2 1 1 2 2 5 6 1 3 5 3 
895 2 4 5 5 5 6 4 4 6 6 5 5 6 3 3 5 5 2 3 2 2 1 1 2 2 5 6 1 3 5 2 
895 2 4 5 5 5 6 4 4 6 6 5 5 6 3 3 5 5 2 3 2 2 1 1 2 2 5 6 1 3 5 1 
895 2 4 5 5 5 6 4 4 6 6 5 5 6 3 3 5 5 2 3 2 2 1 1 2 2 5 6 1 3 
895 2 4 5 5 5 6 4 4 6 6 5 5 6 3 3 5 5 2 3 2 2 1 1 2 2 5 6 1 3 5 3 
895 2 4 5 5 5 6 4 4 6 6 5 5 6 3 3 5 5 2 3 2 2 1 1 2 2 5 6 1 3 5 4 
895 2 4 5 5 5 6 4 4 6 6 5 5 6 3 3 5 5 2 3 2 2 1 1 2 2 5 6 1 3 5 1 
895 2 4 5 5 5 6 4 4 6 6 5 5 6 3 3 5 5 2 3 2 2 1 1 2 2 5 6 1 3 5 1 
895 2 4 5 5 5 6 4 4 6 6 5 5 6 3 3 5 5 2 3 2 2 1 1 2 2 5 6 1 3 5 1 
895 2 4 5 5 5 6 4 4 6 6 5 5 6 3 3 5 5 2 3 2 2 1 1 2 2 5 6 1 3 5 1 3 
895 2 4 5 5 5 6 4 4 6 6 5 5 6 3 3 5 5 2 3 2 2 1 1 2 2 5 6 1 3 5 1 3 
895 2 4 5 5 5 6 4 4 6 6 5 5 6 3 3 5 5 2 3 2 2 1 1 2 2 5 6 1 3 5 1 
895 2 4 5 5 5 6 4 4 6 6 5 5 6 3 3 5 5 2 3 2 2 1 1 2 2 5 6 1 3 
895 2 4 5 5 5 6 4 4 6 6 5 5 6 3 3 5 5 2 3 2 2 1 1 2 2 5 6 1 3 5 5 
895 2 4 5 5 5 6 4 4 6 6 5 5 6 3 3 5 5 2 3 2 2 1 1 2 2 5 6 1 3 5 6 
895 2 4 5 5 5 6 4 4 6 6 5 5 6 3 3 5 5 2 3 2 2 1 1 2 2 5 6 1 3 5 1 
895 2 4 5 5 5 6 4 4 6 6 5 5 6 3 3 5 5 2 3 2 2 1 1 2 2 5 6 1 3 5 1 
895 2 4 5 5 5 6 4 4 6 6 5 5 6 3 3 5 5 2 3 2 2 1 1 2 2 5 6 1 3 5 1 
895 2 4 5 5 5 6 4 4 6 6 5 5 6 3 3 5 5 2 3 2 2 1 1 2 2 5 6 1 3 5 5 
895 2 4 5 5 5 6 4 4 6 6 5 5 6 3 3 5 5 2 3 2 2 1 1 2 2 5 6 1 3 5 1 
895 2 4 5 5 5 6 4 4 6 6 5 5 6 3 3 5 5 2 3 2 2 1 1 2 2 5 6 1 3 5 4 
895 2 4 5 5 5 6 4 4 6 6 5 5 6 3 3 5 5 2 3 2 2 1 1 2 2 5 6 1 3 5 1 4 
895 2 4 5 5 5 6 4 4 6 6 5 5 6 3 3 5 5 2 3 2 2 1 1 2 2 5 6 1 3 5 4 5 1 4 
895 2 4 5 5 5 6 4 4 6 6 5 5 6 3 3 5 5 2 3 2 2 1 1 2 2 5 6 1 3 5 1 4 4 3 1 5 
895 2 4 5 5 5 6 4 4 6 6 5 5 6 3 3 5 5 2 3 2 2 1 1 2 2 5 6 1 3 5 4 3 4 
895 2 4 5 5 5 6 4 4 6 6 5 5 6 3 3 5 5 2 3 2 2 1 1 2 2 5 6 1 3 5 4 3 4 
895 2 4 5 5 5 6 4 4 6 6 5 5 6 3 3 5 5 2 3 2 2 1 1 2 2 5 6 1 3 5 6 
895 2 4 5 5 5 6 4 4 6 6 5 5 6 3 3 5 5 2 3 2 2 1 1 2 2 5 6 1 3 5 6 
895 2 4 5 5 5 6 4 4 6 6 5 5 6 3 3 5 5 2 3 2 2 1 1 2 2 5 6 1 3 5 1 
895 2 4 5 5 5 6 4 4 6 6 5 5 6 3 3 5 5 2 3 2 2 1 1 2 2 5 6 1 3 5 4 1 
895 2 4 5 5 5 6 4 4 6 6 5 5 6 3 3 5 5 2 3 2 2 1 1 2 2 5 6 1 3 5 1 4 
895 2 4 5 5 5 6 4 4 6 6 5 5 6 3 3 5 5 2 3 2 2 1 1 2 2 5 6 1 3 5 5 
895 2 4 5 5 5 6 4 4 6 6 5 5 6 3 3 5 5 2 3 2 2 1 1 2 2 5 6 1 3 5 2 
895 2 4 5 5 5 6 4 4 6 6 5 5 6 3 3 5 5 2 3 2 2 1 1 2 2 5 6 1 3 5 1 
895 2 4 5 5 5 6 4 4 6 6 5 5 6 3 3 5 5 2 3 2 2 1 1 2 2 5 6 1 3 5 5 
895 2 4 5 5 5 6 4 4 6 6 5 5 6 3 3 5 5 2 3 2 2 1 1 2 2 5 6 1 3 5 1 
895 2 4 5 5 5 6 4 4 6 6 5 5 6 3 3 5 5 2 3 2 2 1 1 2 2 5 6 1 3 5 1 3 
895 2 4 5 5 5 6 4 4 6 6 5 5 6 3 3 5 5 2 3 2 2 1 1 2 2 5 6 1 3 5 1 3 
895 2 4 5 5 5 6 4 4 6 6 5 5 6 3 3 5 5 2 3 2 2 1 1 2 2 5 6 1 3 5 6 
895 2 4 5 5 5 6 4 4 6 6 5 5 6 3 3 5 5 2 3 2 2 1 1 2 2 5 6 1 3 5 4 
895 2 4 5 5 5 6 4 4 6 6 5 5 6 3 3 5 5 2 3 2 2 1 1 2 2 5 6 1 3 5 1 3 
895 2 4 5 5 5 6 4 4 6 6 5 5 6 3 3 5 5 2 3 2 2 1 1 2 2 5 6 1 3 5 4 
895 2 4 5 5 5 6 4 4 6 6 5 5 6 3 3 5 5 2 3 2 2 1 1 2 2 5 6 1 3 5 1 
895 2 4 5 5 5 6 4 4 6 6 5 5 6 3 3 5 5 2 3 2 2 1 1 2 2 5 6 1 3 5 1 
895 2 4 5 5 5 6 4 4 6 6 5 5 6 3 3 5 5 2 3 2 2 1 1 2 2 5 6 1 3 5 5 
895 2 4 5 5 5 6 4 4 6 6 5 5 6 3 3 5 5 2 3 2 2 1 1 2 2 5 6 1 3 5 1 
895 2 4 5 5 5 6 4 4 6 6 5 5 6 3 3 5 5 2 3 2 2 1 1 2 2 5 6 1 3 5 1 
895 2 4 5 5 5 6 4 4 6 6 5 5 6 3 3 5 5 2 3 2 2 1 1 2 2 5 6 1 3 5 1 
895 2 4 5 5 5 6 4 4 6 6 5 5 6 3 3 5 5 2 3 2 2 1 1 2 2 5 6 1 3 5 4 
895 2 4 5 5 5 6 4 4 6 6 5 5 6 3 3 5 5 2 3 2 2 1 1 2 2 5 6 1 3 4 1 
895 2 4 5 5 5 6 4 4 6 6 5 5 6 3 3 5 5 2 3 2 2 1 1 2 2 5 6 1 3 
895 2 4 5 5 5 6 4 4 6 6 5 5 6 3 3 5 5 2 3 2 2 1 1 2 2 5 6 1 3 
895 2 4 5 5 5 6 4 4 6 6 5 5 6 3 3 5 5 2 3 2 2 1 1 2 2 5 6 1 3 
895 2 4 5 5 5 6 4 4 6 6 5 5 6 3 3 5 5 2 3 2 2 1 1 2 2 5 6 1 3 4 2 
895 2 4 5 5 5 6 4 4 6 6 5 5 6 3 3 5 5 2 3 2 2 1 1 2 2 5 6 1 3 5 1 
895 2 4 5 5 5 6 4 4 6 6 5 5 6 3 3 5 5 2 3 2 2 1 1 2 2 5 6 1 3 5 1 4 
895 2 4 5 5 5 6 4 4 6 6 5 5 6 3 3 5 5 2 3 2 2 1 1 2 2 5 6 1 3 5 1 4 
895 2 4 5 5 5 6 4 4 6 6 5 5 6 3 3 5 5 2 3 2 2 1 1 2 2 5 6 1 3 5 1 4 
895 2 4 5 5 5 6 4 4 6 6 5 5 6 3 3 5 5 2 3 2 2 1 1 2 2 5 6 1 3 5 1 
895 2 4 5 5 5 6 4 4 6 6 5 5 6 3 3 5 5 2 3 2 2 1 1 2 2 5 6 1 3 5 1 
895 2 4 5 5 5 6 4 4 6 6 5 5 6 3 3 5 5 2 3 2 2 1 1 2 2 5 6 1 3 5 1 
895 2 4 5 5 5 6 4 4 6 6 5 5 6 3 3 5 5 2 3 2 2 1 1 2 2 5 6 1 3 5 1 4 
895 2 4 5 5 5 6 4 4 6 6 5 5 6 3 3 5 5 2 3 2 2 1 1 2 2 5 6 1 3 5 1 4 5 
895 2 4 5 5 5 6 4 4 6 6 5 5 6 3 3 5 5 2 3 2 2 1 1 2 2 5 6 1 3 5 1 
895 2 4 5 5 5 6 4 4 6 6 5 5 6 3 3 5 5 2 3 2 2 1 1 2 2 5 6 1 3 5 1 4 
895 2 4 5 5 5 6 4 4 6 6 5 5 6 3 3 5 5 2 3 2 2 1 1 2 2 5 6 1 3 5 1 4 
895 2 4 5 5 5 6 4 4 6 6 5 5 6 3 3 5 5 2 3 2 2 1 1 2 2 5 6 1 3 5 1 4 
895 2 4 5 5 5 6 4 4 6 6 5 5 6 3 3 5 5 2 3 2 2 1 1 2 2 5 6 1 3 5 1 4 5 
895 2 4 5 5 5 6 4 4 6 6 5 5 6 3 3 5 5 2 3 2 2 1 1 2 2 5 6 1 3 5 1 
895 2 4 5 5 5 6 4 4 6 6 5 5 6 3 3 5 5 2 3 2 2 1 1 2 2 5 6 1 3 5 1 
895 2 4 5 5 5 6 4 4 6 6 5 5 6 3 3 5 5 2 3 2 2 1 1 2 2 5 6 1 3 5 2 
895 2 4 5 5 5 6 4 4 6 6 5 5 6 3 3 5 5 2 3 2 2 1 1 2 2 5 6 1 3 4 5 
895 2 4 5 5 5 6 4 4 6 6 5 5 6 3 3 5 5 2 3 2 2 1 1 2 2 5 6 1 3 4 3 
895 2 4 5 5 5 6 4 4 6 6 5 5 6 3 3 5 5 2 3 2 2 1 1 2 2 5 6 1 3 4 3 3 
895 2 4 5 5 5 6 4 4 6 6 5 5 6 3 3 5 5 2 3 2 2 1 1 2 2 5 6 1 3 4 6 
895 2 4 5 5 5 6 4 4 6 6 5 5 6 3 3 5 5 2 3 2 2 1 1 2 2 5 6 1 3 5 1 
895 2 4 5 5 5 6 4 4 6 6 5 5 6 3 3 5 5 2 3 2 2 1 1 2 2 5 6 1 3 5 5 
895 2 4 5 5 5 6 4 4 6 6 5 5 6 3 3 5 5 2 3 2 2 1 1 2 2 5 6 1 3 5 1 3 
895 2 4 5 5 5 6 4 4 6 6 5 5 6 3 3 5 5 2 3 2 2 1 1 2 2 5 6 1 3 5 5 
895 2 4 5 5 5 6 4 4 6 6 5 5 6 3 3 5 5 2 3 2 2 1 1 2 2 5 6 1 3 4 3 
890 2 4 5 5 5 6 4 4 6 6 5 5 6 3 3 5 5 2 3 2 2 1 1 2 2 5 6 1 3 1 
890 2 4 5 5 5 6 4 4 6 6 5 5 6 3 3 5 5 2 3 2 2 1 1 2 2 5 6 1 3 3 
890 2 4 5 5 5 6 4 4 6 6 5 5 6 3 3 5 5 2 3 2 2 1 1 2 2 5 6 1 3 2 
890 2 4 5 5 5 6 4 4 6 6 5 5 6 3 3 5 5 2 3 2 2 1 1 2 2 5 6 1 3 6 
890 2 4 5 5 5 6 4 4 6 6 5 5 6 3 3 5 5 2 3 2 2 1 1 2 2 5 6 1 3 1 
890 2 4 5 5 5 6 4 4 6 6 5 5 6 3 3 5 5 2 3 2 2 1 1 2 2 5 6 1 3 4 
890 2 4 5 5 5 6 4 4 6 6 5 5 6 3 3 5 5 2 3 2 2 1 1 2 2 5 6 1 3 1 
890 2 4 5 5 5 6 4 4 6 6 5 5 6 3 3 5 5 2 3 2 2 1 1 2 2 5 6 1 3 5 
890 2 4 5 5 5 6 4 4 6 6 5 5 6 3 3 5 5 2 3 2 2 1 1 2 2 5 6 1 3 5 
890 2 4 5 5 5 6 4 4 6 6 5 5 6 3 3 5 5 2 3 2 2 1 1 2 2 5 6 1 3 3 
890 2 4 5 5 5 6 4 4 6 6 5 5 6 3 3 5 5 2 3 2 2 1 1 2 2 5 6 1 3 5 
890 2 4 5 5 5 6 4 4 6 6 5 5 6 3 3 5 5 2 3 2 2 1 1 2 2 5 6 1 3 1 
890 2 4 5 5 5 6 4 4 6 6 5 5 6 3 3 5 5 2 3 2 2 1 1 2 2 5 6 1 3 3 
890 2 4 5 5 5 6 4 4 6 6 5 5 6 3 3 5 5 2 3 2 2 1 1 2 2 5 6 1 3 4 
890 2 4 5 5 5 6 4 4 6 6 5 5 6 3 3 5 5 2 3 2 2 1 1 2 2 5 6 1 3 5 
890 2 4 5 5 5 6 4 4 6 6 5 5 6 3 3 5 5 2 3 2 2 1 1 2 2 5 6 1 3 4 
890 2 4 5 5 5 6 4 4 6 6 5 5 6 3 3 5 5 2 3 2 2 1 1 2 2 5 6 1 3 2 
890 2 4 5 5 5 6 4 4 6 6 5 5 6 3 3 5 5 2 3 2 2 1 1 2 2 5 6 1 3 6 
890 2 4 5 5 5 6 4 4 6 6 5 5 6 3 3 5 5 2 3 2 2 1 1 2 2 5 6 1 3 5 
890 2 4 5 5 5 6 4 4 6 6 5 5 6 3 3 5 5 2 3 2 2 1 1 2 2 5 6 1 3 3 
890 2 4 5 5 5 6 4 4 6 6 5 5 6 3 3 5 5 2 3 2 2 1 1 2 2 5 6 1 3 5 
890 2 4 5 5 5 6 4 4 6 6 5 5 6 3 3 5 5 2 3 2 2 1 1 2 2 5 6 1 3 5 
890 2 4 5 5 5 6 4 4 6 6 5 5 6 3 3 5 5 2 3 2 2 1 1 2 2 5 6 1 3 4 
890 2 4 5 5 5 6 4 4 6 6 5 5 6 3 3 5 5 2 3 2 2 1 1 2 2 5 6 1 3 5 
890 2 4 5 5 5 6 4 4 6 6 5 5 6 3 3 5 5 2 3 2 2 1 1 2 2 5 6 1 3 2 
890 2 4 5 5 5 6 4 4 6 6 5 5 6 3 3 5 5 2 3 2 2 1 1 2 2 5 6 1 3 2 
890 2 4 5 5 5 6 4 4 6 6 5 5 6 3 3 5 5 2 3 2 2 1 1 2 2 5 6 1 3 4 
890 2 4 5 5 5 6 4 4 6 6 5 5 6 3 3 5 5 2 3 2 2 1 1 2 2 5 6 1 3 2 
890 2 4 5 5 5 6 4 4 6 6 5 5 6 3 3 5 5 2 3 2 2 1 1 2 2 5 6 1 3 3 
890 2 4 5 5 5 6 4 4 6 6 5 5 6 3 3 5 5 2 3 2 2 1 1 2 2 5 6 1 3 2 
890 2 4 5 5 5 6 4 4 6 6 5 5 6 3 3 5 5 2 3 2 2 1 1 2 2 5 6 1 3 1 
890 2 4 5 5 5 6 4 4 6 6 5 5 6 3 3 5 5 2 3 2 2 1 1 2 2 5 6 1 3 5 
890 2 4 5 5 5 6 4 4 6 6 5 5 6 3 3 5 5 2 3 2 2 1 1 2 2 5 6 1 3 4 
890 2 4 5 5 5 6 4 4 6 6 5 5 6 3 3 5 5 2 3 2 2 1 1 2 2 5 6 1 3 3 
890 2 4 5 5 5 6 4 4 6 6 5 5 6 3 3 5 5 2 3 2 2 1 1 2 2 5 6 1 3 6 
890 2 4 5 5 5 6 4 4 6 6 5 5 6 3 3 5 5 2 3 2 2 1 1 2 2 5 6 1 3 5 
890 2 4 5 5 5 6 4 4 6 6 5 5 6 3 3 5 5 2 3 2 2 1 1 2 2 5 6 1 3 2 
890 2 4 5 5 5 6 4 4 6 6 5 5 6 3 3 5 5 2 3 2 2 1 1 2 2 5 6 1 3 2 
890 2 4 5 5 5 6 4 4 6 6 5 5 6 3 3 5 5 2 3 2 2 1 1 2 2 5 6 1 3 2 
890 2 4 5 5 5 6 4 4 6 6 5 5 6 3 3 5 5 2 3 2 2 1 1 2 2 5 6 1 3 6 
890 2 4 5 5 5 6 4 4 6 6 5 5 6 3 3 5 5 2 3 2 2 1 1 2 2 5 6 1 3 6 
890 2 4 5 5 5 6 4 4 6 6 5 5 6 3 3 5 5 2 3 2 2 1 1 2 2 5 6 1 3 5 
890 2 4 5 5 5 6 4 4 6 6 5 5 6 3 3 5 5 2 3 2 2 1 1 2 2 5 6 1 3 4 
890 2 4 5 5 5 6 4 4 6 6 5 5 6 3 3 5 5 2 3 2 2 1 1 2 2 5 6 1 3 4 
810 2 4 5 5 5 6 4 4 6 6 5 5 6 3 3 5 5 2 3 2 2 1 1 2 1 1 6 1 4 4 
