-295 4 5 5 5 5 3 5 1 4 3 6 6 
-295 4 5 5 5 5 3 5 1 4 3 
-295 4 5 5 5 5 3 5 1 4 3 6 
-295 4 5 5 5 5 3 5 1 4 3 6 
-295 4 5 5 5 5 3 5 1 4 3 6 
-295 4 5 5 5 5 3 5 1 4 3 
-295 4 5 5 5 5 3 5 1 4 3 
-295 4 5 5 5 5 3 5 1 4 3 6 
-295 4 5 5 5 5 3 5 1 4 3 
-295 4 5 5 5 5 3 5 1 4 3 6 
-295 4 5 5 5 5 3 5 1 4 3 
-295 4 5 5 5 5 3 5 1 4 3 
-295 4 5 5 5 5 3 5 1 4 3 6 6 
-295 4 5 5 5 5 3 5 1 4 3 
-295 4 5 5 5 5 3 5 1 4 3 6 6 
-295 4 5 5 5 5 3 5 1 4 3 6 
-295 4 5 5 5 5 3 5 1 4 3 
-295 4 5 5 5 5 3 5 1 4 3 
-295 4 5 5 5 5 3 5 1 4 3 6 
-295 4 5 5 5 5 3 5 1 4 3 
-295 4 5 5 5 5 3 5 1 4 3 6 
-295 4 5 5 5 5 3 5 1 4 3 6 
-295 4 5 5 5 5 3 5 1 4 3 6 
-295 4 5 5 5 5 3 5 1 4 3 
-295 4 5 5 5 5 3 5 1 4 3 6 6 
-295 4 5 5 5 5 3 5 1 4 3 6 6 4 
-295 4 5 5 5 5 3 5 1 4 3 6 6 
-295 4 5 5 5 5 3 5 1 4 3 
-295 4 5 5 5 5 3 5 1 4 3 
-295 4 5 5 5 5 3 5 1 4 3 6 6 4 
-295 4 5 5 5 5 3 5 1 4 3 6 6 4 
-295 4 5 5 5 5 3 5 1 4 3 6 6 4 
-295 4 5 5 5 5 3 5 1 4 3 
-295 4 5 5 5 5 3 5 1 4 3 6 6 4 
-295 4 5 5 5 5 3 5 1 4 3 6 6 4 
-295 4 5 5 5 5 3 5 1 4 3 6 6 4 
-295 4 5 5 5 5 3 5 1 4 3 6 6 
-295 4 5 5 5 5 3 5 1 4 3 6 6 
-295 4 5 5 5 5 3 5 1 4 
-295 4 5 5 5 5 3 5 1 4 3 6 6 
-295 4 5 5 5 5 3 5 1 4 3 
-295 4 5 5 5 5 3 5 1 4 3 6 6 
-295 4 5 5 5 5 3 5 1 4 3 6 6 4 
-295 4 5 5 5 5 3 5 1 4 3 6 6 4 
-295 4 5 5 5 5 3 5 1 4 3 6 6 
-295 4 5 5 5 5 3 5 1 4 3 6 6 4 
-295 4 5 5 5 5 3 5 1 4 3 6 6 
-295 4 5 5 5 5 3 5 1 4 3 6 6 4 2 
