1425 5 6 5 5 3 4 6 4 6 3 1 3 1 2 5 6 6 6 2 3 6 2 2 2 2 2 3 6 6 4 6 6 2 3 1 4 6 6 6 2 
1380 5 6 5 5 3 4 6 4 6 3 1 3 1 2 5 6 6 6 2 3 6 2 2 2 2 2 3 6 6 4 6 6 2 4 6 5 5 4 
1370 5 6 5 5 3 4 6 4 6 3 1 3 1 2 5 6 6 6 2 3 6 2 2 2 2 2 3 6 6 4 6 6 2 4 6 6 5 
1360 5 6 5 5 3 4 6 4 6 3 1 3 1 2 5 6 6 6 2 3 6 2 2 2 2 2 3 6 6 4 6 6 2 4 3 5 6 5 
1355 5 6 5 5 3 4 6 4 6 3 1 3 1 2 5 6 6 6 2 3 6 2 2 2 2 2 3 6 6 4 6 6 5 6 5 5 1 
1295 5 6 5 5 3 4 6 4 6 3 1 3 1 2 5 6 6 6 2 3 6 2 2 2 2 2 3 6 6 4 6 6 2 4 3 5 2 
1285 5 6 5 5 3 4 6 4 6 3 1 3 1 2 5 6 6 6 2 3 6 2 2 2 2 2 3 6 6 4 6 6 1 4 6 3 2 
1270 5 6 5 5 3 4 6 4 6 3 1 3 1 2 5 6 6 6 2 3 6 2 2 2 2 2 3 6 6 4 6 4 4 1 4 3 1 1 4 3 6 1 
1255 5 6 5 5 3 4 6 4 6 3 1 3 1 2 5 6 6 6 2 3 6 2 2 2 2 2 3 6 6 4 6 6 1 4 6 1 
1255 5 6 5 5 3 4 6 4 6 3 1 3 1 2 5 6 6 6 2 3 6 2 2 2 2 2 3 6 6 4 6 6 5 4 6 
1255 5 6 5 5 3 4 6 4 6 3 1 3 1 2 5 6 6 6 2 3 6 2 2 2 2 2 3 6 6 4 6 6 5 6 1 
1255 5 6 5 5 3 4 6 4 6 3 1 3 1 2 5 6 6 6 2 3 6 2 2 2 2 2 3 6 6 4 6 6 3 1 2 3 6 
1245 5 6 5 5 3 4 6 4 6 3 1 3 1 2 5 6 6 6 2 3 6 2 2 2 2 2 3 6 6 4 6 6 4 2 3 3 6 
1245 5 6 5 5 3 4 6 4 6 3 1 3 1 2 5 6 6 6 2 3 6 2 2 2 2 2 3 6 6 4 6 6 3 3 3 2 3 3 4 5 
1240 5 6 5 5 3 4 6 4 6 3 1 3 1 2 5 6 6 6 2 3 6 2 2 2 2 2 3 6 6 4 6 6 2 4 2 
1240 5 6 5 5 3 4 6 4 6 3 1 3 1 2 5 6 6 6 2 3 6 2 2 2 2 2 3 6 6 4 6 6 1 2 5 
1235 5 6 5 5 3 4 6 4 6 3 1 3 1 2 5 6 6 6 2 3 6 2 2 2 2 2 3 6 6 4 6 6 2 3 4 2 
1230 5 6 5 5 3 4 6 4 6 3 1 3 1 2 5 6 6 6 2 3 6 2 2 2 2 2 3 6 6 4 6 6 2 6 
1230 5 6 5 5 3 4 6 4 6 3 1 3 1 2 5 6 6 6 2 3 6 2 2 2 2 2 3 6 6 4 6 6 2 6 
1230 5 6 5 5 3 4 6 4 6 3 1 3 1 2 5 6 6 6 2 3 6 2 2 2 2 2 3 6 6 4 6 6 2 6 
1230 5 6 5 5 3 4 6 4 6 3 1 3 1 2 5 6 6 6 2 3 6 2 2 2 2 2 3 6 6 4 6 6 2 6 
1230 5 6 5 5 3 4 6 4 6 3 1 3 1 2 5 6 6 6 2 3 6 2 2 2 2 2 3 6 6 4 6 6 1 2 3 2 5 
1230 5 6 5 5 3 4 6 4 6 3 1 3 1 2 5 6 6 6 2 3 6 2 2 2 2 2 3 6 6 4 6 6 2 6 
1230 5 6 5 5 3 4 6 4 6 3 1 3 1 2 5 6 6 6 2 3 6 2 2 2 2 2 3 6 6 4 6 6 3 2 3 6 
1230 5 6 5 5 3 4 6 4 6 3 1 3 1 2 5 6 6 6 2 3 6 2 2 2 2 2 3 6 6 4 6 6 2 6 
1230 5 6 5 5 3 4 6 4 6 3 1 3 1 2 5 6 6 6 2 3 6 2 2 2 2 2 3 6 6 4 6 6 2 6 
1230 5 6 5 5 3 4 6 4 6 3 1 3 1 2 5 6 6 6 2 3 6 2 2 2 2 2 3 6 6 4 6 6 2 6 
1230 5 6 5 5 3 4 6 4 6 3 1 3 1 2 5 6 6 6 2 3 6 2 2 2 2 2 3 6 6 4 6 6 2 6 
1230 5 6 5 5 3 4 6 4 6 3 1 3 1 2 5 6 6 6 2 3 6 2 2 2 2 2 3 6 6 4 6 6 2 3 2 4 2 
1225 5 6 5 5 3 4 6 4 6 3 1 3 1 2 5 6 6 6 2 3 6 2 2 2 2 2 3 6 6 4 6 6 2 2 6 
1225 5 6 5 5 3 4 6 4 6 3 1 3 1 2 5 6 6 6 2 3 6 2 2 2 2 2 3 6 6 4 6 4 2 2 5 
1225 5 6 5 5 3 4 6 4 6 3 1 3 1 2 5 6 6 6 2 3 6 2 2 2 2 2 3 6 6 4 6 6 2 2 6 
1225 5 6 5 5 3 4 6 4 6 3 1 3 1 2 5 6 6 6 2 3 6 2 2 2 2 2 3 6 6 4 6 4 6 3 3 4 2 
1225 5 6 5 5 3 4 6 4 6 3 1 3 1 2 5 6 6 6 2 3 6 2 2 2 2 2 3 6 6 4 6 4 1 1 5 2 
1225 5 6 5 5 3 4 6 4 6 3 1 3 1 2 5 6 6 6 2 3 6 2 2 2 2 2 3 6 6 4 6 6 2 1 6 
1225 5 6 5 5 3 4 6 4 6 3 1 3 1 2 5 6 6 6 2 3 6 2 2 2 2 2 3 6 6 4 6 6 2 3 6 
1225 5 6 5 5 3 4 6 4 6 3 1 3 1 2 5 6 6 6 2 3 6 2 2 2 2 2 3 6 6 4 6 6 3 2 1 3 6 
1220 5 6 5 5 3 4 6 4 6 3 1 3 1 2 5 6 6 6 2 3 6 2 2 2 2 2 3 6 6 4 6 6 4 3 1 5 
1220 5 6 5 5 3 4 6 4 6 3 1 3 1 2 5 6 6 6 2 3 6 2 2 2 2 2 3 6 6 4 6 5 6 1 1 6 
1220 5 6 5 5 3 4 6 4 6 3 1 3 1 2 5 6 6 6 2 3 6 2 2 2 2 2 3 6 6 4 6 5 5 3 6 
1215 5 6 5 5 3 4 6 4 6 3 1 3 1 2 5 6 6 6 2 3 6 2 2 2 2 2 3 6 6 4 6 6 1 1 5 
1215 5 6 5 5 3 4 6 4 6 3 1 3 1 2 5 6 6 6 2 3 6 2 2 2 2 2 3 6 6 4 6 6 2 5 
1215 5 6 5 5 3 4 6 4 6 3 1 3 1 2 5 6 6 6 2 3 6 2 2 2 2 2 3 6 6 4 6 5 4 1 1 3 1 5 
1215 5 6 5 5 3 4 6 4 6 3 1 3 1 2 5 6 6 6 2 3 6 2 2 2 2 2 3 6 6 4 6 6 2 5 
1215 5 6 5 5 3 4 6 4 6 3 1 3 1 2 5 6 6 6 2 3 6 2 2 2 2 2 3 6 6 4 6 6 2 5 
1215 5 6 5 5 3 4 6 4 6 3 1 3 1 2 5 6 6 6 2 3 6 2 2 2 2 2 3 6 6 4 6 6 2 4 4 
1215 5 6 5 5 3 4 6 4 6 3 1 3 1 2 5 6 6 6 2 3 6 2 2 2 2 2 3 6 6 4 6 6 5 5 
1215 5 6 5 5 3 4 6 4 6 3 1 3 1 2 5 6 6 6 2 3 6 2 2 2 2 2 3 6 6 4 6 6 2 5 
1215 5 6 5 5 3 4 6 4 6 3 1 3 1 2 5 6 6 6 2 3 6 2 2 2 2 2 3 6 6 4 6 6 2 5 
1215 5 6 5 5 3 4 6 4 6 3 1 3 1 2 5 6 6 6 2 3 6 2 2 2 2 2 3 6 6 4 6 6 2 5 
1215 5 6 5 5 3 4 6 4 6 3 1 3 1 2 5 6 6 6 2 3 6 2 2 2 2 2 3 6 6 4 6 6 2 4 4 
1215 5 6 5 5 3 4 6 4 6 3 1 3 1 2 5 6 6 6 2 3 6 2 2 2 2 2 3 6 6 4 6 6 2 5 
1215 5 6 5 5 3 4 6 4 6 3 1 3 1 2 5 6 6 6 2 3 6 2 2 2 2 2 3 6 6 4 6 6 2 1 4 3 1 
1215 5 6 5 5 3 4 6 4 6 3 1 3 1 2 5 6 6 6 2 3 6 2 2 2 2 2 3 6 6 4 6 6 2 4 1 
1215 5 6 5 5 3 4 6 4 6 3 1 3 1 2 5 6 6 6 2 3 6 2 2 2 2 2 3 6 6 4 6 6 5 5 
1215 5 6 5 5 3 4 6 4 6 3 1 3 1 2 5 6 6 6 2 3 6 2 2 2 2 2 3 6 6 4 6 6 2 4 1 
1215 5 6 5 5 3 4 6 4 6 3 1 3 1 2 5 6 6 6 2 3 6 2 2 2 2 2 3 6 6 4 6 6 2 5 
1215 5 6 5 5 3 4 6 4 6 3 1 3 1 2 5 6 6 6 2 3 6 2 2 2 2 2 3 6 6 4 6 6 5 5 
1215 5 6 5 5 3 4 6 4 6 3 1 3 1 2 5 6 6 6 2 3 6 2 2 2 2 2 3 6 6 4 6 6 5 2 
1215 5 6 5 5 3 4 6 4 6 3 1 3 1 2 5 6 6 6 2 3 6 2 2 2 2 2 3 6 6 4 6 6 2 5 
1215 5 6 5 5 3 4 6 4 6 3 1 3 1 2 5 6 6 6 2 3 6 2 2 2 2 2 3 6 6 4 6 5 1 4 6 
1215 5 6 5 5 3 4 6 4 6 3 1 3 1 2 5 6 6 6 2 3 6 2 2 2 2 2 3 6 6 4 6 6 5 2 
1215 5 6 5 5 3 4 6 4 6 3 1 3 1 2 5 6 6 6 2 3 6 2 2 2 2 2 3 6 6 4 6 6 4 1 4 4 
1215 5 6 5 5 3 4 6 4 6 3 1 3 1 2 5 6 6 6 2 3 6 2 2 2 2 2 3 6 6 4 6 6 1 4 2 
1215 5 6 5 5 3 4 6 4 6 3 1 3 1 2 5 6 6 6 2 3 6 2 2 2 2 2 3 6 6 4 6 6 2 4 1 
1210 5 6 5 5 3 4 6 4 6 3 1 3 1 2 5 6 6 6 2 3 6 2 2 2 2 2 3 6 6 4 6 6 3 2 1 3 4 4 
1210 5 6 5 5 3 4 6 4 6 3 1 3 1 2 5 6 6 6 2 3 6 2 2 2 2 2 3 6 6 4 6 6 2 3 5 
1210 5 6 5 5 3 4 6 4 6 3 1 3 1 2 5 6 6 6 2 3 6 2 2 2 2 2 3 6 6 4 6 6 1 3 6 
1210 5 6 5 5 3 4 6 4 6 3 1 3 1 2 5 6 6 6 2 3 6 2 2 2 2 2 3 6 6 4 6 6 2 3 5 
1210 5 6 5 5 3 4 6 4 6 3 1 3 1 2 5 6 6 6 2 3 6 2 2 2 2 2 3 6 6 4 6 6 2 1 5 
1210 5 6 5 5 3 4 6 4 6 3 1 3 1 2 5 6 6 6 2 3 6 2 2 2 2 2 3 6 6 4 6 6 2 3 5 
1205 5 6 5 5 3 4 6 4 6 3 1 3 1 2 5 6 6 6 2 3 6 2 2 2 2 2 3 6 6 4 6 6 1 3 3 2 3 6 
1205 5 6 5 5 3 4 6 4 6 3 1 3 1 2 5 6 6 6 2 3 6 2 2 2 2 2 3 6 6 4 6 6 2 3 1 4 1 
1205 5 6 5 5 3 4 6 4 6 3 1 3 1 2 5 6 6 6 2 3 6 2 2 2 2 2 3 6 6 4 6 6 2 2 1 5 
1205 5 6 5 5 3 4 6 4 6 3 1 3 1 2 5 6 6 6 2 3 6 2 2 2 2 2 3 6 6 4 6 6 4 6 
1205 5 6 5 5 3 4 6 4 6 3 1 3 1 2 5 6 6 6 2 3 6 2 2 2 2 2 3 6 6 4 6 6 4 6 
1205 5 6 5 5 3 4 6 4 6 3 1 3 1 2 5 6 6 6 2 3 6 2 2 2 2 2 3 6 6 4 6 6 4 6 
1205 5 6 5 5 3 4 6 4 6 3 1 3 1 2 5 6 6 6 2 3 6 2 2 2 2 2 3 6 6 4 6 6 2 2 1 5 
1200 5 6 5 5 3 4 6 4 6 3 1 3 1 2 5 6 6 6 2 3 6 2 2 2 2 2 3 6 6 4 6 4 3 1 3 4 6 
1200 5 6 5 5 3 4 6 4 6 3 1 3 1 2 5 6 6 6 2 3 6 2 2 2 2 2 3 6 6 4 6 6 2 4 3 3 
1200 5 6 5 5 3 4 6 4 6 3 1 3 1 2 5 6 6 6 2 3 6 2 2 2 2 2 3 6 6 4 6 6 1 1 4 3 3 
1195 5 6 5 5 3 4 6 4 6 3 1 3 1 2 5 6 6 6 2 3 6 2 2 2 2 2 3 6 6 4 6 6 3 4 5 
1195 5 6 5 5 3 4 6 4 6 3 1 3 1 2 5 6 6 6 2 3 6 2 2 2 2 2 3 6 6 4 6 6 2 3 4 3 3 
1190 5 6 5 5 3 4 6 4 6 3 1 3 1 2 5 6 6 6 2 3 6 2 2 2 2 2 3 6 6 4 6 4 2 6 
1190 5 6 5 5 3 4 6 4 6 3 1 3 1 2 5 6 6 6 2 3 6 2 2 2 2 2 3 6 6 4 6 6 1 5 
1190 5 6 5 5 3 4 6 4 6 3 1 3 1 2 5 6 6 6 2 3 6 2 2 2 2 2 3 6 6 4 6 6 5 1 
1190 5 6 5 5 3 4 6 4 6 3 1 3 1 2 5 6 6 6 2 3 6 2 2 2 2 2 3 6 6 4 6 6 1 5 
1190 5 6 5 5 3 4 6 4 6 3 1 3 1 2 5 6 6 6 2 3 6 2 2 2 2 2 3 6 6 4 6 4 5 6 
1190 5 6 5 5 3 4 6 4 6 3 1 3 1 2 5 6 6 6 2 3 6 2 2 2 2 2 3 6 6 4 6 6 1 5 
1190 5 6 5 5 3 4 6 4 6 3 1 3 1 2 5 6 6 6 2 3 6 2 2 2 2 2 3 6 6 4 6 6 1 5 
1190 5 6 5 5 3 4 6 4 6 3 1 3 1 2 5 6 6 6 2 3 6 2 2 2 2 2 3 6 6 4 6 6 5 1 
1190 5 6 5 5 3 4 6 4 6 3 1 3 1 2 5 6 6 6 2 3 6 2 2 2 2 2 3 6 6 4 6 6 1 5 
1180 5 6 5 5 3 4 6 4 6 3 1 3 1 2 5 6 6 6 2 3 6 2 2 2 2 2 3 6 6 4 6 6 6 
1180 5 6 5 5 3 4 6 4 6 3 1 3 1 2 5 6 6 6 2 3 6 2 2 2 2 2 3 6 6 4 6 6 6 
1180 5 6 5 5 3 4 6 4 6 3 1 3 1 2 5 6 6 6 2 3 6 2 2 2 2 2 3 6 6 4 6 6 6 
1180 5 6 5 5 3 4 6 4 6 3 1 3 1 2 5 6 6 6 2 3 6 2 2 2 2 2 3 6 6 4 6 6 6 
1180 5 6 5 5 3 4 6 4 6 3 1 3 1 2 5 6 6 6 2 3 6 2 2 2 2 2 3 6 6 4 6 6 6 
1180 5 6 5 5 3 4 6 4 6 3 1 3 1 2 5 6 6 6 2 3 6 2 2 2 2 2 3 6 6 4 6 6 6 
1180 5 6 5 5 3 4 6 4 6 3 1 3 1 2 5 6 6 6 2 3 6 2 2 2 2 2 3 6 6 4 6 6 6 
1180 5 6 5 5 3 4 6 4 6 3 1 3 1 2 5 6 6 6 2 3 6 2 2 2 2 2 3 6 6 4 6 6 6 
1180 5 6 5 5 3 4 6 4 6 3 1 3 1 2 5 6 6 6 2 3 6 2 2 2 2 2 3 6 6 4 6 6 6 
1180 5 6 5 5 3 4 6 4 6 3 1 3 1 2 5 6 6 6 2 3 6 2 2 2 2 2 3 6 6 4 6 6 6 
1175 5 6 5 5 3 4 6 4 6 3 1 3 1 2 5 6 6 6 2 3 6 2 2 2 2 2 3 6 6 4 6 6 3 3 5 
1175 5 6 5 5 3 4 6 4 6 3 1 3 1 2 5 6 6 6 2 3 6 2 2 2 2 2 3 6 6 4 6 6 3 3 4 4 
1170 5 6 5 5 3 4 6 4 6 3 1 3 1 2 5 6 6 6 2 3 6 2 2 2 2 2 3 6 6 4 6 6 3 5 
1170 5 6 5 5 3 4 6 4 6 3 1 3 1 2 5 6 6 6 2 3 6 2 2 2 2 2 3 6 6 4 6 6 3 5 
1170 5 6 5 5 3 4 6 4 6 3 1 3 1 2 5 6 6 6 2 3 6 2 2 2 2 2 3 6 6 4 6 5 3 6 
1170 5 6 5 5 3 4 6 4 6 3 1 3 1 2 5 6 6 6 2 3 6 2 2 2 2 2 3 6 6 4 6 6 5 3 
1170 5 6 5 5 3 4 6 4 6 3 1 3 1 2 5 6 6 6 2 3 6 2 2 2 2 2 3 6 6 4 6 4 3 1 6 
1100 5 6 5 5 3 4 6 4 6 3 1 3 1 2 5 6 6 6 2 3 6 2 2 2 2 2 3 6 6 4 6 2 
1100 5 6 5 5 3 4 6 4 6 3 1 3 1 2 5 6 6 6 2 3 6 2 2 2 2 2 3 6 6 4 6 2 
1100 5 6 5 5 3 4 6 4 6 3 1 3 1 2 5 6 6 6 2 3 6 2 2 2 2 2 3 6 6 4 6 2 
1100 5 6 5 5 3 4 6 4 6 3 1 3 1 2 5 6 6 6 2 3 6 2 2 2 2 2 3 6 6 4 6 4 6 2 1 
1075 5 6 5 5 3 4 6 4 6 3 1 3 1 2 5 6 6 6 2 3 6 2 2 2 2 2 3 6 6 4 6 1 
1075 5 6 5 5 3 4 6 4 6 3 1 3 1 2 5 6 6 6 2 3 6 2 2 2 2 2 3 6 6 4 6 6 2 1 
1075 5 6 5 5 3 4 6 4 6 3 1 3 1 2 5 6 6 6 2 3 6 2 2 2 2 2 3 6 6 4 6 1 
1075 5 6 5 5 3 4 6 4 6 3 1 3 1 2 5 6 6 6 2 3 6 2 2 2 2 2 3 6 6 4 6 1 
1075 5 6 5 5 3 4 6 4 6 3 1 3 1 2 5 6 6 6 2 3 6 2 2 2 2 2 3 6 6 4 6 6 2 3 
1075 5 6 5 5 3 4 6 4 6 3 1 3 1 2 5 6 6 6 2 3 6 2 2 2 2 2 3 6 6 4 6 6 2 1 
1075 5 6 5 5 3 4 6 4 6 3 1 3 1 2 5 6 6 6 2 3 6 2 2 2 2 2 3 6 6 4 6 1 
1075 5 6 5 5 3 4 6 4 6 3 1 3 1 2 5 6 6 6 2 3 6 2 2 2 2 2 3 6 6 4 6 6 2 1 
1075 5 6 5 5 3 4 6 4 6 3 1 3 1 2 5 6 6 6 2 3 6 2 2 2 2 2 3 6 6 4 6 6 2 2 
1075 5 6 5 5 3 4 6 4 6 3 1 3 1 2 5 6 6 6 2 3 6 2 2 2 2 2 3 6 6 4 6 1 
1075 5 6 5 5 3 4 6 4 6 3 1 3 1 2 5 6 6 6 2 3 6 2 2 2 2 2 3 6 6 4 6 1 
1060 5 6 5 5 3 4 6 4 6 3 1 3 1 2 5 6 6 6 2 3 6 2 2 2 2 2 3 6 6 4 6 6 4 3 3 3 
1055 5 6 5 5 3 4 6 4 6 3 1 3 1 2 5 6 6 6 2 3 6 2 2 2 2 2 3 6 6 4 6 3 
1055 5 6 5 5 3 4 6 4 6 3 1 3 1 2 5 6 6 6 2 3 6 2 2 2 2 2 3 6 6 4 6 3 
1055 5 6 5 5 3 4 6 4 6 3 1 3 1 2 5 6 6 6 2 3 6 2 2 2 2 2 3 6 6 4 6 3 
1055 5 6 5 5 3 4 6 4 6 3 1 3 1 2 5 6 6 6 2 3 6 2 2 2 2 2 3 6 6 4 6 3 
995 5 6 5 5 3 4 6 4 6 3 1 3 1 2 5 6 6 6 2 3 6 2 2 2 2 1 3 4 6 4 4 5 
970 5 6 5 5 3 4 6 4 6 3 1 3 1 2 5 6 6 6 2 3 6 2 2 2 2 2 3 6 3 6 3 
955 5 6 5 5 3 4 6 4 6 3 1 3 1 2 5 6 6 6 2 3 6 2 2 2 1 2 4 3 2 4 1 1 
930 5 6 5 5 3 4 6 4 6 3 1 3 1 2 5 6 6 6 2 3 6 2 2 2 2 2 2 3 5 3 6 2 
900 5 6 5 5 3 4 6 4 6 3 1 3 1 2 5 6 6 6 2 3 6 2 2 2 2 2 5 4 
890 5 6 5 5 3 4 6 4 6 3 1 3 1 2 5 6 6 6 2 3 6 2 2 2 2 2 6 
890 5 6 5 5 3 4 6 4 6 3 1 3 1 2 5 6 6 6 2 3 6 2 2 2 2 1 4 6 
890 5 6 5 5 3 4 6 4 6 3 1 3 1 2 5 6 6 6 2 3 6 2 2 2 2 1 6 1 
885 5 6 5 5 3 4 6 4 6 3 1 3 1 2 5 6 6 6 2 3 6 2 2 2 2 1 3 4 3 4 4 
885 5 6 5 5 3 4 6 4 6 3 1 3 1 2 5 6 6 6 2 3 6 2 2 2 2 1 1 3 3 5 
855 5 6 5 5 3 4 6 4 6 3 1 3 1 2 5 6 6 6 2 3 6 2 2 2 1 1 1 3 2 
855 5 6 5 5 3 4 6 4 6 3 1 3 1 2 5 6 6 6 2 3 6 2 2 2 2 1 3 5 
855 5 6 5 5 3 4 6 4 6 3 1 3 1 2 5 6 6 6 2 3 6 2 2 2 2 1 4 3 1 
855 5 6 5 5 3 4 6 4 6 3 1 3 1 2 5 6 6 6 2 3 6 2 2 2 2 2 3 1 
850 5 6 5 5 3 4 6 4 6 3 1 3 1 2 5 6 6 6 2 3 6 2 2 2 2 1 2 
850 5 6 5 5 3 4 6 4 6 3 1 3 1 2 5 6 6 6 2 3 6 2 2 2 2 2 1 
850 5 6 5 5 3 4 6 4 6 3 1 3 1 2 5 6 6 6 2 3 6 2 2 2 2 2 4 
850 5 6 5 5 3 4 6 4 6 3 1 3 1 2 5 6 6 6 2 3 6 2 2 1 1 1 1 1 5 
850 5 6 5 5 3 4 6 4 6 3 1 3 1 2 5 6 6 6 2 3 6 2 2 2 2 2 1 
850 5 6 5 5 3 4 6 4 6 3 1 3 1 2 5 6 6 6 2 3 6 2 2 2 2 2 1 
850 5 6 5 5 3 4 6 4 6 3 1 3 1 2 5 6 6 6 2 3 6 2 2 2 2 1 5 
850 5 6 5 5 3 4 6 4 6 3 1 3 1 2 5 6 6 6 2 3 6 2 2 2 2 1 4 4 
850 5 6 5 5 3 4 6 4 6 3 1 3 1 2 5 6 6 6 2 3 6 2 2 2 2 2 1 
850 5 6 5 5 3 4 6 4 6 3 1 3 1 2 5 6 6 6 2 3 6 2 2 2 2 1 5 
850 5 6 5 5 3 4 6 4 6 3 1 3 1 2 5 6 6 6 2 3 6 2 2 2 1 1 1 5 
850 5 6 5 5 3 4 6 4 6 3 1 3 1 2 5 6 6 6 2 3 6 2 2 2 1 2 5 
850 5 6 5 5 3 4 6 4 6 3 1 3 1 2 5 6 6 6 2 3 6 2 2 2 2 1 1 4 
850 5 6 5 5 3 4 6 4 6 3 1 3 1 2 5 6 6 6 2 3 6 2 2 2 2 2 4 
850 5 6 5 5 3 4 6 4 6 3 1 3 1 2 5 6 6 6 2 3 6 2 2 2 2 2 3 4 5 6 5 2 
840 5 6 5 5 3 4 6 4 6 3 1 3 1 2 5 6 6 6 2 3 6 2 2 2 2 6 
840 5 6 5 5 3 4 6 4 6 3 1 3 1 2 5 6 6 6 2 3 6 2 2 2 2 6 
840 5 6 5 5 3 4 6 4 6 3 1 3 1 2 5 6 6 6 2 3 6 2 2 2 2 6 
840 5 6 5 5 3 4 6 4 6 3 1 3 1 2 5 6 6 6 2 3 6 2 2 2 2 6 
835 5 6 5 5 3 4 6 4 6 3 1 3 1 2 5 6 6 6 2 3 6 2 1 2 2 2 4 3 3 
825 5 6 5 5 3 4 6 4 6 3 1 3 1 2 5 6 6 6 2 3 6 2 2 2 2 5 
825 5 6 5 5 3 4 6 4 6 3 1 3 1 2 5 6 6 6 2 3 6 2 2 2 2 5 
825 5 6 5 5 3 4 6 4 6 3 1 3 1 2 5 6 6 6 2 3 6 2 2 2 2 5 
825 5 6 5 5 3 4 6 4 6 3 1 3 1 2 5 6 6 6 2 3 6 2 2 2 2 5 
800 5 6 5 5 3 4 6 4 6 3 1 3 1 2 5 6 6 6 2 3 6 2 2 2 2 4 
800 5 6 5 5 3 4 6 4 6 3 1 3 1 2 5 6 6 6 2 3 6 2 2 2 2 4 
800 5 6 5 5 3 4 6 4 6 3 1 3 1 2 5 6 6 6 2 3 6 2 2 2 2 4 
800 5 6 5 5 3 4 6 4 6 3 1 3 1 2 5 6 6 6 2 3 6 2 2 2 2 4 
800 5 6 5 5 3 4 6 4 6 3 1 3 1 2 5 6 6 6 2 3 6 2 2 2 2 4 
800 5 6 5 5 3 4 6 4 6 3 1 3 1 2 5 6 6 6 2 3 6 2 2 2 1 5 
800 5 6 5 5 3 4 6 4 6 3 1 3 1 2 5 6 6 6 2 3 6 2 2 2 2 4 
790 5 6 5 5 3 4 6 4 6 3 1 3 1 2 5 6 6 6 2 3 6 2 2 1 1 6 
790 5 6 5 5 3 4 6 4 6 3 1 3 1 2 5 6 6 6 2 3 6 2 2 2 6 
790 5 6 5 5 3 4 6 4 6 3 1 3 1 2 5 6 6 6 2 3 6 2 2 2 6 
790 5 6 5 5 3 4 6 4 6 3 1 3 1 2 5 6 6 6 2 3 6 2 2 2 6 
790 5 6 5 5 3 4 6 4 6 3 1 3 1 2 5 6 6 6 2 3 6 2 2 2 6 
790 5 6 5 5 3 4 6 4 6 3 1 3 1 2 5 6 6 6 2 3 6 2 2 2 6 
780 5 6 5 5 3 4 6 4 6 3 1 3 1 2 5 6 6 6 2 3 6 2 2 2 2 3 
775 5 6 5 5 3 4 6 4 6 3 1 3 1 2 5 6 6 6 2 3 6 2 2 2 1 4 
775 5 6 5 5 3 4 6 4 6 3 1 3 1 2 5 6 6 6 2 3 6 2 2 2 5 
775 5 6 5 5 3 4 6 4 6 3 1 3 1 2 5 6 6 6 2 3 6 2 2 2 5 
775 5 6 5 5 3 4 6 4 6 3 1 3 1 2 5 6 6 6 2 3 6 2 2 2 5 
775 5 6 5 5 3 4 6 4 6 3 1 3 1 2 5 6 6 6 2 3 6 2 2 2 5 
765 5 6 5 5 3 4 6 4 6 3 1 3 1 2 5 6 4 4 4 5 3 6 6 2 2 1 2 3 
765 5 6 5 5 3 4 6 4 6 3 1 3 1 2 5 6 6 6 2 3 6 2 2 1 6 
765 5 6 5 5 3 4 6 4 6 3 1 3 1 2 5 6 6 6 2 3 6 2 2 1 6 
750 5 6 5 5 3 4 6 4 6 3 1 3 1 2 5 6 6 6 2 3 6 2 2 2 4 
750 5 6 5 5 3 4 6 4 6 3 1 3 1 2 5 6 6 6 2 3 6 2 2 2 4 
750 5 6 5 5 3 4 6 4 6 3 1 3 1 2 5 6 6 6 2 3 6 2 2 2 4 
750 5 6 5 5 3 4 6 4 6 3 1 3 1 2 5 6 6 6 2 3 6 2 2 1 5 
750 5 6 5 5 3 4 6 4 6 3 1 3 1 2 5 6 6 6 2 3 6 2 2 1 5 
740 5 6 5 5 3 4 6 4 6 3 1 3 1 2 5 6 6 6 2 3 6 2 2 6 
740 5 6 5 5 3 4 6 4 6 3 1 3 1 2 5 6 6 6 2 3 6 2 2 6 
740 5 6 5 5 3 4 6 4 6 3 1 3 1 2 5 6 6 6 2 3 6 2 2 6 
740 5 6 5 5 3 4 6 4 6 3 1 3 1 2 5 6 6 6 2 3 6 2 2 6 
740 5 6 5 5 3 4 6 4 6 3 1 3 1 2 5 6 6 6 2 3 6 2 2 6 
740 5 6 5 5 3 4 6 4 6 3 1 3 1 2 5 6 6 6 2 3 6 2 2 6 
740 5 6 5 5 3 4 6 4 6 3 1 3 1 2 5 6 6 6 2 3 6 2 2 6 
730 5 6 5 5 3 4 6 4 6 3 1 3 1 2 5 6 6 6 2 3 6 2 2 2 3 
730 5 6 5 5 3 4 6 4 6 3 1 3 1 2 5 6 6 6 2 3 6 2 2 2 3 
730 5 6 5 5 3 4 6 4 6 3 1 3 1 2 5 6 6 6 2 3 6 2 2 2 3 
730 5 6 5 5 3 4 6 4 6 3 1 3 1 2 5 6 6 6 2 3 6 2 2 2 3 
730 5 6 5 5 3 4 6 4 6 3 1 3 1 2 5 6 6 6 2 3 6 2 2 2 3 
730 5 6 5 5 3 4 6 4 6 3 1 3 1 2 5 6 6 6 2 3 6 2 2 2 3 
725 5 6 5 5 3 4 6 4 6 3 1 3 1 2 5 6 6 6 2 3 6 2 2 5 
725 5 6 5 5 3 4 6 4 6 3 1 3 1 2 5 6 6 6 2 3 6 2 2 1 4 
725 5 6 5 5 3 4 6 4 6 3 1 3 1 2 5 6 6 6 2 3 6 2 2 5 
725 5 6 5 5 3 4 6 4 6 3 1 3 1 2 5 6 6 6 2 3 6 2 2 1 4 
725 5 6 5 5 3 4 6 4 6 3 1 3 1 2 5 6 6 6 2 3 6 2 2 1 4 
725 5 6 5 5 3 4 6 4 6 3 1 3 1 2 5 6 6 6 2 3 6 2 2 5 
725 5 6 5 5 3 4 6 4 6 3 1 3 1 2 5 6 6 6 2 3 6 2 2 5 
725 5 6 5 5 3 4 6 4 6 3 1 3 1 2 5 6 6 6 2 3 6 2 2 5 
725 5 6 5 5 3 4 6 4 6 3 1 3 1 2 5 6 6 6 2 3 6 2 2 5 
725 5 6 5 5 3 4 6 4 6 3 1 3 1 2 5 6 6 6 2 3 6 2 2 5 
715 5 6 5 5 3 4 6 4 6 3 1 3 1 2 5 6 6 6 2 3 6 2 1 6 
710 5 6 5 5 3 4 6 4 6 3 1 3 1 2 5 6 6 6 2 6 2 1 6 
710 5 6 5 5 3 4 6 4 6 3 1 3 1 2 5 6 6 5 2 6 2 2 2 3 
705 5 6 5 5 3 4 6 4 6 3 1 3 1 2 5 6 6 6 2 3 6 2 2 1 3 
705 5 6 5 5 3 4 6 4 6 3 1 3 1 2 5 6 6 6 2 3 6 2 2 1 3 
700 5 6 5 5 3 4 6 4 6 3 1 3 1 2 5 6 6 6 2 3 6 2 2 4 
700 5 6 5 5 3 4 6 4 6 3 1 3 1 2 5 6 6 6 2 3 6 2 2 4 
700 5 6 5 5 3 4 6 4 6 3 1 3 1 2 5 6 6 6 2 3 6 2 2 4 
700 5 6 5 5 3 4 6 4 6 3 1 3 1 2 5 6 6 6 2 3 6 2 2 4 
700 5 6 5 5 3 4 6 4 6 3 1 3 1 2 5 6 6 6 2 3 6 2 2 4 
700 5 6 5 5 3 4 6 4 6 3 1 3 1 2 5 6 6 6 2 3 6 2 1 5 
700 5 6 5 5 3 4 6 4 6 3 1 3 1 2 5 6 6 6 2 3 6 2 2 4 
700 5 6 5 5 3 4 6 4 6 3 1 3 1 2 5 6 6 6 2 3 6 2 2 4 
700 5 6 5 5 3 4 6 4 6 3 1 3 1 2 5 6 6 6 2 3 6 2 2 4 
695 5 6 5 5 3 4 6 4 6 3 1 3 1 2 5 6 6 6 2 6 1 2 5 
690 5 6 5 5 3 4 6 4 6 3 1 3 1 2 5 6 6 6 2 3 6 2 6 
690 5 6 5 5 3 4 6 4 6 3 1 3 1 2 5 6 6 6 2 3 6 2 6 
685 5 6 5 5 3 4 6 4 6 3 1 3 1 2 5 6 6 6 2 2 2 1 2 3 
680 5 6 5 5 3 4 6 4 6 3 1 3 1 2 5 6 6 6 2 3 6 2 2 3 
680 5 6 5 5 3 4 6 4 6 3 1 3 1 2 5 6 6 6 2 3 6 2 2 3 
675 5 6 5 5 3 4 6 4 6 3 1 3 1 2 5 6 6 6 2 3 6 2 1 4 
675 5 6 5 5 3 4 6 4 6 3 1 3 1 2 5 6 6 6 2 3 6 2 5 
675 5 6 5 5 3 4 6 4 6 3 1 3 1 2 5 6 6 6 2 3 6 2 5 
670 5 6 5 5 3 4 6 4 6 3 1 3 1 2 5 6 6 6 2 6 2 1 4 
655 5 6 5 5 3 4 6 4 6 3 1 3 1 2 5 6 6 6 2 3 6 2 1 3 
655 5 6 5 5 3 4 6 4 6 3 1 3 1 2 5 6 6 6 2 3 6 2 1 3 
650 5 6 5 5 3 4 6 4 6 3 1 3 1 2 5 6 6 6 2 3 6 2 4 
650 5 6 5 5 3 4 6 4 6 3 1 3 1 2 5 6 6 6 2 3 6 2 4 
650 5 6 5 5 3 4 6 4 6 3 1 3 1 2 5 6 6 6 2 3 6 2 4 
650 5 6 5 5 3 4 6 4 6 3 1 3 1 2 5 6 6 6 2 3 6 2 4 
645 5 6 5 5 3 4 6 4 6 3 1 3 1 2 5 6 6 6 2 6 2 4 
630 5 6 5 5 3 4 6 4 6 3 1 3 1 2 5 6 6 6 2 3 6 2 3 
630 5 6 5 5 3 4 6 4 6 3 1 3 1 2 5 6 6 6 2 3 6 2 3 
630 5 6 5 5 3 4 6 4 6 3 1 3 1 2 5 6 6 6 2 3 6 2 3 
625 5 6 5 5 3 4 6 4 6 3 1 3 1 2 5 6 6 6 2 6 2 3 
625 5 6 5 5 3 4 6 4 6 3 1 3 1 2 5 6 6 6 2 3 6 5 
625 5 6 5 5 3 4 6 4 6 3 1 3 1 2 5 6 6 6 2 3 6 1 4 
600 5 6 5 5 3 4 6 4 6 3 1 3 1 2 5 6 6 6 2 3 6 4 
575 5 6 5 5 3 4 6 4 6 3 1 3 1 2 5 6 6 6 2 6 3 
