210 5 6 5 5 5 4 4 4 1 5 4 1 2 2 1 
130 5 6 5 5 5 4 4 5 6 
130 5 6 5 5 5 4 4 2 6 
120 5 6 5 5 5 5 3 2 5 
115 5 6 5 5 5 4 4 2 5 
115 5 6 5 5 5 4 4 5 5 
105 5 6 5 5 5 4 5 6 
95 5 6 5 5 5 4 4 4 3 3 2 4 4 
90 5 6 5 5 5 5 5 1 
90 5 6 5 5 5 4 5 5 
90 5 6 5 5 5 4 4 2 1 
90 5 6 5 5 5 4 4 2 4 
70 5 6 5 5 5 4 2 3 4 
70 5 6 5 5 5 4 4 5 3 
70 5 6 5 5 5 4 4 5 3 
65 5 6 5 5 5 4 5 4 
65 5 6 5 5 5 4 5 1 
50 5 6 5 5 5 4 4 3 3 1 3 
40 5 6 5 5 5 4 4 3 5 3 2 4 
0 5 6 5 5 5 4 3 3 
0 5 6 5 5 5 4 3 3 
-35 5 6 5 5 5 4 
-70 5 6 5 5 5 4 4 4 4 5 6 
-85 5 6 5 5 5 4 4 4 4 5 5 2 
-85 5 6 5 5 5 4 4 4 4 5 5 
-85 5 6 5 5 5 4 4 
-85 5 6 5 5 5 4 4 2 
-85 5 6 5 5 5 4 4 
-85 5 6 5 5 5 4 4 2 
-85 5 6 5 5 5 4 4 2 
-85 5 6 5 5 5 4 4 2 
-85 5 6 5 5 5 4 4 
-85 5 6 5 5 5 4 
-85 5 6 5 5 5 4 
-85 5 6 5 5 5 4 4 
-85 5 6 5 5 5 4 4 2 
-85 5 6 5 5 5 4 
-85 5 6 5 5 5 4 
-85 5 6 5 5 5 4 4 2 
-85 5 6 5 5 5 4 4 2 
-85 5 6 5 5 5 4 4 
-85 5 6 5 5 5 4 4 2 
-85 5 6 5 5 5 4 
-85 5 6 5 5 5 4 
-85 5 6 5 5 5 4 4 2 
-85 5 6 5 5 5 4 4 2 
-85 5 6 5 5 5 4 
-85 5 6 5 5 5 4 4 4 4 5 5 
