805 6 5 5 5 6 4 3 4 6 2 2 3 6 5 5 5 5 4 3 4 6 2 2 2 6 
805 6 5 5 5 6 4 3 4 6 2 2 3 6 5 5 5 5 4 3 4 6 2 2 2 6 
790 6 5 5 5 6 4 3 4 6 2 2 3 6 5 5 5 5 4 3 4 6 2 2 2 5 
790 6 5 5 5 6 4 3 4 6 2 2 3 6 5 5 5 5 4 3 4 6 2 2 2 5 
790 6 5 5 5 6 4 3 4 6 2 2 3 6 5 5 5 5 4 3 4 6 2 2 2 5 
790 6 5 5 5 6 4 3 4 6 2 2 3 6 5 5 5 5 4 3 4 6 2 2 2 5 
780 6 5 5 5 6 4 3 4 6 2 2 3 6 5 5 5 5 4 3 4 6 2 2 1 6 
780 6 5 5 5 6 4 3 4 6 2 2 3 6 5 5 5 5 4 3 4 6 2 2 1 6 
765 6 5 5 5 6 4 3 4 6 2 2 3 6 5 5 5 5 4 3 4 6 2 2 1 5 
765 6 5 5 5 6 4 3 4 6 2 2 3 6 5 5 5 5 4 3 4 6 2 2 1 2 4 
755 6 5 5 5 6 4 3 4 6 2 2 3 6 5 5 5 5 4 3 4 6 2 2 6 
755 6 5 5 5 6 4 3 4 6 2 2 3 6 5 5 5 5 4 3 4 6 2 2 6 
755 6 5 5 5 6 4 3 4 6 2 2 3 6 5 5 5 5 4 3 4 6 2 2 6 
755 6 5 5 5 6 4 3 4 6 2 2 3 6 5 5 5 5 4 3 4 6 2 2 6 
745 6 5 5 5 6 4 3 4 6 2 2 3 6 5 5 5 5 4 3 4 6 2 2 2 3 
745 6 5 5 5 6 4 3 4 6 2 2 3 6 5 5 5 5 4 3 4 6 2 2 2 3 
740 6 5 5 5 6 4 3 4 6 2 2 3 6 5 5 5 5 4 3 4 6 2 2 5 
740 6 5 5 5 6 4 3 4 6 2 2 3 6 5 5 5 5 4 3 4 6 2 2 1 1 4 
740 6 5 5 5 6 4 3 4 6 2 2 3 6 5 5 5 5 4 3 4 6 2 2 5 
740 6 5 5 5 6 4 3 4 6 2 2 3 6 5 5 5 5 4 3 4 6 2 2 5 
740 6 5 5 5 6 4 3 4 6 2 2 3 6 5 5 5 5 4 3 4 6 2 2 5 
740 6 5 5 5 6 4 3 4 6 2 2 3 6 5 5 5 5 4 3 4 6 2 2 5 
740 6 5 5 5 6 4 3 4 6 2 2 3 6 5 5 5 5 4 3 4 6 2 2 5 
715 6 5 5 5 6 4 3 4 6 2 2 3 6 5 5 5 5 4 3 4 6 2 2 4 
715 6 5 5 5 6 4 3 4 6 2 2 3 6 5 5 5 5 4 3 4 6 2 2 4 
705 6 5 5 5 6 4 3 4 6 2 2 3 6 5 5 5 5 4 3 4 6 2 6 
705 6 5 5 5 6 4 3 4 6 2 2 3 6 5 5 5 5 4 3 4 6 2 6 
705 6 5 5 5 6 4 3 4 6 2 2 3 6 5 5 5 5 4 3 4 6 2 6 
705 6 5 5 5 6 4 3 4 6 2 2 3 6 5 5 5 5 4 3 4 6 2 6 
705 6 5 5 5 6 4 3 4 6 2 2 3 6 5 5 5 5 4 3 4 6 2 6 
705 6 5 5 5 6 4 3 4 6 2 2 3 6 5 5 5 5 4 3 4 6 2 6 
695 6 5 5 5 6 4 3 4 6 2 2 3 6 5 5 5 5 4 3 4 6 2 2 3 
695 6 5 5 5 6 4 3 4 6 2 2 3 6 5 5 5 5 4 3 4 6 2 2 3 
690 6 5 5 5 6 4 3 4 6 2 2 3 6 5 5 5 5 4 3 4 6 2 5 
690 6 5 5 5 6 4 3 4 6 2 2 3 6 5 5 5 5 4 3 4 6 2 5 
690 6 5 5 5 6 4 3 4 6 2 2 3 6 5 5 5 6 2 3 2 2 5 
690 6 5 5 5 6 4 3 4 6 2 2 3 6 5 5 6 6 6 1 2 5 
690 6 5 5 5 6 4 3 4 6 2 2 3 6 5 5 5 5 4 3 4 6 2 5 
690 6 5 5 5 6 4 3 4 6 2 2 3 6 5 5 5 5 4 3 4 6 2 5 
690 6 5 5 5 6 4 3 4 6 2 2 3 6 5 5 5 5 4 3 4 6 2 5 
685 6 5 5 5 6 4 3 4 6 2 2 3 6 5 5 6 4 2 5 2 1 5 
685 6 5 5 5 6 4 3 4 6 2 2 3 6 5 5 3 6 3 6 5 1 2 5 
675 6 5 5 5 6 4 3 4 6 2 2 3 6 5 5 5 5 1 6 2 6 
675 6 5 5 5 6 4 3 4 6 2 2 3 6 5 5 5 5 2 1 3 2 1 5 
665 6 5 5 5 6 4 3 4 6 2 2 3 6 5 5 5 5 4 3 4 6 2 4 
665 6 5 5 5 6 4 3 4 6 2 2 3 6 5 5 5 6 3 3 6 2 2 3 
665 6 5 5 5 6 4 3 4 6 2 2 3 6 5 5 5 5 4 3 4 6 2 4 
665 6 5 5 5 6 4 3 4 6 2 2 3 6 5 5 5 5 4 3 4 6 2 4 
665 6 5 5 5 6 4 3 4 6 2 2 3 6 5 5 5 5 4 3 4 6 2 4 
665 6 5 5 5 6 4 3 4 6 2 2 3 6 5 5 5 5 4 3 4 6 2 4 
665 6 5 5 5 6 4 3 4 6 2 2 3 6 5 5 5 5 4 3 4 6 2 4 
660 6 5 5 5 6 4 3 4 6 2 2 3 6 5 5 5 5 4 2 2 6 
660 6 5 5 5 6 4 3 4 6 2 2 3 6 5 5 5 4 6 2 2 5 
655 6 5 5 5 6 4 3 4 6 2 2 3 6 5 5 5 5 4 3 4 6 6 
655 6 5 5 5 6 4 3 4 6 2 2 3 6 5 5 5 3 4 4 5 6 6 
655 6 5 5 5 6 4 3 4 6 2 2 3 6 5 5 5 5 4 3 4 6 6 
645 6 5 5 5 6 4 3 4 6 2 2 3 6 5 5 5 5 4 3 4 6 1 1 3 
645 6 5 5 5 6 4 3 4 6 2 2 3 6 5 5 5 5 4 3 4 6 2 3 
645 6 5 5 5 6 4 3 4 6 2 2 3 6 5 5 5 5 4 3 4 6 2 3 
640 6 5 5 5 6 4 3 4 6 2 2 3 6 5 5 5 5 4 3 4 6 5 
640 6 5 5 5 6 4 3 4 6 2 2 3 6 5 5 5 5 4 3 4 6 5 
640 6 5 5 5 6 4 3 4 6 2 2 3 6 5 5 5 5 4 3 4 6 5 
640 6 5 5 5 6 4 3 4 6 2 2 3 6 5 5 5 5 4 3 4 6 5 
640 6 5 5 5 6 4 3 4 6 2 2 3 6 5 5 5 5 4 3 4 6 1 4 
640 6 5 5 5 6 4 3 4 6 2 2 3 6 5 5 5 5 4 3 4 6 5 
640 6 5 5 5 6 4 3 4 6 2 2 3 6 5 5 5 6 5 2 2 3 
635 6 5 5 5 6 4 3 4 6 2 2 3 6 5 4 3 5 6 5 3 6 5 
635 6 5 5 5 6 4 3 4 6 2 2 3 6 5 5 5 4 5 6 2 4 
630 6 5 5 5 6 4 3 4 6 2 2 3 6 5 5 5 5 4 3 4 2 2 3 
630 6 5 5 5 6 4 3 4 6 2 2 3 6 5 5 5 4 3 5 4 3 5 5 
625 6 5 5 5 6 4 3 4 6 2 2 3 6 5 5 5 4 4 4 4 1 3 1 1 1 5 
620 6 5 5 5 6 4 3 4 6 2 2 3 6 5 5 5 4 3 4 1 3 5 6 
615 6 5 5 5 6 4 3 4 6 2 2 3 6 5 5 5 5 4 3 4 6 4 
615 6 5 5 5 6 4 3 4 6 2 2 3 6 5 5 5 4 3 6 2 5 
615 6 5 5 5 6 4 3 4 6 2 2 3 6 5 5 5 5 4 3 4 6 4 
615 6 5 5 5 6 4 3 4 6 2 2 3 6 5 5 5 5 4 3 4 6 4 
605 6 5 5 5 6 4 3 4 6 2 2 3 6 5 5 3 4 3 3 3 6 4 2 5 
605 6 5 5 5 6 4 3 4 6 2 2 3 6 5 5 6 3 5 4 6 4 
605 6 5 5 5 6 4 3 4 6 2 2 3 6 5 5 5 6 5 3 6 
600 6 5 5 5 6 4 3 4 6 2 2 3 6 5 5 5 4 5 3 1 2 4 
595 6 5 5 5 6 4 3 4 6 2 2 3 6 5 5 5 5 4 3 4 6 3 
595 6 5 5 5 6 4 3 4 6 2 2 3 6 5 5 5 5 4 3 4 6 3 
595 6 5 5 5 6 4 3 4 6 2 2 3 6 5 5 5 5 4 3 4 6 3 
595 6 5 5 5 6 4 3 4 6 2 2 3 6 5 5 5 5 4 3 4 6 3 
595 6 5 5 5 6 4 3 4 6 2 2 3 6 5 5 5 5 4 3 4 6 3 
595 6 5 5 5 6 4 3 4 6 2 2 3 6 5 5 5 5 4 3 4 6 3 
595 6 5 5 5 6 4 3 4 6 2 2 3 6 5 5 5 5 3 4 4 6 3 
595 6 5 5 5 6 4 3 4 6 2 2 3 6 5 5 5 5 4 3 4 6 3 
590 6 5 5 5 6 4 3 4 6 2 2 3 6 5 5 5 6 2 2 3 
590 6 5 5 5 6 4 3 4 6 2 2 3 6 5 5 5 5 4 6 1 3 
580 6 5 5 5 6 4 3 4 6 2 2 3 6 5 5 5 5 5 3 5 3 
570 6 5 5 5 6 4 3 4 6 2 2 3 6 5 5 5 5 3 1 6 3 
560 6 5 5 5 6 4 3 4 6 2 2 3 6 5 5 5 3 5 3 4 1 1 3 
550 6 5 5 5 6 4 3 4 6 2 3 2 6 5 4 6 4 3 1 5 3 4 3 
530 6 5 5 5 6 4 3 4 6 2 2 3 6 5 3 1 5 6 6 3 1 
470 6 5 5 5 6 4 3 4 6 2 2 3 6 5 5 5 4 1 
450 6 5 5 5 6 4 3 4 6 2 2 3 6 5 3 1 5 2 
445 6 5 5 5 6 4 3 4 6 2 2 3 6 5 5 5 1 
435 6 5 5 5 6 4 3 4 6 2 2 3 6 5 4 6 1 
435 6 5 5 5 6 4 3 4 6 2 2 3 6 5 1 6 1 
420 6 5 5 5 6 4 3 4 6 2 2 3 6 5 5 2 
420 6 5 5 5 6 4 3 4 6 2 2 3 6 5 5 2 
420 6 5 5 5 6 4 3 4 6 2 2 3 6 5 5 2 
405 6 5 5 5 6 4 3 4 6 2 2 3 6 5 3 4 3 2 
400 6 5 5 5 6 4 3 4 6 2 2 3 6 5 3 1 2 
400 6 5 5 5 6 4 3 4 6 2 2 3 6 5 5 3 1 
395 6 5 5 5 6 4 3 4 6 2 2 3 6 5 5 4 
395 6 5 5 5 6 4 3 4 6 2 2 3 6 5 1 4 1 
395 6 5 5 5 6 4 3 4 6 2 2 3 6 5 4 5 
395 6 5 5 5 6 4 3 4 6 2 2 3 6 5 4 5 
395 6 5 5 5 6 4 3 4 6 2 2 3 6 5 4 5 
395 6 5 5 5 6 4 3 4 6 2 2 3 6 5 5 4 
395 6 5 5 5 6 4 3 4 6 2 2 3 6 5 1 5 
395 6 5 5 5 6 4 3 4 6 2 2 3 6 5 1 2 
385 6 5 5 5 6 4 3 4 6 2 2 3 6 6 5 
385 6 5 5 5 6 4 3 4 6 2 2 3 6 5 6 
375 6 5 5 5 6 4 3 4 6 5 3 2 5 6 3 1 1 
370 6 5 5 5 6 4 3 4 6 2 2 3 6 5 2 
370 6 5 5 5 6 4 3 4 6 2 2 3 6 5 2 
345 6 5 5 5 6 4 3 4 6 2 2 3 6 6 3 3 
320 6 5 5 5 6 4 3 4 6 2 2 3 6 2 
320 6 5 5 5 6 4 3 4 6 2 2 3 6 2 
305 6 5 5 5 5 4 4 5 5 2 4 1 6 1 
295 6 5 5 5 6 4 3 4 6 2 2 3 6 4 
295 6 5 5 5 6 4 3 4 6 2 2 3 6 4 
275 6 5 5 5 6 4 3 4 6 2 2 3 6 3 
275 6 5 5 5 6 4 3 4 6 2 2 3 6 3 
-45 6 5 5 5 6 4 3 4 6 2 2 3 4 4 
