175 4 1 6 5 5 6 4 4 6 2 3 1 6 
120 4 1 6 5 5 6 4 2 6 
120 4 1 6 5 5 6 4 2 6 
120 4 1 6 5 5 6 4 2 6 
120 4 1 6 5 5 6 4 2 6 
110 4 1 6 5 5 6 6 6 
110 4 1 6 5 5 6 4 3 5 2 
105 4 1 6 5 5 6 4 2 5 
105 4 1 6 5 5 6 4 5 2 
105 4 1 6 5 5 6 4 2 5 
105 4 1 6 5 5 6 4 2 5 
105 4 1 6 5 5 6 4 2 2 
105 4 1 6 5 5 6 4 2 2 
100 4 1 6 5 5 6 3 5 6 
95 4 1 6 5 5 6 5 6 
95 4 1 6 5 5 6 4 1 6 
95 4 1 6 5 5 6 2 6 
90 4 1 6 5 5 5 5 5 1 
90 4 1 6 5 5 6 3 4 4 3 2 
80 4 1 6 5 5 6 5 2 
80 4 1 6 5 5 6 4 2 4 
80 4 1 6 5 5 6 4 1 2 
80 4 1 6 5 5 6 2 2 
80 4 1 6 5 5 6 3 4 3 6 
80 4 1 6 5 5 6 4 2 1 
80 4 1 6 5 5 6 4 4 5 
80 4 1 6 5 5 6 4 2 1 
80 4 1 6 5 5 6 4 5 4 
80 4 1 6 5 5 6 4 2 1 
75 4 1 6 5 5 6 4 2 1 6 
75 4 1 6 5 5 6 4 3 6 
70 4 1 6 5 5 6 4 6 
70 4 1 6 5 5 6 4 6 
70 4 1 6 5 5 6 4 6 
70 4 1 6 5 5 6 4 6 
70 4 1 6 5 5 6 6 4 
70 4 1 6 5 5 6 4 6 
70 4 1 6 5 5 6 6 4 
65 4 1 6 5 5 6 4 3 3 5 
65 4 1 6 5 5 6 4 4 3 3 4 
60 4 1 6 5 5 6 4 5 3 
60 4 1 6 5 5 6 4 2 3 
60 4 1 6 5 5 6 4 2 3 
60 4 1 6 5 5 6 3 1 1 1 
60 4 1 6 5 5 6 4 2 3 
60 4 1 6 5 5 6 4 2 3 
55 4 1 6 5 5 6 4 1 4 
55 4 1 6 5 5 6 2 1 
55 4 1 6 5 5 6 4 1 1 
55 4 1 6 5 5 6 2 4 
55 4 1 6 5 5 6 4 1 1 
40 4 1 6 5 5 6 3 5 3 
40 4 1 6 5 5 6 3 5 3 
35 4 1 6 5 5 6 4 1 3 
5 4 1 6 5 5 6 1 
5 4 1 6 5 5 6 1 
5 4 1 6 5 5 6 1 
5 4 1 6 5 5 6 1 
5 4 1 6 5 5 6 1 
-10 4 1 6 5 5 4 2 
-10 4 1 6 5 5 5 1 
-35 4 1 6 5 5 2 
-85 4 1 6 5 2 
-85 4 1 6 5 2 
