725 4 4 6 5 5 6 4 5 5 1 2 1 3 5 3 6 4 5 6 4 6 1 2 1 6 
710 4 4 6 5 5 6 4 5 5 1 2 1 3 5 3 6 4 5 6 4 6 1 2 1 5 
685 4 4 6 5 5 6 4 5 5 1 2 1 3 5 3 6 4 5 6 4 6 1 2 1 1 3 
685 4 4 6 5 5 6 4 5 5 1 2 1 3 5 3 6 4 5 6 4 6 1 2 5 
675 4 4 6 5 5 6 4 5 5 1 2 1 3 5 3 6 4 5 6 4 6 2 6 
675 4 4 6 5 5 6 4 5 5 1 2 1 3 5 3 6 4 5 6 4 6 2 6 
665 4 4 6 5 5 6 4 5 5 1 2 1 3 5 3 6 4 5 6 4 6 1 1 2 3 
660 4 4 6 5 5 6 4 5 5 1 2 1 3 5 3 6 4 5 6 4 6 1 1 5 
660 4 4 6 5 5 6 4 5 5 1 2 1 3 5 3 6 4 5 6 4 6 1 2 4 
660 4 4 6 5 5 6 4 5 5 1 2 1 3 5 3 6 4 5 6 4 6 1 2 4 
650 4 4 6 5 5 6 4 5 5 1 2 1 3 5 3 6 4 5 6 4 6 1 6 
650 4 4 6 5 5 6 4 5 5 1 2 1 3 5 3 6 4 5 6 4 6 1 6 
650 4 4 6 5 5 6 4 5 5 1 2 1 3 5 3 6 4 5 6 4 6 1 6 
640 4 4 6 5 5 6 4 5 5 1 2 1 3 5 3 6 4 5 6 4 4 3 2 6 
635 4 4 6 5 5 6 4 5 5 1 2 1 3 5 3 6 4 5 6 4 6 1 5 
635 4 4 6 5 5 6 4 5 5 1 2 1 3 5 3 6 4 5 6 4 6 2 4 
635 4 4 6 5 5 6 4 5 5 1 2 1 3 5 3 6 4 5 6 4 6 1 5 
625 4 4 6 5 5 6 4 5 5 1 2 1 3 5 3 6 4 5 6 4 6 6 
620 4 4 6 5 5 6 4 5 5 1 2 1 3 5 3 6 4 5 6 4 5 2 4 
615 4 4 6 5 5 6 4 5 5 1 2 1 3 5 3 6 4 5 6 4 6 2 3 
615 4 4 6 5 5 6 4 5 5 1 2 1 3 5 3 6 4 5 6 4 6 1 1 3 
615 4 4 6 5 5 6 4 5 5 1 2 1 3 5 3 6 4 5 6 4 6 1 1 3 
610 4 4 6 5 5 6 4 5 5 1 2 1 3 5 3 6 4 5 6 4 6 5 
600 4 4 6 5 5 6 4 5 5 1 2 1 3 5 3 6 4 5 6 4 2 1 1 3 
590 4 4 6 5 5 6 4 5 5 1 2 1 3 5 3 6 4 5 6 4 6 1 3 
590 4 4 6 5 5 6 4 5 5 1 2 1 3 5 3 6 4 5 6 4 6 1 3 
590 4 4 6 5 5 6 4 5 5 1 2 1 3 5 3 6 4 5 6 4 6 1 3 
565 4 4 6 5 5 6 4 5 5 1 2 1 3 5 3 6 4 5 6 4 6 3 
565 4 4 6 5 5 6 4 5 5 1 2 1 3 5 3 6 4 5 6 4 6 3 
550 4 4 6 5 5 6 4 5 5 1 2 1 3 5 3 6 4 5 6 4 5 3 
