-10 6 5 5 3 5 5 1 
-115 6 5 5 3 6 5 1 
-135 6 5 5 3 6 
-135 6 5 5 3 6 
-135 6 5 5 3 6 4 
-135 6 5 5 3 6 4 1 
-135 6 5 5 3 6 
-135 6 5 5 3 4 
-135 6 5 5 3 6 4 
-135 6 5 5 3 6 4 1 
-135 6 5 5 3 6 4 
-135 6 5 5 3 6 
-135 6 5 5 3 
-185 6 5 5 3 6 4 1 4 4 3 3 3 4 2 4 5 5 
-185 6 5 5 3 6 4 1 4 4 3 3 3 4 2 4 5 5 
-185 6 5 5 3 6 4 1 4 4 3 3 3 4 2 4 5 5 
-185 6 5 5 3 6 4 1 4 4 3 3 3 4 2 4 5 5 
-185 6 5 5 3 6 4 1 4 4 3 3 3 4 2 4 
-185 6 5 5 3 6 4 1 4 4 3 3 3 4 2 4 
-185 6 5 5 3 6 4 1 4 4 3 3 3 4 2 4 5 
-185 6 5 5 3 6 4 1 4 4 3 3 3 4 2 4 
-185 6 5 5 3 6 4 1 4 4 3 3 3 4 2 4 5 
-185 6 5 5 3 6 4 1 4 4 3 3 3 4 2 4 
-185 6 5 5 3 6 4 1 4 4 3 3 3 4 2 4 5 5 
-185 6 5 5 3 6 4 1 4 4 3 3 3 4 2 4 
-185 6 5 5 3 6 4 1 4 4 3 3 3 4 2 4 5 
-185 6 5 5 3 6 4 1 4 4 3 3 3 4 2 4 5 
-185 6 5 5 3 6 4 1 4 4 3 3 3 4 2 4 
-185 6 5 5 3 6 4 1 4 4 3 3 3 4 2 4 5 5 
-185 6 5 5 3 6 4 1 4 4 3 3 3 4 2 4 5 5 
-185 6 5 5 3 6 4 1 4 4 3 3 3 4 2 4 5 
-185 6 5 5 3 6 4 1 
-185 6 5 5 3 6 4 
-185 6 5 5 3 6 4 1 4 
-185 6 5 5 3 6 4 
-185 6 5 5 3 6 4 1 
-185 6 5 5 3 6 4 1 4 4 3 3 3 4 2 4 
-185 6 5 5 3 6 4 1 4 4 3 3 3 4 2 4 5 5 
-185 6 5 5 3 6 4 1 4 4 3 3 3 4 2 4 
-185 6 5 5 3 6 4 1 4 4 3 3 3 4 2 4 5 
-185 6 5 5 3 6 4 1 4 4 3 3 3 4 2 4 5 
-185 6 5 5 3 6 4 1 4 4 3 3 3 4 2 4 5 5 
-185 6 5 5 3 6 4 1 4 4 3 3 3 4 2 4 
-210 6 5 5 3 6 4 1 
-215 6 5 5 3 6 4 1 
-215 6 5 5 3 1 
-215 6 5 5 3 6 4 2 
-215 6 5 5 3 6 4 2 
