380 4 1 6 5 5 6 4 4 6 2 2 6 3 6 5 
335 4 1 6 5 5 6 4 4 6 2 3 1 1 3 5 3 5 1 2 
325 4 1 6 5 5 6 4 4 6 2 3 1 4 5 4 2 
325 4 1 6 5 5 6 4 4 6 2 3 1 1 1 5 2 
315 4 1 6 5 5 6 4 4 6 2 3 1 4 6 2 
305 4 1 6 5 5 6 4 4 6 2 4 3 4 3 5 5 
300 4 1 6 5 5 6 4 4 6 2 1 1 3 5 5 
290 4 1 6 5 5 6 4 4 6 2 3 1 5 6 
285 4 1 6 5 5 6 4 4 6 2 5 6 1 
280 4 1 6 5 5 6 4 4 6 2 3 4 3 3 6 3 4 
275 4 1 6 5 5 6 4 4 6 2 3 1 2 5 
275 4 1 6 5 5 6 4 4 6 2 3 1 3 1 3 6 
275 4 1 6 5 5 6 4 4 6 2 3 1 2 5 
275 4 1 6 5 5 6 4 4 6 2 1 2 3 2 
275 4 1 6 5 5 6 4 4 6 2 3 1 5 5 
275 4 1 6 5 5 6 4 5 6 3 1 4 5 2 
270 4 1 6 5 5 6 4 4 6 2 5 4 2 
270 4 1 6 5 5 6 4 4 6 2 3 4 4 6 3 
255 4 1 6 5 5 5 5 5 6 1 1 5 4 
255 4 1 6 5 5 6 4 5 5 5 2 5 
250 4 1 6 5 5 6 4 4 6 2 3 5 5 
250 4 1 6 5 5 6 4 4 6 2 3 2 5 
250 4 1 6 5 5 6 4 4 6 2 3 1 5 4 
250 4 1 6 5 5 6 4 4 6 2 3 1 2 1 
245 4 1 6 5 5 6 4 4 6 2 4 1 5 
245 4 1 6 5 5 6 4 4 6 2 4 1 5 
240 4 1 6 5 5 6 4 4 6 2 4 3 6 
240 4 1 6 5 5 6 4 4 6 2 3 6 1 
235 4 1 6 5 5 6 4 4 6 2 3 1 3 3 5 
235 4 1 6 5 5 6 4 4 6 2 1 6 
230 4 1 6 5 5 6 4 4 6 2 3 3 4 2 
230 4 1 6 5 5 6 4 4 6 2 3 4 3 5 
230 4 1 6 5 5 6 4 4 6 2 3 1 3 5 
230 4 1 6 5 5 6 4 4 6 2 3 4 2 3 
230 4 1 6 5 5 6 4 4 6 2 3 1 3 5 
230 4 1 6 5 5 6 4 4 6 2 3 1 4 1 3 
120 4 1 6 5 5 6 4 2 6 
110 4 1 6 5 5 6 3 4 2 5 
105 4 1 6 5 5 6 4 2 2 
95 4 1 6 5 5 6 6 5 
95 4 1 6 5 5 6 6 2 
95 4 1 6 5 5 6 6 5 
90 4 1 6 5 5 6 3 4 4 3 2 
80 4 1 6 5 5 6 4 5 4 
80 4 1 6 5 5 6 4 1 2 
80 4 1 6 5 5 6 2 2 
80 4 1 6 5 5 6 4 4 5 
80 4 1 6 5 5 6 2 5 
80 4 1 6 5 5 6 4 2 4 
80 4 1 6 5 5 6 4 4 2 
80 4 1 6 5 5 6 4 2 1 
80 4 1 6 5 5 6 4 2 4 
80 4 1 6 5 5 6 4 5 4 
80 4 1 6 5 5 6 5 5 
75 4 1 6 5 5 6 3 6 4 
75 4 1 6 5 5 6 4 3 6 
75 4 1 6 5 5 6 3 6 1 
60 4 1 6 5 5 6 4 2 3 
60 4 1 6 5 5 6 2 3 4 
60 4 1 6 5 5 6 3 1 1 4 
55 4 1 6 5 5 6 5 4 
5 4 1 6 5 5 6 1 
-60 4 1 6 5 5 4 
-300 4 1 6 5 5 6 4 2 
