60 6 5 5 3 1 5 6 
60 6 5 5 5 3 4 6 5 6 
5 6 5 5 3 4 6 
-35 6 5 5 3 5 5 5 4 
-70 6 5 5 6 
-70 6 5 5 6 
-85 6 5 5 2 
-85 6 5 5 2 
-95 6 5 5 3 6 
-95 6 5 5 3 5 6 
-120 6 5 6 
-130 6 5 5 3 
-130 6 5 5 3 
-130 6 5 5 3 
-130 6 5 5 3 
-130 6 5 5 3 
-130 6 5 5 3 6 
-135 6 5 5 3 6 5 4 
-135 6 5 5 3 6 4 4 
-135 6 5 5 3 6 4 1 
-155 6 5 5 3 3 
-215 6 5 5 3 5 5 1 
-215 6 5 5 3 6 1 
-250 6 5 5 3 6 4 1 4 4 3 3 3 4 2 
-250 6 5 5 3 6 4 1 4 4 3 3 3 4 2 
-250 6 5 5 3 6 4 1 4 4 3 3 3 4 
-250 6 5 5 3 6 4 1 4 4 3 3 3 4 2 
-250 6 5 5 3 
-250 6 5 5 3 5 
-250 6 5 5 3 5 
-250 6 5 5 3 5 5 
-250 6 5 5 3 5 
-250 6 5 5 3 5 
-250 6 5 5 3 5 
-250 6 5 5 3 5 5 
-250 6 5 5 3 
-250 6 5 5 3 5 5 
-250 6 5 5 3 
-250 6 5 5 3 5 5 
-250 6 5 5 3 
-250 6 5 5 3 5 
-250 6 5 5 3 5 5 
-250 6 5 5 3 5 5 
-250 6 5 5 3 5 
-250 6 5 5 3 
-250 6 5 5 3 5 
-250 6 5 5 3 6 4 1 4 4 3 3 3 4 
-250 6 5 5 3 6 4 1 4 4 3 3 3 4 2 4 5 
