1525 5 6 5 5 3 4 6 4 6 3 1 3 1 2 5 6 6 6 2 3 6 2 2 2 2 2 3 6 6 4 6 6 2 3 1 4 6 6 6 6 4 5 
1515 5 6 5 5 3 4 6 4 6 3 1 3 1 2 5 6 6 6 2 3 6 2 2 2 2 2 3 6 6 4 6 6 2 3 1 4 6 6 6 6 6 
1510 5 6 5 5 3 4 6 4 6 3 1 3 1 2 5 6 6 6 2 3 6 2 2 2 2 2 3 6 6 4 6 6 2 3 1 4 6 6 4 5 6 1 1 
1505 5 6 5 5 3 4 6 4 6 3 1 3 1 2 5 6 6 6 2 3 6 2 2 2 2 2 3 6 6 4 6 6 2 3 1 4 6 6 6 6 1 3 4 
1465 5 6 5 5 3 4 6 4 6 3 1 3 1 2 5 6 6 6 2 3 6 2 2 2 2 2 3 6 6 4 6 6 2 3 1 4 6 6 6 3 4 5 
1460 5 6 5 5 3 4 6 4 6 3 1 3 1 2 5 6 6 6 2 3 6 2 2 2 2 2 3 6 6 4 6 6 2 3 1 4 6 6 4 2 6 
1455 5 6 5 5 3 4 6 4 6 3 1 3 1 2 5 6 6 6 2 3 6 2 2 2 2 2 3 6 6 4 6 6 2 3 1 4 6 5 1 5 2 4 
1455 5 6 5 5 3 4 6 4 6 3 1 3 1 2 5 6 6 6 2 3 6 2 2 2 2 2 3 6 6 4 6 6 2 3 1 4 6 6 6 3 6 
1455 5 6 5 5 3 4 6 4 6 3 1 3 1 2 5 6 6 6 2 3 6 2 2 2 2 2 3 6 6 4 6 6 2 3 1 4 6 6 6 6 3 
1455 5 6 5 5 3 4 6 4 6 3 1 3 1 2 5 6 6 6 2 3 6 2 2 2 2 2 3 6 6 4 6 6 2 3 1 4 6 6 6 6 3 
1455 5 6 5 5 3 4 6 4 6 3 1 3 1 2 5 6 6 6 2 3 6 2 2 2 2 2 3 6 6 4 6 6 2 3 1 4 6 6 6 6 3 
1455 5 6 5 5 3 4 6 4 6 3 1 3 1 2 5 6 6 6 2 3 6 2 2 2 2 2 3 6 6 4 6 6 2 3 1 4 6 5 3 3 5 2 2 
1455 5 6 5 5 3 4 6 4 6 3 1 3 1 2 5 6 6 6 2 3 6 2 2 2 2 2 3 6 6 4 6 6 2 3 1 4 6 6 6 6 3 
1455 5 6 5 5 3 4 6 4 6 3 1 3 1 2 5 6 6 6 2 3 6 2 2 2 2 2 3 6 6 4 6 6 2 3 1 4 6 6 6 3 6 
1455 5 6 5 5 3 4 6 4 6 3 1 3 1 2 5 6 6 6 2 3 6 2 2 2 2 2 3 6 6 4 6 6 2 3 1 4 6 6 6 3 6 
1445 5 6 5 5 3 4 6 4 6 3 1 3 1 2 5 6 6 6 2 3 6 2 2 2 2 2 3 6 6 4 6 5 1 4 1 4 6 6 6 5 
1440 5 6 5 5 3 4 6 4 6 3 1 3 1 2 5 6 6 6 2 3 6 2 2 2 2 2 3 6 6 4 6 6 2 3 1 4 6 6 6 3 5 
1440 5 6 5 5 3 4 6 4 6 3 1 3 1 2 5 6 6 6 2 3 6 2 2 2 2 2 3 6 6 4 6 6 2 3 1 4 6 6 6 3 5 
1440 5 6 5 5 3 4 6 4 6 3 1 3 1 2 5 6 6 6 2 3 6 2 2 2 2 2 3 6 6 4 6 6 2 3 1 4 6 6 6 3 2 
1440 5 6 5 5 3 4 6 4 6 3 1 3 1 2 5 6 6 6 2 3 6 2 2 2 2 2 3 6 6 4 6 6 2 3 1 4 6 6 6 3 5 
1440 5 6 5 5 3 4 6 4 6 3 1 3 1 2 5 6 6 6 2 3 6 2 2 2 2 2 3 6 6 4 6 6 2 3 1 4 6 6 6 3 2 
1440 5 6 5 5 3 4 6 4 6 3 1 3 1 2 5 6 6 6 2 3 6 2 2 2 2 2 3 6 6 4 6 6 2 3 1 4 6 6 6 3 5 
1435 5 6 5 5 3 4 6 4 6 3 1 3 1 2 5 6 6 6 2 3 6 2 2 2 2 2 3 6 6 4 6 6 2 3 1 4 6 6 6 5 
1435 5 6 5 5 3 4 6 4 6 3 1 3 1 2 5 6 6 6 2 3 6 2 2 2 2 2 3 6 6 4 6 6 2 3 1 4 6 6 6 5 
1435 5 6 5 5 3 4 6 4 6 3 1 3 1 2 5 6 6 6 2 3 6 2 2 2 2 2 3 6 6 4 6 6 2 3 1 4 6 6 6 5 
1435 5 6 5 5 3 4 6 4 6 3 1 3 1 2 5 6 6 6 2 3 6 2 2 2 2 2 3 6 6 4 6 6 2 3 1 4 6 6 6 2 
1435 5 6 5 5 3 4 6 4 6 3 1 3 1 2 5 6 6 6 2 3 6 2 2 2 2 2 3 6 6 4 6 6 2 3 1 4 6 6 6 2 
1435 5 6 5 5 3 4 6 4 6 3 1 3 1 2 5 6 6 6 2 3 6 2 2 2 2 2 3 6 6 4 6 6 2 3 1 4 6 6 6 5 
1435 5 6 5 5 3 4 6 4 6 3 1 3 1 2 5 6 6 6 2 3 6 2 2 2 2 2 3 6 6 4 6 6 2 3 1 4 6 6 6 2 
1435 5 6 5 5 3 4 6 4 6 3 1 3 1 2 5 6 6 6 2 3 6 2 2 2 2 2 3 6 6 4 6 6 2 3 1 4 6 6 6 2 
1435 5 6 5 5 3 4 6 4 6 3 1 3 1 2 5 6 6 6 2 3 6 2 2 2 2 2 3 6 6 4 6 6 2 3 1 4 6 6 6 2 
1435 5 6 5 5 3 4 6 4 6 3 1 3 1 2 5 6 6 6 2 3 6 2 2 2 2 2 3 6 6 4 6 6 2 3 1 4 6 6 6 5 
1435 5 6 5 5 3 4 6 4 6 3 1 3 1 2 5 6 6 6 2 3 6 2 2 2 2 2 3 6 6 4 6 6 2 3 1 4 6 6 6 2 
1435 5 6 5 5 3 4 6 4 6 3 1 3 1 2 5 6 6 6 2 3 6 2 2 2 2 2 3 6 6 4 6 6 2 3 1 4 6 6 6 5 
1435 5 6 5 5 3 4 6 4 6 3 1 3 1 2 5 6 6 6 2 3 6 2 2 2 2 2 3 6 6 4 6 6 2 3 1 4 6 6 6 5 
1415 5 6 5 5 3 4 6 4 6 3 1 3 1 2 5 6 6 6 2 3 6 2 2 2 2 2 3 6 6 4 6 6 2 3 1 4 6 5 3 3 5 5 3 3 
1415 5 6 5 5 3 4 6 4 6 3 1 3 1 2 5 6 6 6 2 3 6 2 2 2 2 2 3 6 6 4 6 6 2 3 1 4 6 6 6 3 1 
1410 5 6 5 5 3 4 6 4 6 3 1 3 1 2 5 6 6 6 2 3 6 2 2 2 2 2 3 6 6 4 6 6 2 3 1 4 6 6 6 4 
1410 5 6 5 5 3 4 6 4 6 3 1 3 1 2 5 6 6 6 2 3 6 2 2 2 2 2 3 6 6 4 6 6 2 3 1 4 6 6 6 4 
1410 5 6 5 5 3 4 6 4 6 3 1 3 1 2 5 6 6 6 2 3 6 2 2 2 2 2 3 6 6 4 6 6 2 3 1 4 6 6 6 1 
1410 5 6 5 5 3 4 6 4 6 3 1 3 1 2 5 6 6 6 2 3 6 2 2 2 2 2 3 6 6 4 6 6 2 3 1 4 6 6 6 1 
1410 5 6 5 5 3 4 6 4 6 3 1 3 1 2 5 6 6 6 2 3 6 2 2 2 2 2 3 6 6 4 6 6 2 3 1 4 6 6 6 4 
1410 5 6 5 5 3 4 6 4 6 3 1 3 1 2 5 6 6 6 2 3 6 2 2 2 2 2 3 6 6 4 6 6 2 3 1 4 6 6 6 1 
1410 5 6 5 5 3 4 6 4 6 3 1 3 1 2 5 6 6 6 2 3 6 2 2 2 2 2 3 6 6 4 6 6 2 3 1 4 6 6 6 4 
1410 5 6 5 5 3 4 6 4 6 3 1 3 1 2 5 6 6 6 2 3 6 2 2 2 2 2 3 6 6 4 6 6 2 3 1 4 6 6 6 1 
1410 5 6 5 5 3 4 6 4 6 3 1 3 1 2 5 6 6 6 2 3 6 2 2 2 2 2 3 6 6 4 6 6 2 3 1 4 6 6 6 1 
1410 5 6 5 5 3 4 6 4 6 3 1 3 1 2 5 6 6 6 2 3 6 2 2 2 2 2 3 6 6 4 6 6 2 3 1 4 6 6 6 1 
1410 5 6 5 5 3 4 6 4 6 3 1 3 1 2 5 6 6 6 2 3 6 2 2 2 2 2 3 6 6 4 6 6 2 3 1 4 6 6 6 1 
1410 5 6 5 5 3 4 6 4 6 3 1 3 1 2 5 6 6 6 2 3 6 2 2 2 2 2 3 6 6 4 6 6 2 3 1 4 6 6 6 1 
1410 5 6 5 5 3 4 6 4 6 3 1 3 1 2 5 6 6 6 2 3 6 2 2 2 2 2 3 6 6 4 6 6 2 3 1 4 6 6 6 1 
1410 5 6 5 5 3 4 6 4 6 3 1 3 1 2 5 6 6 6 2 3 6 2 2 2 2 2 3 6 6 4 6 6 2 3 1 4 6 6 6 1 
1410 5 6 5 5 3 4 6 4 6 3 1 3 1 2 5 6 6 6 2 3 6 2 2 2 2 2 3 6 6 4 6 6 2 3 1 4 6 6 6 1 
1410 5 6 5 5 3 4 6 4 6 3 1 3 1 2 5 6 6 6 2 3 6 2 2 2 2 2 3 6 6 4 6 6 2 3 1 4 6 6 6 1 
1410 5 6 5 5 3 4 6 4 6 3 1 3 1 2 5 6 6 6 2 3 6 2 2 2 2 2 3 6 6 4 6 6 2 3 1 4 6 6 6 4 
1410 5 6 5 5 3 4 6 4 6 3 1 3 1 2 5 6 6 6 2 3 6 2 2 2 2 2 3 6 6 4 6 6 2 3 1 4 6 6 6 4 
1410 5 6 5 5 3 4 6 4 6 3 1 3 1 2 5 6 6 6 2 3 6 2 2 2 2 2 3 6 6 4 6 6 2 3 1 4 6 6 6 4 
1410 5 6 5 5 3 4 6 4 6 3 1 3 1 2 5 6 6 6 2 3 6 2 2 2 2 2 3 6 6 4 6 6 2 3 1 4 6 6 6 4 
1410 5 6 5 5 3 4 6 4 6 3 1 3 1 2 5 6 6 6 2 3 6 2 2 2 2 2 3 6 6 4 6 6 2 3 1 4 6 6 6 4 
1405 5 6 5 5 3 4 6 4 6 3 1 3 1 2 5 6 6 6 2 3 6 2 2 2 2 2 3 6 6 4 6 6 2 3 1 4 6 5 1 4 5 
1405 5 6 5 5 3 4 6 4 6 3 1 3 1 2 5 6 6 6 2 3 6 2 2 2 2 2 3 6 6 4 6 6 2 3 1 4 6 5 3 2 2 5 2 3 
1400 5 6 5 5 3 4 6 4 6 3 1 3 1 2 5 6 6 6 2 3 6 2 2 2 2 2 3 6 6 4 6 6 2 3 1 4 6 6 4 2 3 
1390 5 6 5 5 3 4 6 4 6 3 1 3 1 2 5 6 6 6 2 3 6 2 2 2 2 2 3 6 6 4 6 6 2 3 1 4 6 5 1 3 6 
1380 5 6 5 5 3 4 6 4 6 3 1 3 1 2 5 6 6 6 2 3 6 2 2 2 2 2 3 6 6 4 6 6 2 3 1 4 6 5 4 4 4 
1380 5 6 5 5 3 4 6 4 6 3 1 3 1 2 5 6 6 6 2 3 6 2 2 2 2 2 3 6 6 4 6 6 2 4 6 1 5 5 
1370 5 6 5 5 3 4 6 4 6 3 1 3 1 2 5 6 6 6 2 3 6 2 2 2 2 2 3 6 6 4 6 6 2 3 1 4 6 6 5 
1370 5 6 5 5 3 4 6 4 6 3 1 3 1 2 5 6 6 6 2 3 6 2 2 2 2 2 3 6 6 4 6 6 2 3 1 4 6 6 2 
1370 5 6 5 5 3 4 6 4 6 3 1 3 1 2 5 6 6 6 2 3 6 2 2 2 2 2 3 6 6 4 6 6 2 3 1 4 6 6 2 
1370 5 6 5 5 3 4 6 4 6 3 1 3 1 2 5 6 6 6 2 3 6 2 2 2 2 2 3 6 6 4 6 6 2 3 1 4 6 6 2 
1370 5 6 5 5 3 4 6 4 6 3 1 3 1 2 5 6 6 6 2 3 6 2 2 2 2 2 3 6 6 4 6 6 2 3 1 4 6 6 4 4 
1370 5 6 5 5 3 4 6 4 6 3 1 3 1 2 5 6 6 6 2 3 6 2 2 2 2 2 3 6 6 4 6 6 2 3 1 4 6 6 4 4 
1370 5 6 5 5 3 4 6 4 6 3 1 3 1 2 5 6 6 6 2 3 6 2 2 2 2 2 3 6 6 4 6 6 2 3 1 4 6 6 5 
1370 5 6 5 5 3 4 6 4 6 3 1 3 1 2 5 6 6 6 2 3 6 2 2 2 2 2 3 6 6 4 6 6 2 3 1 4 6 6 2 
1370 5 6 5 5 3 4 6 4 6 3 1 3 1 2 5 6 6 6 2 3 6 2 2 2 2 2 3 6 6 4 6 6 2 3 1 4 6 6 2 
1370 5 6 5 5 3 4 6 4 6 3 1 3 1 2 5 6 6 6 2 3 6 2 2 2 2 2 3 6 6 4 6 6 2 3 1 4 6 6 2 
1370 5 6 5 5 3 4 6 4 6 3 1 3 1 2 5 6 6 6 2 3 6 2 2 2 2 2 3 6 6 4 6 6 2 3 1 4 6 6 5 
1370 5 6 5 5 3 4 6 4 6 3 1 3 1 2 5 6 6 6 2 3 6 2 2 2 2 2 3 6 6 4 6 6 2 3 1 4 6 3 5 3 3 1 1 
1370 5 6 5 5 3 4 6 4 6 3 1 3 1 2 5 6 6 6 2 3 6 2 2 2 2 2 3 6 6 4 6 6 2 3 1 4 6 6 4 4 
1370 5 6 5 5 3 4 6 4 6 3 1 3 1 2 5 6 6 6 2 3 6 2 2 2 2 2 3 6 6 4 6 6 2 3 1 4 6 6 2 
1370 5 6 5 5 3 4 6 4 6 3 1 3 1 2 5 6 6 6 2 3 6 2 2 2 2 2 3 6 6 4 6 6 2 3 1 4 6 6 5 
1370 5 6 5 5 3 4 6 4 6 3 1 3 1 2 5 6 6 6 2 3 6 2 2 2 2 2 3 6 6 4 6 6 2 3 1 4 6 6 4 4 
1370 5 6 5 5 3 4 6 4 6 3 1 3 1 2 5 6 6 6 2 3 6 2 2 2 2 2 3 6 6 4 6 6 2 3 1 4 6 6 5 
1370 5 6 5 5 3 4 6 4 6 3 1 3 1 2 5 6 6 6 2 3 6 2 2 2 2 2 3 6 6 4 6 6 2 3 1 4 6 6 5 
1370 5 6 5 5 3 4 6 4 6 3 1 3 1 2 5 6 6 6 2 3 6 2 2 2 2 2 3 6 6 4 6 6 2 3 1 4 6 6 4 4 
1350 5 6 5 5 3 4 6 4 6 3 1 3 1 2 5 6 6 6 2 3 6 2 2 2 2 2 3 6 6 4 6 6 4 2 3 3 4 3 6 6 
1345 5 6 5 5 3 4 6 4 6 3 1 3 1 2 5 6 6 6 2 3 6 2 2 2 2 2 3 6 6 4 6 6 2 3 1 4 6 6 1 
1345 5 6 5 5 3 4 6 4 6 3 1 3 1 2 5 6 6 6 2 3 6 2 2 2 2 2 3 6 6 4 6 6 2 3 1 4 6 6 1 
1345 5 6 5 5 3 4 6 4 6 3 1 3 1 2 5 6 6 6 2 3 6 2 2 2 2 2 3 6 6 4 6 6 2 3 1 4 6 6 1 
1345 5 6 5 5 3 4 6 4 6 3 1 3 1 2 5 6 6 6 2 3 6 2 2 2 2 2 3 6 6 4 6 6 2 3 1 4 6 6 1 
1345 5 6 5 5 3 4 6 4 6 3 1 3 1 2 5 6 6 6 2 3 6 2 2 2 2 2 3 6 6 4 6 6 2 3 1 4 6 6 1 
1345 5 6 5 5 3 4 6 4 6 3 1 3 1 2 5 6 6 6 2 3 6 2 2 2 2 2 3 6 6 4 6 6 2 3 1 4 6 6 1 
1345 5 6 5 5 3 4 6 4 6 3 1 3 1 2 5 6 6 6 2 3 6 2 2 2 2 2 3 6 6 4 6 6 2 3 1 4 6 6 1 
1345 5 6 5 5 3 4 6 4 6 3 1 3 1 2 5 6 6 6 2 3 6 2 2 2 2 2 3 6 6 4 6 6 2 3 1 4 6 6 1 
1345 5 6 5 5 3 4 6 4 6 3 1 3 1 2 5 6 6 6 2 3 6 2 2 2 2 2 3 6 6 4 6 6 2 3 1 4 6 6 1 
1345 5 6 5 5 3 4 6 4 6 3 1 3 1 2 5 6 6 6 2 3 6 2 2 2 2 2 3 6 6 4 6 6 2 3 1 4 6 6 1 
1345 5 6 5 5 3 4 6 4 6 3 1 3 1 2 5 6 6 6 2 3 6 2 2 2 2 2 3 6 6 4 6 6 3 3 3 2 3 3 4 6 3 6 
1345 5 6 5 5 3 4 6 4 6 3 1 3 1 2 5 6 6 6 2 3 6 2 2 2 2 2 3 6 6 4 6 6 2 3 1 4 6 6 1 
1345 5 6 5 5 3 4 6 4 6 3 1 3 1 2 5 6 6 6 2 3 6 2 2 2 2 2 3 6 6 4 6 6 2 3 1 4 6 6 1 
1340 5 6 5 5 3 4 6 4 6 3 1 3 1 2 5 6 6 6 2 3 6 2 2 2 2 2 3 6 6 4 6 6 4 3 4 6 5 3 4 1 
1325 5 6 5 5 3 4 6 4 6 3 1 3 1 2 5 6 6 6 2 3 6 2 2 2 2 2 3 6 6 4 6 6 2 3 1 4 6 6 3 
1325 5 6 5 5 3 4 6 4 6 3 1 3 1 2 5 6 6 6 2 3 6 2 2 2 2 2 3 6 6 4 6 6 2 3 1 4 6 6 3 
1325 5 6 5 5 3 4 6 4 6 3 1 3 1 2 5 6 6 6 2 3 6 2 2 2 2 2 3 6 6 4 6 6 2 3 1 4 6 6 3 
1325 5 6 5 5 3 4 6 4 6 3 1 3 1 2 5 6 6 6 2 3 6 2 2 2 2 2 3 6 6 4 6 6 2 3 1 4 6 6 3 
1325 5 6 5 5 3 4 6 4 6 3 1 3 1 2 5 6 6 6 2 3 6 2 2 2 2 2 3 6 6 4 6 6 2 3 1 4 6 6 3 
1325 5 6 5 5 3 4 6 4 6 3 1 3 1 2 5 6 6 6 2 3 6 2 2 2 2 2 3 6 6 4 6 6 2 3 1 4 6 6 3 
1325 5 6 5 5 3 4 6 4 6 3 1 3 1 2 5 6 6 6 2 3 6 2 2 2 2 2 3 6 6 4 6 6 2 3 1 4 6 6 3 
1325 5 6 5 5 3 4 6 4 6 3 1 3 1 2 5 6 6 6 2 3 6 2 2 2 2 2 3 6 6 4 6 6 2 3 1 4 6 6 3 
1325 5 6 5 5 3 4 6 4 6 3 1 3 1 2 5 6 6 6 2 3 6 2 2 2 2 2 3 6 6 4 6 6 5 6 5 5 3 
1325 5 6 5 5 3 4 6 4 6 3 1 3 1 2 5 6 6 6 2 3 6 2 2 2 2 2 3 6 6 4 6 6 2 3 1 4 6 6 3 
1325 5 6 5 5 3 4 6 4 6 3 1 3 1 2 5 6 6 6 2 3 6 2 2 2 2 2 3 6 6 4 6 6 2 3 1 4 6 6 3 
1325 5 6 5 5 3 4 6 4 6 3 1 3 1 2 5 6 6 6 2 3 6 2 2 2 2 2 3 6 6 4 6 6 2 3 1 4 6 6 3 
1310 5 6 5 5 3 4 6 4 6 3 1 3 1 2 5 6 6 6 2 3 6 2 2 2 2 2 3 6 6 4 6 6 2 3 1 4 6 3 2 
1305 5 6 5 5 3 4 6 4 6 3 1 3 1 2 5 6 6 6 2 3 6 2 2 2 2 2 3 6 6 4 6 6 2 3 1 4 6 2 
1305 5 6 5 5 3 4 6 4 6 3 1 3 1 2 5 6 6 6 2 3 6 2 2 2 2 2 3 6 6 4 6 6 1 3 4 6 3 6 
1305 5 6 5 5 3 4 6 4 6 3 1 3 1 2 5 6 6 6 2 3 6 2 2 2 2 2 3 6 6 4 6 6 2 3 1 4 6 2 
1305 5 6 5 5 3 4 6 4 6 3 1 3 1 2 5 6 6 6 2 3 6 2 2 2 2 2 3 6 6 4 6 6 2 3 1 4 6 2 
1305 5 6 5 5 3 4 6 4 6 3 1 3 1 2 5 6 6 6 2 3 6 2 2 2 2 2 3 6 6 4 6 6 2 4 6 2 
1305 5 6 5 5 3 4 6 4 6 3 1 3 1 2 5 6 6 6 2 3 6 2 2 2 2 2 3 6 6 4 6 6 2 3 1 4 6 2 
1290 5 6 5 5 3 4 6 4 6 3 1 3 1 2 5 6 6 6 2 3 6 2 2 2 2 2 3 6 6 4 6 5 4 1 1 3 1 3 4 3 4 3 4 1 1 
1290 5 6 5 5 3 4 6 4 6 3 1 3 1 2 5 6 6 6 2 3 6 2 2 2 2 2 3 6 6 4 6 6 5 4 5 2 
1285 5 6 5 5 3 4 6 4 6 3 1 3 1 2 5 6 6 6 2 3 6 2 2 2 2 2 3 6 6 4 6 6 2 3 1 4 6 3 1 
1285 5 6 5 5 3 4 6 4 6 3 1 3 1 2 5 6 6 6 2 3 6 2 2 2 2 2 3 6 6 4 6 6 2 3 1 4 6 3 1 
1285 5 6 5 5 3 4 6 4 6 3 1 3 1 2 5 6 6 6 2 3 6 2 2 2 2 2 3 6 6 4 6 5 6 6 3 2 
1285 5 6 5 5 3 4 6 4 6 3 1 3 1 2 5 6 6 6 2 3 6 2 2 2 2 2 3 6 6 4 6 6 2 3 1 4 3 5 5 
1285 5 6 5 5 3 4 6 4 6 3 1 3 1 2 5 6 6 6 2 3 6 2 2 2 2 2 3 6 6 4 6 6 2 3 1 4 6 3 1 
1285 5 6 5 5 3 4 6 4 6 3 1 3 1 2 5 6 6 6 2 3 6 2 2 2 2 2 3 6 6 4 6 6 2 3 1 4 6 3 1 
1285 5 6 5 5 3 4 6 4 6 3 1 3 1 2 5 6 6 6 2 3 6 2 2 2 2 2 3 6 6 4 6 6 2 4 6 3 4 
1280 5 6 5 5 3 4 6 4 6 3 1 3 1 2 5 6 6 6 2 3 6 2 2 2 2 2 3 6 6 4 6 6 2 3 1 4 6 1 
1280 5 6 5 5 3 4 6 4 6 3 1 3 1 2 5 6 6 6 2 3 6 2 2 2 2 2 3 6 6 4 6 6 2 3 1 4 6 1 
1280 5 6 5 5 3 4 6 4 6 3 1 3 1 2 5 6 6 6 2 3 6 2 2 2 2 2 3 6 6 4 6 6 2 3 1 4 6 4 
1280 5 6 5 5 3 4 6 4 6 3 1 3 1 2 5 6 6 6 2 3 6 2 2 2 2 2 3 6 6 4 6 6 2 3 1 4 6 1 
1280 5 6 5 5 3 4 6 4 6 3 1 3 1 2 5 6 6 6 2 3 6 2 2 2 2 2 3 6 6 4 6 6 2 3 1 4 6 1 
1280 5 6 5 5 3 4 6 4 6 3 1 3 1 2 5 6 6 6 2 3 6 2 2 2 2 2 3 6 6 4 6 6 1 4 6 4 1 
1280 5 6 5 5 3 4 6 4 6 3 1 3 1 2 5 6 6 6 2 3 6 2 2 2 2 2 3 6 6 4 6 6 1 4 6 2 
1280 5 6 5 5 3 4 6 4 6 3 1 3 1 2 5 6 6 6 2 3 6 2 2 2 2 2 3 6 6 4 6 6 2 3 1 4 6 1 
1280 5 6 5 5 3 4 6 4 6 3 1 3 1 2 5 6 6 6 2 3 6 2 2 2 2 2 3 6 6 4 6 6 2 3 1 4 6 1 
1280 5 6 5 5 3 4 6 4 6 3 1 3 1 2 5 6 6 6 2 3 6 2 2 2 2 2 3 6 6 4 6 6 2 3 1 4 6 4 
1280 5 6 5 5 3 4 6 4 6 3 1 3 1 2 5 6 6 6 2 3 6 2 2 2 2 2 3 6 6 4 6 6 2 3 1 4 6 4 
1280 5 6 5 5 3 4 6 4 6 3 1 3 1 2 5 6 6 6 2 3 6 2 2 2 2 2 3 6 6 4 6 6 2 3 1 4 6 4 
1280 5 6 5 5 3 4 6 4 6 3 1 3 1 2 5 6 6 6 2 3 6 2 2 2 2 2 3 6 6 4 6 6 5 6 2 
1280 5 6 5 5 3 4 6 4 6 3 1 3 1 2 5 6 6 6 2 3 6 2 2 2 2 2 3 6 6 4 6 6 2 3 1 4 6 4 
1280 5 6 5 5 3 4 6 4 6 3 1 3 1 2 5 6 6 6 2 3 6 2 2 2 2 2 3 6 6 4 6 6 2 3 1 4 6 1 
1280 5 6 5 5 3 4 6 4 6 3 1 3 1 2 5 6 6 6 2 3 6 2 2 2 2 2 3 6 6 4 6 6 5 6 2 
1280 5 6 5 5 3 4 6 4 6 3 1 3 1 2 5 6 6 6 2 3 6 2 2 2 2 2 3 6 6 4 6 6 2 3 1 4 6 1 
1280 5 6 5 5 3 4 6 4 6 3 1 3 1 2 5 6 6 6 2 3 6 2 2 2 2 2 3 6 6 4 6 6 2 3 1 4 6 4 
1280 5 6 5 5 3 4 6 4 6 3 1 3 1 2 5 6 6 6 2 3 6 2 2 2 2 2 3 6 6 4 6 6 3 2 2 4 6 1 
1280 5 6 5 5 3 4 6 4 6 3 1 3 1 2 5 6 6 6 2 3 6 2 2 2 2 2 3 6 6 4 6 6 5 6 2 
1280 5 6 5 5 3 4 6 4 6 3 1 3 1 2 5 6 6 6 2 3 6 2 2 2 2 2 3 6 6 4 6 6 2 3 1 4 6 4 
1280 5 6 5 5 3 4 6 4 6 3 1 3 1 2 5 6 6 6 2 3 6 2 2 2 2 2 3 6 6 4 6 6 2 3 1 4 6 4 
1275 5 6 5 5 3 4 6 4 6 3 1 3 1 2 5 6 6 6 2 3 6 2 2 2 2 2 3 6 6 4 6 4 2 1 2 4 5 
1260 5 6 5 5 3 4 6 4 6 3 1 3 1 2 5 6 6 6 2 3 6 2 2 2 2 2 3 6 6 4 6 6 1 4 3 6 4 
1255 5 6 5 5 3 4 6 4 6 3 1 3 1 2 5 6 6 6 2 3 6 2 2 2 2 2 3 6 6 4 6 6 1 2 6 
1255 5 6 5 5 3 4 6 4 6 3 1 3 1 2 5 6 6 6 2 3 6 2 2 2 2 2 3 6 6 4 6 6 3 1 2 3 2 6 
1250 5 6 5 5 3 4 6 4 6 3 1 3 1 2 5 6 6 6 2 3 6 2 2 2 2 2 3 6 6 4 6 4 1 1 5 4 2 
1250 5 6 5 5 3 4 6 4 6 3 1 3 1 2 5 6 6 6 2 3 6 2 2 2 2 2 3 6 6 4 6 6 2 4 3 4 3 1 
1245 5 6 5 5 3 4 6 4 6 3 1 3 1 2 5 6 6 6 2 3 6 2 2 2 2 2 3 6 6 4 6 6 1 1 4 3 5 
1240 5 6 5 5 3 4 6 4 6 3 1 3 1 2 5 6 6 6 2 3 6 2 2 2 2 2 3 6 6 4 6 6 2 1 4 2 
1240 5 6 5 5 3 4 6 4 6 3 1 3 1 2 5 6 6 6 2 3 6 2 2 2 2 2 3 6 6 4 6 6 2 4 2 
1240 5 6 5 5 3 4 6 4 6 3 1 3 1 2 5 6 6 6 2 3 6 2 2 2 2 2 3 6 6 4 6 6 5 4 2 
1240 5 6 5 5 3 4 6 4 6 3 1 3 1 2 5 6 6 6 2 3 6 2 2 2 2 2 3 6 6 4 6 6 2 4 3 5 1 
1240 5 6 5 5 3 4 6 4 6 3 1 3 1 2 5 6 6 6 2 3 6 2 2 2 2 2 3 6 6 4 6 6 2 4 2 
1240 5 6 5 5 3 4 6 4 6 3 1 3 1 2 5 6 6 6 2 3 6 2 2 2 2 2 3 6 6 4 6 6 4 1 4 2 
1240 5 6 5 5 3 4 6 4 6 3 1 3 1 2 5 6 6 6 2 3 6 2 2 2 2 2 3 6 6 4 6 4 6 2 5 
1240 5 6 5 5 3 4 6 4 6 3 1 3 1 2 5 6 6 6 2 3 6 2 2 2 2 2 3 6 6 4 6 5 5 1 6 
1240 5 6 5 5 3 4 6 4 6 3 1 3 1 2 5 6 6 6 2 3 6 2 2 2 2 2 3 6 6 4 6 6 2 4 2 
1240 5 6 5 5 3 4 6 4 6 3 1 3 1 2 5 6 6 6 2 3 6 2 2 2 2 2 3 6 6 4 6 6 1 3 2 1 5 
1240 5 6 5 5 3 4 6 4 6 3 1 3 1 2 5 6 6 6 2 3 6 2 2 2 2 2 3 6 6 4 6 6 2 1 4 5 
1235 5 6 5 5 3 4 6 4 6 3 1 3 1 2 5 6 6 6 2 3 6 2 2 2 2 2 3 6 6 4 6 6 3 2 1 6 
1235 5 6 5 5 3 4 6 4 6 3 1 3 1 2 5 6 6 6 2 3 6 2 2 2 2 2 3 6 6 4 6 5 5 1 2 6 
1230 5 6 5 5 3 4 6 4 6 3 1 3 1 2 5 6 6 6 2 3 6 2 2 2 2 2 3 6 6 4 6 6 2 6 
1230 5 6 5 5 3 4 6 4 6 3 1 3 1 2 5 6 6 6 2 3 6 2 2 2 2 2 3 6 6 4 6 4 4 1 4 3 1 1 4 1 
1230 5 6 5 5 3 4 6 4 6 3 1 3 1 2 5 6 6 6 2 3 6 2 2 2 2 2 3 6 6 4 6 6 2 3 6 
1230 5 6 5 5 3 4 6 4 6 3 1 3 1 2 5 6 6 6 2 3 6 2 2 2 2 2 3 6 6 4 6 6 2 6 
1230 5 6 5 5 3 4 6 4 6 3 1 3 1 2 5 6 6 6 2 3 6 2 2 2 2 2 3 6 6 4 6 6 2 1 6 
1230 5 6 5 5 3 4 6 4 6 3 1 3 1 2 5 6 6 6 2 3 6 2 2 2 2 2 3 6 6 4 6 5 3 3 2 3 4 5 
1225 5 6 5 5 3 4 6 4 6 3 1 3 1 2 5 6 6 6 2 3 6 2 2 2 2 2 3 6 6 4 6 6 2 3 6 
1225 5 6 5 5 3 4 6 4 6 3 1 3 1 2 5 6 6 6 2 3 6 2 2 2 2 2 3 6 6 4 6 6 4 3 1 2 1 6 
1225 5 6 5 5 3 4 6 4 6 3 1 3 1 2 5 6 6 6 2 3 6 2 2 2 2 2 3 6 6 4 6 6 2 1 6 
1225 5 6 5 5 3 4 6 4 6 3 1 3 1 2 5 6 6 6 2 3 6 2 2 2 2 2 3 6 6 4 6 6 2 1 6 
1220 5 6 5 5 3 4 6 4 6 3 1 3 1 2 5 6 6 6 2 3 6 2 2 2 2 2 3 6 6 4 6 4 2 2 3 5 
1220 5 6 5 5 3 4 6 4 6 3 1 3 1 2 5 6 6 6 2 3 6 2 2 2 2 2 3 6 6 4 6 6 2 3 3 6 
1220 5 6 5 5 3 4 6 4 6 3 1 3 1 2 5 6 6 6 2 3 6 2 2 2 2 2 3 6 6 4 6 6 2 3 3 3 6 
1220 5 6 5 5 3 4 6 4 6 3 1 3 1 2 5 6 6 6 2 3 6 2 2 2 2 2 3 6 6 4 6 6 2 4 3 1 
1220 5 6 5 5 3 4 6 4 6 3 1 3 1 2 5 6 6 6 2 3 6 2 2 2 2 2 3 6 6 4 6 6 2 2 1 6 
1220 5 6 5 5 3 4 6 4 6 3 1 3 1 2 5 6 6 6 2 3 6 2 2 2 2 2 3 6 6 4 6 5 3 5 6 
1220 5 6 5 5 3 4 6 4 6 3 1 3 1 2 5 6 6 6 2 3 6 2 2 2 2 2 3 6 6 4 6 6 3 2 1 3 5 
1220 5 6 5 5 3 4 6 4 6 3 1 3 1 2 5 6 6 6 2 3 6 2 2 2 2 2 3 6 6 4 6 6 4 1 1 2 6 
1215 5 6 5 5 3 4 6 4 6 3 1 3 1 2 5 6 6 6 2 3 6 2 2 2 2 2 3 6 6 4 6 6 2 5 
1215 5 6 5 5 3 4 6 4 6 3 1 3 1 2 5 6 6 6 2 3 6 2 2 2 2 2 3 6 6 4 6 6 2 2 5 
1215 5 6 5 5 3 4 6 4 6 3 1 3 1 2 5 6 6 6 2 3 6 2 2 2 2 2 3 6 6 4 6 6 2 3 2 5 
1215 5 6 5 5 3 4 6 4 6 3 1 3 1 2 5 6 6 6 2 3 6 2 2 2 2 2 3 6 6 4 6 6 5 2 
1215 5 6 5 5 3 4 6 4 6 3 1 3 1 2 5 6 6 6 2 3 6 2 2 2 2 2 3 6 6 4 6 6 2 4 1 
1215 5 6 5 5 3 4 6 4 6 3 1 3 1 2 5 6 6 6 2 3 6 2 2 2 2 2 3 6 6 4 6 6 5 2 
1215 5 6 5 5 3 4 6 4 6 3 1 3 1 2 5 6 6 6 2 3 6 2 2 2 2 2 3 6 6 4 6 6 5 2 
1215 5 6 5 5 3 4 6 4 6 3 1 3 1 2 5 6 6 6 2 3 6 2 2 2 2 2 3 6 6 4 6 6 2 5 
1215 5 6 5 5 3 4 6 4 6 3 1 3 1 2 5 6 6 6 2 3 6 2 2 2 2 2 3 6 6 4 6 6 2 5 
1215 5 6 5 5 3 4 6 4 6 3 1 3 1 2 5 6 6 6 2 3 6 2 2 2 2 2 3 6 6 4 6 6 2 4 1 
1210 5 6 5 5 3 4 6 4 6 3 1 3 1 2 5 6 6 6 2 3 6 2 2 2 2 2 3 6 6 4 6 6 2 3 5 
1210 5 6 5 5 3 4 6 4 6 3 1 3 1 2 5 6 6 6 2 3 6 2 2 2 2 2 3 6 6 4 6 6 1 1 3 5 
1210 5 6 5 5 3 4 6 4 6 3 1 3 1 2 5 6 6 6 2 3 6 2 2 2 2 2 3 6 6 4 6 6 1 1 1 5 
1205 5 6 5 5 3 4 6 4 6 3 1 3 1 2 5 6 6 6 2 3 6 2 2 2 2 2 3 6 6 4 6 6 2 3 3 5 
1205 5 6 5 5 3 4 6 4 6 3 1 3 1 2 5 6 6 6 2 3 6 2 2 2 2 2 3 6 6 4 6 6 2 3 1 2 4 4 
1205 5 6 5 5 3 4 6 4 6 3 1 3 1 2 5 6 6 6 2 3 6 2 2 2 2 2 3 6 6 4 6 5 3 5 5 
1205 5 6 5 5 3 4 6 4 6 3 1 3 1 2 5 6 6 6 2 3 6 2 2 2 2 2 3 6 6 4 6 6 1 6 
1205 5 6 5 5 3 4 6 4 6 3 1 3 1 2 5 6 6 6 2 3 6 2 2 2 2 2 3 6 6 4 6 6 2 2 1 5 
1200 5 6 5 5 3 4 6 4 6 3 1 3 1 2 5 6 6 6 2 3 6 2 2 2 2 2 3 6 6 4 6 4 2 5 1 
1200 5 6 5 5 3 4 6 4 6 3 1 3 1 2 5 6 6 6 2 3 6 2 2 2 2 2 3 6 6 4 6 6 2 4 3 3 
1200 5 6 5 5 3 4 6 4 6 3 1 3 1 2 5 6 6 6 2 3 6 2 2 2 2 2 3 6 6 4 6 6 1 3 3 2 3 5 
1200 5 6 5 5 3 4 6 4 6 3 1 3 1 2 5 6 6 6 2 3 6 2 2 2 2 2 3 6 6 4 6 5 1 4 5 
1195 5 6 5 5 3 4 6 4 6 3 1 3 1 2 5 6 6 6 2 3 6 2 2 2 2 2 3 6 6 4 6 4 6 3 4 4 
1190 5 6 5 5 3 4 6 4 6 3 1 3 1 2 5 6 6 6 2 3 6 2 2 2 2 2 3 6 6 4 6 6 5 1 
1190 5 6 5 5 3 4 6 4 6 3 1 3 1 2 5 6 6 6 2 3 6 2 2 2 2 2 3 6 6 4 6 6 1 5 
1190 5 6 5 5 3 4 6 4 6 3 1 3 1 2 5 6 6 6 2 3 6 2 2 2 2 2 3 6 6 4 6 6 4 5 
1190 5 6 5 5 3 4 6 4 6 3 1 3 1 2 5 6 6 6 2 3 6 2 2 2 2 2 3 6 6 4 6 6 4 5 
1185 5 6 5 5 3 4 6 4 6 3 1 3 1 2 5 6 6 6 2 3 6 2 2 2 2 2 3 6 6 4 6 6 2 1 1 3 3 1 3 5 
1180 5 6 5 5 3 4 6 4 6 3 1 3 1 2 5 6 6 6 2 3 6 2 2 2 2 2 3 6 6 4 6 6 6 
1180 5 6 5 5 3 4 6 4 6 3 1 3 1 2 5 6 6 6 2 3 6 2 2 2 2 2 3 6 6 4 6 6 6 
1180 5 6 5 5 3 4 6 4 6 3 1 3 1 2 5 6 6 6 2 3 6 2 2 2 2 2 3 6 6 4 6 6 6 
1180 5 6 5 5 3 4 6 4 6 3 1 3 1 2 5 6 6 6 2 3 6 2 2 2 2 2 3 6 6 4 6 6 6 
1175 5 6 5 5 3 4 6 4 6 3 1 3 1 2 5 6 6 6 2 3 6 2 2 2 2 2 3 6 6 4 6 6 3 3 4 1 
1170 5 6 5 5 3 4 6 4 6 3 1 3 1 2 5 6 6 6 2 3 6 2 2 2 2 2 3 6 6 4 6 6 5 3 
1170 5 6 5 5 3 4 6 4 6 3 1 3 1 2 5 6 6 6 2 3 6 2 2 2 2 2 3 6 6 4 6 6 3 5 
1170 5 6 5 5 3 4 6 4 6 3 1 3 1 2 5 6 6 6 2 3 6 2 2 2 2 2 3 6 6 4 6 6 3 5 
1110 5 6 5 5 3 4 6 4 6 3 1 3 1 2 5 6 6 6 2 3 6 2 2 2 2 2 3 6 6 4 6 5 5 2 2 
1110 5 6 5 5 3 4 6 4 6 3 1 3 1 2 5 6 6 6 2 3 6 2 2 2 2 2 3 6 6 4 6 5 2 2 3 
1100 5 6 5 5 3 4 6 4 6 3 1 3 1 2 5 6 6 6 2 3 6 2 2 2 2 2 3 6 6 4 6 2 
1100 5 6 5 5 3 4 6 4 6 3 1 3 1 2 5 6 6 6 2 3 6 2 2 2 2 2 3 6 6 4 6 6 1 2 2 
1100 5 6 5 5 3 4 6 4 6 3 1 3 1 2 5 6 6 6 2 3 6 2 2 2 2 2 3 6 6 4 6 6 1 2 3 2 2 
1100 5 6 5 5 3 4 6 4 6 3 1 3 1 2 5 6 6 6 2 3 6 2 2 2 2 2 3 6 6 4 6 2 
1100 5 6 5 5 3 4 6 4 6 3 1 3 1 2 5 6 6 6 2 3 6 2 2 2 2 2 3 6 6 4 6 2 
1090 5 6 5 5 3 4 6 4 6 3 1 3 1 2 5 6 6 6 2 3 6 2 2 2 2 2 3 6 6 4 5 2 3 
1080 5 6 5 5 3 4 6 4 6 3 1 3 1 2 5 6 6 6 2 3 6 2 2 2 2 2 3 6 6 4 6 4 3 
1080 5 6 5 5 3 4 6 4 6 3 1 3 1 2 5 6 6 6 2 3 6 2 2 2 2 2 3 6 6 4 6 4 3 
1080 5 6 5 5 3 4 6 4 6 3 1 3 1 2 5 6 6 6 2 3 6 2 2 2 2 2 3 6 6 4 6 4 3 
1075 5 6 5 5 3 4 6 4 6 3 1 3 1 2 5 6 6 6 2 3 6 2 2 2 2 2 3 6 6 4 6 1 
1075 5 6 5 5 3 4 6 4 6 3 1 3 1 2 5 6 6 6 2 3 6 2 2 2 2 2 3 6 6 4 6 1 
1075 5 6 5 5 3 4 6 4 6 3 1 3 1 2 5 6 6 6 2 3 6 2 2 2 2 2 3 6 6 4 1 6 
1075 5 6 5 5 3 4 6 4 6 3 1 3 1 2 5 6 6 6 2 3 6 2 2 2 2 2 3 6 6 4 6 4 3 1 3 4 6 
1075 5 6 5 5 3 4 6 4 6 3 1 3 1 2 5 6 6 6 2 3 6 2 2 2 2 2 3 6 6 4 6 1 
1075 5 6 5 5 3 4 6 4 6 3 1 3 1 2 5 6 6 6 2 3 6 2 2 2 2 2 3 6 6 4 6 6 2 1 
1075 5 6 5 5 3 4 6 4 6 3 1 3 1 2 5 6 6 6 2 3 6 2 2 2 2 2 3 6 6 4 6 6 2 2 
1075 5 6 5 5 3 4 6 4 6 3 1 3 1 2 5 6 6 6 2 3 6 2 2 2 2 2 3 6 6 4 6 4 3 1 3 
1055 5 6 5 5 3 4 6 4 6 3 1 3 1 2 5 6 6 6 2 3 6 2 2 2 2 2 3 6 6 4 6 3 
1055 5 6 5 5 3 4 6 4 6 3 1 3 1 2 5 6 6 6 2 3 6 2 2 2 2 2 3 6 6 4 6 3 
1055 5 6 5 5 3 4 6 4 6 3 1 3 1 2 5 6 6 6 2 3 6 2 2 2 2 2 3 6 6 4 6 3 
1055 5 6 5 5 3 4 6 4 6 3 1 3 1 2 5 6 6 6 2 3 6 2 2 2 2 2 3 6 6 4 6 3 
1055 5 6 5 5 3 4 6 4 6 3 1 3 1 2 5 6 6 6 2 3 6 2 2 2 2 2 3 6 6 4 6 3 
1055 5 6 5 5 3 4 6 4 6 3 1 3 1 2 5 6 6 6 2 3 6 2 2 2 2 2 3 6 6 4 6 3 
1045 5 6 5 5 3 4 6 4 6 3 1 3 1 2 5 6 6 6 2 3 6 2 2 2 2 2 3 6 6 4 3 3 2 
1035 5 6 5 5 3 4 6 4 6 3 1 3 1 2 5 6 6 6 2 3 6 2 2 2 2 2 3 6 6 4 2 
1035 5 6 5 5 3 4 6 4 6 3 1 3 1 2 5 6 6 6 2 3 6 2 2 2 2 2 3 6 6 4 2 
1035 5 6 5 5 3 4 6 4 6 3 1 3 1 2 5 6 6 6 2 3 6 2 2 2 2 2 3 6 6 4 2 
1035 5 6 5 5 3 4 6 4 6 3 1 3 1 2 5 6 6 6 2 3 6 2 2 2 2 2 3 6 6 4 2 
1015 5 6 5 5 3 4 6 4 6 3 1 3 1 2 5 6 6 6 2 3 6 2 2 2 2 2 3 6 6 3 5 
1010 5 6 5 5 3 4 6 4 6 3 1 3 1 2 5 6 6 6 2 3 6 2 2 2 2 2 3 6 6 2 
1010 5 6 5 5 3 4 6 4 6 3 1 3 1 2 5 6 6 6 2 3 6 2 2 2 2 2 3 6 6 5 
985 5 6 5 5 3 4 6 4 6 3 1 3 1 2 5 6 6 6 2 3 6 2 2 2 2 2 3 6 6 1 
