930 6 5 5 5 6 4 3 4 6 2 2 3 6 5 5 5 5 4 3 4 6 2 2 2 2 1 6 2 
905 6 5 5 5 6 4 3 4 6 2 2 3 6 5 5 5 5 4 3 4 6 2 2 2 2 1 4 6 
905 6 5 5 5 6 4 3 4 6 2 2 3 6 5 5 5 5 4 3 4 6 2 2 2 1 1 2 6 
905 6 5 5 5 6 4 3 4 6 2 2 3 6 5 5 5 5 4 3 4 6 2 2 2 2 2 6 
855 6 5 5 5 6 4 3 4 6 2 2 3 6 5 5 5 5 4 3 4 6 2 2 2 1 1 6 
820 6 5 5 5 6 4 3 4 6 2 2 3 6 5 5 5 5 4 3 4 6 2 2 2 1 1 1 3 3 
815 6 5 5 5 6 4 3 4 6 2 2 3 6 5 5 5 5 4 3 4 6 2 2 2 1 5 
805 6 5 5 5 6 4 3 4 6 2 2 3 6 5 5 5 5 4 3 4 6 2 2 2 6 
805 6 5 5 5 6 4 3 4 6 2 2 3 6 5 5 5 5 4 3 4 6 2 2 2 6 
805 6 5 5 5 6 4 3 4 6 2 2 3 6 5 5 5 5 4 3 4 6 2 2 2 6 
805 6 5 5 5 6 4 3 4 6 2 2 3 6 5 5 5 5 4 3 4 6 2 2 2 6 
790 6 5 5 5 6 4 3 4 6 2 2 3 6 5 5 5 5 4 3 4 6 2 2 2 5 
790 6 5 5 5 6 4 3 4 6 2 2 3 6 5 5 5 5 4 3 4 6 2 2 1 2 4 
790 6 5 5 5 6 4 3 4 6 2 2 3 6 5 5 5 5 4 3 4 6 2 1 2 2 4 
790 6 5 5 5 6 4 3 4 6 2 2 3 6 5 5 5 5 4 3 4 6 2 2 2 1 4 
790 6 5 5 5 6 4 3 4 6 2 2 3 6 5 5 5 5 4 3 4 6 2 2 2 1 4 
790 6 5 5 5 6 4 3 4 6 2 2 3 6 5 5 5 5 4 3 4 6 2 2 2 1 4 
790 6 5 5 5 6 4 3 4 6 2 2 3 6 5 5 5 5 4 3 4 6 2 2 2 5 
790 6 5 5 5 6 4 3 4 6 2 2 3 6 5 5 5 5 4 3 4 6 2 2 2 1 4 
780 6 5 5 5 6 4 3 4 6 2 2 3 6 5 5 5 5 4 3 4 6 2 2 1 6 
770 6 5 5 5 6 4 3 4 6 2 2 3 6 5 5 5 5 4 3 4 6 2 2 2 1 3 
770 6 5 5 5 6 4 3 4 6 2 2 3 6 5 5 5 5 4 3 4 6 2 2 2 1 3 
770 6 5 5 5 6 4 3 4 6 2 2 3 6 5 5 5 5 4 3 4 6 2 2 2 1 3 
765 6 5 5 5 6 4 3 4 6 2 2 3 6 5 5 5 5 4 3 4 6 2 2 2 4 
765 6 5 5 5 6 4 3 4 6 2 2 3 6 5 5 5 5 4 3 4 6 2 2 2 4 
765 6 5 5 5 6 4 3 4 6 2 2 3 6 5 5 5 5 4 3 4 6 2 2 1 1 4 
765 6 5 5 5 6 4 3 4 6 2 2 3 6 5 5 5 5 4 3 4 6 2 2 2 4 
765 6 5 5 5 6 4 3 4 6 2 2 3 6 5 5 5 5 4 3 4 6 2 2 2 4 
765 6 5 5 5 6 4 3 4 6 2 2 3 6 5 5 5 5 4 3 4 6 2 2 2 4 
765 6 5 5 5 6 4 3 4 6 2 2 3 6 5 5 5 5 4 3 4 6 2 2 1 5 
755 6 5 5 5 6 4 3 4 6 2 2 3 6 5 5 5 5 4 3 4 6 2 2 6 
755 6 5 5 5 6 4 3 4 6 2 2 3 6 5 5 5 5 4 3 4 6 2 2 6 
755 6 5 5 5 6 4 3 4 6 2 2 3 6 5 5 5 5 4 3 4 6 2 2 6 
755 6 5 5 5 6 4 3 4 6 2 2 3 6 5 5 5 5 4 3 4 6 2 2 6 
745 6 5 5 5 6 4 3 4 6 2 2 3 6 5 5 5 5 4 3 4 6 2 2 2 3 
745 6 5 5 5 6 4 3 4 6 2 2 3 6 5 5 5 5 4 3 4 6 2 2 2 3 
745 6 5 5 5 6 4 3 4 6 2 2 3 6 5 5 5 5 4 3 4 6 2 2 2 3 
740 6 5 5 5 6 4 3 4 6 2 2 3 6 5 5 5 5 4 3 4 6 2 2 5 
740 6 5 5 5 6 4 3 4 6 2 2 3 6 5 5 5 5 4 3 4 6 2 2 1 4 
740 6 5 5 5 6 4 3 4 6 2 2 3 6 5 5 5 5 4 3 4 6 2 2 5 
740 6 5 5 5 6 4 3 4 6 2 2 3 6 5 5 5 5 4 3 4 6 2 2 5 
740 6 5 5 5 6 4 3 4 6 2 2 3 6 5 5 5 5 4 3 4 6 2 2 5 
740 6 5 5 5 6 4 3 4 6 2 2 3 6 5 5 5 5 4 3 4 6 2 2 5 
740 6 5 5 5 6 4 3 4 6 2 2 3 6 5 5 5 5 4 3 4 6 2 2 5 
730 6 5 5 5 6 4 3 4 6 2 2 3 6 5 5 5 5 4 3 4 6 2 1 6 
730 6 5 5 5 6 4 3 4 6 2 2 3 6 5 5 5 5 4 3 4 6 2 1 6 
730 6 5 5 5 6 4 3 4 6 2 2 3 6 5 5 5 5 4 3 4 6 2 1 6 
730 6 5 5 5 6 4 3 4 6 2 2 3 6 5 5 5 5 4 3 4 6 2 1 6 
720 6 5 5 5 6 4 3 4 6 2 2 3 6 5 5 5 5 4 3 4 6 2 2 1 3 
720 6 5 5 5 6 4 3 4 6 2 2 3 6 5 5 5 5 4 3 4 6 2 2 1 3 
715 6 5 5 5 6 4 3 4 6 2 2 3 6 5 5 5 5 4 3 4 6 2 2 4 
715 6 5 5 5 6 4 3 4 6 2 2 3 6 5 5 5 5 4 3 4 6 2 2 4 
715 6 5 5 5 6 4 3 4 6 2 2 3 6 5 5 5 5 4 3 4 6 2 1 1 4 
715 6 5 5 5 6 4 3 4 6 2 2 3 6 5 5 5 5 4 3 4 6 2 2 4 
715 6 5 5 5 6 4 3 4 6 2 2 3 6 5 5 5 5 4 3 4 6 2 2 4 
715 6 5 5 5 6 4 3 4 6 2 2 3 6 5 5 5 5 4 3 4 6 2 2 4 
715 6 5 5 5 6 4 3 4 6 2 2 3 6 5 5 5 5 4 3 4 6 1 2 5 
715 6 5 5 5 6 4 3 4 6 2 2 3 6 5 5 5 5 4 3 4 6 2 2 4 
710 6 5 5 5 6 4 3 4 6 2 2 3 6 5 5 5 6 3 3 6 2 2 5 
710 6 5 5 5 6 4 3 4 6 2 2 3 6 5 5 5 6 5 2 2 1 5 
705 6 5 5 5 6 4 3 4 6 2 2 3 6 5 5 5 5 4 3 4 6 2 6 
705 6 5 5 5 6 4 3 4 6 2 2 3 6 5 5 5 5 4 3 4 6 2 6 
705 6 5 5 5 6 4 3 4 6 2 2 3 6 5 5 5 5 4 3 4 6 2 6 
705 6 5 5 5 6 4 3 4 6 2 2 3 6 5 5 5 5 4 3 4 6 2 6 
705 6 5 5 5 6 4 3 4 6 2 2 3 6 5 5 5 5 4 3 4 6 2 6 
700 6 5 5 5 6 4 3 4 6 2 2 3 6 5 5 5 5 4 3 4 2 2 1 5 
695 6 5 5 5 6 4 3 4 6 2 2 3 6 5 5 5 5 4 3 4 6 2 2 3 
695 6 5 5 5 6 4 3 4 6 2 2 3 6 5 5 5 5 4 3 4 6 2 2 3 
695 6 5 5 5 6 4 3 4 6 2 2 3 6 5 5 5 5 4 3 4 6 2 2 3 
690 6 5 5 5 6 4 3 4 6 2 2 3 6 5 5 5 5 4 3 4 6 2 5 
690 6 5 5 5 6 4 3 4 6 2 2 3 6 5 5 5 5 4 3 4 6 2 5 
690 6 5 5 5 6 4 3 4 6 2 2 3 6 5 5 5 5 4 3 4 6 2 5 
690 6 5 5 5 6 4 3 4 6 2 2 3 6 5 5 5 5 4 3 4 6 2 5 
690 6 5 5 5 6 4 3 4 6 2 2 3 6 5 5 5 5 4 3 4 6 2 5 
690 6 5 5 5 6 4 3 4 6 2 2 3 6 5 5 5 5 4 3 4 6 2 1 4 
690 6 5 5 5 6 4 3 4 6 2 2 3 6 5 5 5 5 4 3 4 6 2 1 4 
690 6 5 5 5 6 4 3 4 6 2 2 3 6 5 5 5 5 4 3 4 6 2 5 
690 6 5 5 5 6 4 3 4 6 2 2 3 6 5 5 5 5 4 3 4 6 2 5 
690 6 5 5 5 6 4 3 4 6 2 2 3 6 5 5 5 5 4 3 4 6 2 5 
690 6 5 5 5 6 4 3 4 6 2 2 3 6 5 5 5 5 4 3 4 6 2 5 
690 6 5 5 5 6 4 3 4 6 2 2 3 6 5 5 5 5 4 3 4 6 2 5 
690 6 5 5 5 6 4 3 4 6 2 2 3 6 5 5 5 5 4 3 4 6 2 5 
670 6 5 5 5 6 4 3 4 6 2 2 3 6 5 5 5 5 4 2 2 1 5 
665 6 5 5 5 6 4 3 4 6 2 2 3 6 5 5 5 5 4 3 4 6 1 5 
665 6 5 5 5 6 4 3 4 6 2 2 3 6 5 5 5 5 4 3 4 6 2 4 
665 6 5 5 5 6 4 3 4 6 2 2 3 6 5 5 5 5 4 3 4 6 2 4 
665 6 5 5 5 6 4 3 4 6 2 2 3 6 5 5 6 6 6 1 2 4 
665 6 5 5 5 6 4 3 4 6 2 2 3 6 5 5 5 5 4 3 4 6 2 4 
665 6 5 5 5 6 4 3 4 6 2 2 3 6 5 5 5 5 4 3 4 6 2 4 
665 6 5 5 5 6 4 3 4 6 2 2 3 6 5 5 5 5 4 3 4 6 2 4 
665 6 5 5 5 6 4 3 4 6 2 2 3 6 5 5 5 5 4 3 4 6 2 4 
665 6 5 5 5 6 4 3 4 6 2 2 3 6 5 5 5 5 4 3 4 6 1 5 
660 6 5 5 5 6 4 3 4 6 2 2 3 6 5 5 6 4 2 5 2 1 4 
660 6 5 5 5 6 4 3 4 6 2 2 3 6 5 5 3 6 3 6 5 2 1 4 
655 6 5 5 5 6 4 3 4 6 2 2 3 6 5 5 5 5 4 3 4 6 6 
655 6 5 5 5 6 4 3 4 6 2 2 3 6 5 5 5 5 4 3 4 6 6 
655 6 5 5 5 6 4 3 4 6 2 2 3 6 5 5 5 5 4 3 4 6 6 
645 6 5 5 5 6 4 3 4 6 2 2 3 6 5 5 5 5 4 3 4 6 2 3 
645 6 5 5 5 6 4 3 4 6 2 2 3 6 5 5 5 5 4 3 4 6 2 3 
645 6 5 5 5 6 4 3 4 6 2 2 3 6 5 5 5 5 4 3 4 6 2 3 
645 6 5 5 5 6 4 3 4 6 2 2 3 6 5 5 5 5 4 3 4 6 2 3 
645 6 5 5 5 6 4 3 4 6 2 2 3 6 5 5 5 5 4 3 4 6 2 3 
645 6 5 5 5 6 4 3 4 6 2 2 3 6 5 5 5 5 4 3 4 6 2 3 
645 6 5 5 5 6 4 3 4 6 2 2 3 6 5 5 5 5 4 3 4 6 2 3 
645 6 5 5 5 6 4 3 4 6 2 2 3 6 5 5 5 5 4 3 4 6 2 3 
645 6 5 5 5 6 4 3 4 6 2 2 3 6 5 5 5 5 4 3 4 6 1 1 3 
640 6 5 5 5 6 4 3 4 6 2 2 3 6 5 5 5 5 4 3 4 6 5 
640 6 5 5 5 6 4 3 4 6 2 2 3 6 5 5 5 5 4 3 4 6 5 
640 6 5 5 5 6 4 3 4 6 2 2 3 6 5 5 5 5 4 3 4 6 5 
640 6 5 5 5 6 4 3 4 6 2 2 3 6 5 5 5 5 4 3 4 6 5 
625 6 5 5 5 6 4 3 4 6 2 2 3 6 5 5 5 5 1 6 6 
625 6 5 5 5 6 4 3 4 6 2 2 3 6 5 5 5 5 4 3 4 4 2 4 
620 6 5 5 5 6 4 3 4 6 2 2 3 6 5 5 5 5 4 3 4 6 1 3 
615 6 5 5 5 6 4 3 4 6 2 2 3 6 5 5 5 5 4 3 4 6 4 
615 6 5 5 5 6 4 3 4 6 2 2 3 6 5 5 5 5 4 3 4 4 6 
615 6 5 5 5 6 4 3 4 6 2 2 3 6 5 5 5 5 4 3 4 4 6 
615 6 5 5 5 6 4 3 4 6 2 2 3 6 5 5 5 5 4 3 4 6 4 
615 6 5 5 5 6 4 3 4 6 2 2 3 6 5 5 5 5 4 3 4 6 4 
615 6 5 5 5 6 4 3 4 6 2 2 3 6 5 5 5 5 4 3 4 6 4 
615 6 5 5 5 6 4 3 4 6 2 2 3 6 5 5 5 5 4 3 4 6 4 
615 6 5 5 5 6 4 3 4 6 2 2 3 6 5 5 5 5 4 3 4 6 4 
605 6 5 5 5 6 4 3 4 6 2 2 3 6 5 5 5 4 6 1 3 6 
605 6 5 5 5 6 4 3 4 6 2 2 3 6 5 5 5 6 2 3 6 
600 6 5 5 5 6 4 3 4 6 2 2 3 6 5 5 5 5 4 3 4 5 4 
600 6 5 5 5 6 4 3 4 6 2 2 3 6 5 5 5 5 2 1 3 5 
595 6 5 5 5 6 4 3 4 6 2 2 3 6 5 5 5 5 4 3 4 6 3 
565 6 5 5 5 6 4 3 4 6 2 2 3 6 5 5 5 3 4 4 6 4 
560 6 5 5 5 6 4 3 4 6 2 2 3 6 5 5 5 5 4 3 4 3 4 3 
