555 2 1 5 5 5 5 5 5 2 6 4 1 3 2 5 3 5 4 6 6 
550 2 1 5 5 5 5 5 5 2 6 4 1 3 2 5 3 5 4 5 1 5 4 
545 2 1 5 5 5 5 5 5 2 6 4 1 3 2 5 3 5 4 6 3 5 3 
540 2 1 5 5 5 5 5 5 2 6 4 1 3 2 5 3 5 4 6 2 
540 2 1 5 5 5 5 5 5 2 6 4 3 2 1 5 3 5 4 6 5 
525 2 1 5 5 5 5 5 5 2 6 4 1 3 2 5 3 5 4 5 2 
520 2 1 5 5 5 5 5 5 2 6 4 1 3 2 5 3 5 4 3 6 1 
520 2 1 5 5 5 5 5 5 2 6 4 1 3 2 5 3 5 6 4 3 1 
515 2 1 5 5 5 5 5 5 2 6 4 1 3 2 5 3 5 4 6 4 
480 2 1 5 5 5 5 5 5 2 6 4 1 3 2 5 3 5 4 3 2 
480 2 1 5 5 5 5 5 5 2 6 4 1 3 2 5 3 5 4 3 2 
475 2 1 5 5 5 5 5 5 2 6 4 1 3 2 5 3 5 4 2 
475 2 1 5 5 5 5 5 5 2 6 4 1 3 2 5 3 5 4 2 
475 2 1 5 5 5 5 5 5 2 6 4 1 3 2 6 4 6 1 
475 2 1 5 5 5 5 5 5 2 6 4 1 3 2 5 3 5 4 2 
460 2 1 5 5 5 5 5 5 2 6 4 1 3 2 3 5 3 3 5 2 
450 2 1 5 5 5 5 5 5 2 6 4 1 3 2 5 3 5 4 1 
450 2 1 5 5 5 5 5 5 2 6 4 1 3 2 5 3 5 4 1 
450 2 1 5 5 5 5 5 5 2 6 4 1 3 2 5 3 5 4 1 
450 2 1 5 5 5 5 5 5 2 6 4 1 3 2 5 3 5 4 1 
450 2 1 5 5 5 5 5 5 2 6 4 1 3 2 5 3 5 4 1 
450 2 1 5 5 5 5 5 5 2 6 4 1 3 2 5 3 5 4 4 
450 2 1 5 5 5 5 5 5 2 6 4 1 3 2 5 3 5 4 4 
450 2 1 5 5 5 5 5 5 2 6 4 1 3 2 5 3 5 4 1 
450 2 1 5 5 5 5 5 5 2 6 4 1 3 2 5 3 5 4 4 
450 2 1 5 5 5 5 5 5 2 6 4 1 3 2 5 3 5 4 1 
450 2 1 5 5 5 5 5 5 2 6 4 1 3 2 5 3 5 5 
450 2 1 5 5 5 5 5 5 2 6 4 1 3 2 5 3 5 4 1 
450 2 1 5 5 5 5 5 5 2 6 4 1 3 2 5 3 5 4 1 
450 2 1 5 5 5 5 5 5 2 6 4 1 3 2 5 3 5 2 
450 2 1 5 5 5 5 5 5 2 6 4 1 3 2 5 3 5 4 1 
450 2 1 5 5 5 5 5 5 2 6 4 1 3 2 5 3 5 4 1 
450 2 1 5 5 5 5 5 5 2 6 4 1 3 2 5 3 5 4 1 
450 2 1 5 5 5 5 5 5 2 6 4 1 3 2 5 3 5 4 1 
450 2 1 5 5 5 5 5 5 2 6 4 1 3 2 5 3 5 4 1 
450 2 1 5 5 5 5 5 5 2 6 4 1 3 2 5 3 5 4 1 
450 2 1 5 5 5 5 5 5 2 6 4 1 3 2 5 3 5 4 4 
450 2 1 5 5 5 5 5 5 2 6 4 1 3 2 5 3 5 4 1 
450 2 1 5 5 5 5 5 5 2 6 4 1 3 2 5 3 5 4 1 
450 2 1 5 5 5 5 5 5 2 6 4 1 3 2 5 3 5 4 1 
450 2 1 5 5 5 5 5 5 2 6 4 1 3 2 5 3 5 4 4 
450 2 1 5 5 5 5 5 5 2 6 4 1 3 2 5 3 5 4 1 
450 2 1 5 5 5 5 5 5 2 6 4 1 3 2 5 3 5 2 
450 2 1 5 5 5 5 5 5 2 6 4 1 3 2 5 3 5 4 1 
450 2 1 5 5 5 5 5 5 2 6 4 1 3 2 5 3 5 4 1 
450 2 1 5 5 5 5 5 5 2 6 4 1 3 2 5 3 5 4 1 
450 2 1 5 5 5 5 5 5 2 6 4 1 3 2 5 3 5 4 1 
450 2 1 5 5 5 5 5 5 2 6 4 1 3 2 5 3 5 2 
450 2 1 5 5 5 5 5 5 2 6 4 1 3 2 5 3 5 4 4 
450 2 1 5 5 5 5 5 5 2 6 4 1 3 2 5 3 5 5 
450 2 1 5 5 5 5 5 5 2 6 4 1 3 2 5 3 5 4 1 
450 2 1 5 5 5 5 5 5 2 6 4 1 3 2 5 3 5 4 1 
450 2 1 5 5 5 5 5 5 2 6 4 1 3 2 5 3 5 4 1 
450 2 1 5 5 5 5 5 5 2 6 4 1 3 2 5 3 5 4 1 
450 2 1 5 5 5 5 5 5 2 6 4 1 3 2 5 3 5 2 
450 2 1 5 5 5 5 5 5 2 6 4 1 3 2 5 3 5 2 
450 2 1 5 5 5 5 5 5 2 6 4 1 3 2 5 3 5 4 1 
450 2 1 5 5 5 5 5 5 2 6 4 1 3 2 5 3 5 2 
450 2 1 5 5 5 5 5 5 2 6 4 1 3 2 5 3 5 4 1 
450 2 1 5 5 5 5 5 5 2 6 4 1 3 2 5 3 5 4 4 
440 2 1 5 5 5 5 5 5 2 6 4 1 3 2 3 6 4 2 
425 2 1 5 5 5 5 5 5 2 6 4 1 3 2 5 3 5 1 
425 2 1 5 5 5 5 5 5 2 6 4 1 3 2 5 3 5 1 
425 2 1 5 5 5 5 5 5 2 6 4 1 3 2 5 3 5 1 
420 2 1 5 5 5 5 5 5 2 6 4 3 4 2 5 1 2 
420 2 1 5 5 5 5 5 5 2 6 4 1 3 2 5 5 1 
410 2 1 5 5 5 5 5 5 2 6 4 1 3 2 6 2 
410 2 1 5 5 5 5 5 5 2 6 4 2 3 6 4 5 
410 2 1 5 5 5 5 5 5 2 6 4 1 3 2 5 6 
405 2 1 5 5 5 5 5 5 2 6 4 1 3 2 5 3 5 3 
405 2 1 5 5 5 5 5 5 2 6 4 1 3 2 5 3 5 3 
405 2 1 5 5 5 5 5 5 2 6 4 1 3 2 5 3 5 3 
405 2 1 5 5 5 5 5 5 2 6 4 1 3 2 5 3 5 3 
405 2 1 5 5 5 5 5 5 2 6 4 1 3 2 5 3 5 3 
405 2 1 5 5 5 5 5 5 2 6 4 1 3 2 5 3 1 4 3 
395 2 1 5 5 5 5 5 5 2 6 4 1 3 2 5 1 1 
395 2 1 5 5 5 5 5 5 2 6 4 1 3 2 3 6 4 3 
385 2 1 5 5 5 5 5 5 2 6 4 1 3 2 6 1 
345 2 1 5 5 5 5 5 5 2 6 4 4 3 2 2 
345 2 1 5 5 5 5 5 5 2 6 4 1 3 2 2 
335 2 1 5 5 5 5 5 5 2 6 4 1 3 1 6 
335 2 1 5 5 5 5 5 5 2 6 4 1 3 4 6 
335 2 1 5 5 5 5 5 5 2 6 4 1 3 4 6 
330 2 1 5 5 5 5 5 5 2 6 4 1 1 6 
330 2 1 5 5 5 5 5 5 2 6 4 5 6 
320 2 1 5 5 5 5 5 5 2 6 4 1 3 4 5 
320 2 1 5 5 5 5 5 5 2 6 4 1 3 1 2 
320 2 1 5 5 5 5 5 5 2 6 4 1 1 3 2 
320 2 1 5 5 5 5 5 5 2 6 4 1 4 3 2 
320 2 1 5 5 5 5 5 5 2 6 4 1 3 2 4 
320 2 1 5 5 5 5 5 5 2 6 4 1 3 1 2 
320 2 1 5 5 5 5 5 5 2 6 4 1 3 2 4 
320 2 1 5 5 5 5 5 5 2 6 4 1 1 3 5 
315 2 1 5 5 5 5 5 5 2 6 4 1 3 3 6 
315 2 1 5 5 5 5 5 5 2 6 4 2 2 
315 2 1 5 5 5 5 5 5 2 6 4 1 4 2 
315 2 1 5 5 5 5 5 5 2 6 4 1 1 5 
310 2 1 5 5 5 5 5 5 2 6 4 1 3 6 
305 2 1 5 5 5 5 5 5 2 6 4 1 3 2 3 3 
305 2 1 5 5 5 5 5 5 2 6 4 4 6 
305 2 1 5 5 5 5 5 5 2 6 4 1 3 2 3 3 
305 2 1 5 5 5 5 5 5 2 6 4 1 6 
300 2 1 5 5 5 5 5 5 2 6 4 1 3 3 2 
295 2 1 5 5 5 5 5 5 2 6 4 1 3 5 
295 2 1 5 5 5 5 5 5 2 6 4 1 3 1 4 
295 2 1 5 5 5 5 5 5 2 6 4 1 3 5 
295 2 1 5 5 5 5 5 5 2 6 4 4 1 3 1 
290 2 1 5 5 5 5 5 5 2 6 4 1 4 4 
290 2 1 5 5 5 5 5 5 2 6 4 1 1 4 
290 2 1 5 5 5 5 5 5 2 6 4 1 5 
290 2 1 5 5 5 5 5 5 2 6 4 2 4 
290 2 1 5 5 5 5 5 5 2 6 4 1 1 1 
290 2 1 5 5 5 5 5 5 2 6 4 1 5 
290 2 1 5 5 5 5 5 5 2 6 2 4 4 
290 2 1 5 5 5 5 5 5 2 6 4 1 4 4 
290 2 1 5 5 5 5 5 5 2 6 4 1 5 
290 2 1 5 5 5 5 5 5 2 6 4 1 2 
290 2 1 5 5 5 5 5 5 2 6 4 1 5 
290 2 1 5 5 5 5 5 5 2 6 4 1 1 1 
290 2 1 5 5 5 5 5 5 2 6 4 1 2 
290 2 1 5 5 5 5 5 5 2 6 1 2 1 
290 2 1 5 5 5 5 5 5 2 6 4 3 3 6 
285 2 1 5 5 5 5 5 5 2 6 3 1 6 
285 2 1 5 5 5 5 5 5 2 6 4 3 6 
280 2 1 5 5 5 5 5 5 2 6 4 6 
280 2 1 5 5 5 5 5 5 2 6 4 6 
275 2 1 5 5 5 5 5 5 2 6 4 1 3 3 4 
275 2 1 5 5 5 5 5 5 2 6 4 1 3 1 3 
