140 4 2 5 5 5 5 5 5 6 
140 4 2 5 5 5 5 5 2 6 
140 4 2 5 5 5 5 5 5 6 
125 4 2 5 5 5 5 5 5 5 
125 4 2 5 5 5 5 5 5 2 
125 4 2 5 5 5 5 5 5 2 
125 4 2 5 5 5 5 5 5 2 
120 4 2 5 5 5 5 5 3 1 6 
115 4 2 5 5 5 6 4 5 2 
115 4 2 5 5 5 5 5 4 6 
115 4 2 5 5 5 5 5 1 6 
105 4 2 5 5 5 5 5 3 1 5 
105 4 2 5 5 5 6 6 2 
105 4 2 5 5 5 6 2 6 
100 4 2 5 5 5 5 5 5 1 
100 4 2 5 5 5 5 5 4 5 
100 4 2 5 5 5 5 5 1 5 
100 4 2 5 5 5 5 5 5 1 
100 4 2 5 5 5 5 5 2 1 
100 4 2 5 5 5 5 5 5 1 
90 4 2 5 5 5 5 5 6 
90 4 2 5 5 5 6 5 5 
90 4 2 5 5 5 5 5 6 
90 4 2 5 5 5 6 4 2 4 
90 4 2 5 5 5 5 6 2 
90 4 2 5 5 5 5 5 6 
90 4 2 5 5 5 6 2 5 
85 4 2 5 5 5 5 5 3 3 5 
80 4 2 5 5 5 5 5 5 3 
80 4 2 5 5 5 5 5 5 3 
80 4 2 5 5 5 5 5 5 3 
80 4 2 5 5 5 5 5 3 4 4 3 
75 4 2 5 5 5 5 5 1 4 
75 4 2 5 5 5 5 5 1 1 
65 4 2 5 5 5 5 6 1 
65 4 2 5 5 5 6 2 4 
60 4 2 5 5 5 5 5 3 3 1 
55 4 2 5 5 5 5 5 1 3 
55 4 2 5 5 5 5 5 1 3 
45 4 2 5 5 5 6 4 1 3 
45 4 2 5 5 5 5 6 3 
25 4 2 5 5 5 5 2 
25 4 2 5 5 5 5 2 
25 4 2 5 5 5 5 2 
0 4 2 5 5 5 5 1 
-5 4 2 5 5 5 6 3 
-5 4 2 5 5 5 6 3 
-50 4 2 5 5 5 1 
