345 5 6 5 5 5 4 4 4 1 5 4 1 3 2 2 4 5 2 
340 5 6 5 5 5 4 4 4 1 5 4 1 2 2 1 2 
330 5 6 5 5 5 4 4 4 1 5 4 1 2 2 6 
330 5 6 5 5 5 4 4 4 1 5 4 1 2 2 6 
330 5 6 5 5 5 4 4 4 1 5 4 1 2 2 6 
330 5 6 5 5 5 4 4 4 1 5 4 1 2 4 4 6 
330 5 6 5 5 5 4 4 4 1 5 4 1 2 2 6 
320 5 6 5 5 5 4 4 4 1 5 4 1 2 3 5 5 
315 5 6 5 5 5 4 4 4 1 5 4 1 2 2 2 
315 5 6 5 5 5 4 4 4 1 5 4 1 2 2 5 
315 5 6 5 5 5 4 4 4 1 5 4 1 2 2 1 4 
315 5 6 5 5 5 4 4 4 1 5 4 1 2 2 1 1 
315 5 6 5 5 5 4 4 4 1 5 4 1 2 2 2 
315 5 6 5 5 5 4 4 4 1 5 4 1 2 2 2 
310 5 6 5 5 5 4 4 4 1 5 4 1 2 3 4 6 
305 5 6 5 5 5 4 4 4 1 5 4 1 1 2 6 
290 5 6 5 5 5 4 4 4 1 5 4 1 2 1 5 
290 5 6 5 5 5 5 5 1 5 2 5 5 
275 5 6 5 5 5 4 4 4 1 5 4 1 2 3 3 5 
275 5 6 5 5 5 4 4 4 1 5 4 1 5 3 5 3 
270 5 6 5 5 5 4 4 4 1 5 4 1 2 2 3 
270 5 6 5 5 5 4 4 4 1 5 4 1 2 3 1 4 
130 5 6 5 5 5 4 4 2 6 
110 5 6 5 5 5 4 2 3 6 
105 5 6 5 5 5 4 6 2 
95 5 6 5 5 5 4 4 3 2 1 
90 5 6 5 5 5 4 4 5 1 
90 5 6 5 5 5 4 3 4 3 6 
90 5 6 5 5 5 4 4 2 1 
80 5 6 5 5 5 5 6 
80 5 6 5 5 5 4 6 4 
75 5 6 5 5 5 4 4 3 3 5 
70 5 6 5 5 5 4 4 5 3 
70 5 6 5 5 5 4 4 5 3 
70 5 6 5 5 5 4 3 5 1 
55 5 6 5 5 5 6 4 
15 5 6 5 5 5 4 4 4 3 3 2 3 3 
15 5 6 5 5 5 2 
-10 5 6 5 5 5 1 
-15 5 6 5 5 5 4 4 4 1 5 4 1 2 2 4 3 
-30 5 6 5 5 5 3 
-35 5 6 5 5 2 
-35 5 6 5 5 5 4 4 4 1 5 4 1 2 2 
-40 5 6 5 5 5 4 4 3 5 3 2 1 6 
-75 5 6 5 5 5 4 4 4 4 2 2 
-85 5 6 5 5 5 4 4 3 3 1 4 1 2 
-90 5 6 5 5 5 4 4 4 1 5 4 1 2 2 5 
-415 5 6 5 5 5 4 4 4 1 5 4 
