630 5 6 5 5 5 5 4 3 2 1 6 1 4 2 5 5 6 5 6 6 
630 5 6 5 5 5 5 4 3 2 1 6 1 4 2 5 5 6 5 6 6 
630 5 6 5 5 5 5 4 3 2 1 6 1 4 2 5 5 6 5 6 6 
630 5 6 5 5 5 5 4 3 2 1 6 1 4 2 5 5 6 5 6 6 
625 5 6 5 5 5 5 4 3 2 1 6 1 4 2 5 5 6 5 4 2 5 
615 5 6 5 5 5 5 4 3 2 1 6 1 4 2 5 5 6 5 6 5 
615 5 6 5 5 5 5 4 3 2 1 6 1 4 2 5 5 6 5 6 5 
615 5 6 5 5 5 5 4 3 2 1 6 1 4 2 5 5 6 5 6 5 
615 5 6 5 5 5 5 4 3 2 1 6 1 4 2 5 5 6 5 6 2 
615 5 6 5 5 5 5 4 3 2 1 6 1 4 2 5 5 6 5 6 5 
615 5 6 5 5 5 5 4 3 2 1 6 1 4 2 5 5 6 5 6 5 
615 5 6 5 5 5 5 4 3 2 1 6 1 4 2 5 5 6 5 6 5 
615 5 6 5 5 5 5 4 3 2 1 6 1 4 2 5 5 6 5 6 5 
615 5 6 5 5 5 5 4 3 2 1 6 1 4 2 5 5 6 5 6 5 
615 5 6 5 5 5 5 4 3 2 1 6 1 4 2 5 5 6 5 6 5 
615 5 6 5 5 5 5 4 3 2 1 6 1 4 2 5 5 6 5 6 2 
600 5 6 5 5 5 5 4 3 2 1 6 1 4 2 5 4 6 5 5 1 2 4 
600 5 6 5 5 5 5 4 3 2 1 6 1 4 2 5 5 6 4 5 2 1 6 
590 5 6 5 5 5 5 4 3 2 1 6 1 4 2 5 5 6 5 6 4 
590 5 6 5 5 5 5 4 3 2 1 6 1 4 2 5 5 6 5 6 1 
590 5 6 5 5 5 5 4 3 2 1 6 1 4 2 5 5 6 5 4 6 
590 5 6 5 5 5 5 4 3 2 1 6 1 4 2 5 5 6 5 6 1 
590 5 6 5 5 5 5 4 3 2 1 6 1 4 2 5 5 6 5 4 6 
590 5 6 5 5 5 5 4 3 2 1 6 1 4 2 5 5 6 5 6 1 
580 5 6 5 5 5 5 4 3 2 1 6 1 4 2 5 5 6 5 4 2 3 
580 5 6 5 5 5 5 4 3 2 1 6 1 4 2 5 5 6 5 4 2 3 
575 5 6 5 5 5 5 4 3 2 1 6 1 4 2 5 5 6 5 4 1 1 3 
570 5 6 5 5 5 5 4 3 2 1 6 1 4 2 5 5 6 5 6 3 
570 5 6 5 5 5 5 4 3 2 1 6 1 4 2 5 5 6 5 6 3 
570 5 6 5 5 5 5 4 3 2 1 6 1 4 2 5 5 6 5 6 3 
570 5 6 5 5 5 5 4 3 2 1 6 1 4 2 5 5 6 5 6 3 
570 5 6 5 5 5 5 4 3 2 1 6 1 4 2 5 5 6 5 6 3 
570 5 6 5 5 5 5 4 3 2 1 6 1 4 2 5 5 6 3 6 5 
570 5 6 5 5 5 5 4 3 2 1 6 1 4 2 5 5 6 5 6 3 
555 5 6 5 5 5 5 4 3 2 1 6 1 4 2 5 5 6 5 4 3 4 
550 5 6 5 5 5 5 4 3 2 1 6 1 4 2 5 5 6 5 5 
550 5 6 5 5 5 5 4 3 2 1 6 1 4 2 5 5 6 5 2 
550 5 6 5 5 5 5 4 3 2 1 6 1 4 2 5 5 6 5 2 
550 5 6 5 5 5 5 4 3 2 1 6 1 4 2 5 5 6 5 2 
550 5 6 5 5 5 5 4 3 2 1 6 1 4 2 5 5 6 4 5 4 
550 5 6 5 5 5 5 4 3 2 1 6 1 4 2 5 5 6 5 4 4 
550 5 6 5 5 5 5 4 3 2 1 6 1 4 2 5 5 6 5 5 
550 5 6 5 5 5 5 4 3 2 1 6 1 4 2 5 5 6 5 5 
550 5 6 5 5 5 5 4 3 2 1 6 1 4 2 5 5 6 5 5 
550 5 6 5 5 5 5 4 3 2 1 6 1 4 2 5 5 6 5 2 
550 5 6 5 5 5 5 4 3 2 1 6 1 4 2 5 5 6 5 5 
550 5 6 5 5 5 5 4 3 2 1 6 1 4 2 5 5 6 5 5 
550 5 6 5 5 5 5 4 3 2 1 6 1 4 2 5 5 6 5 5 
550 5 6 5 5 5 5 4 3 2 1 6 1 4 2 5 5 6 5 4 4 
550 5 6 5 5 5 5 4 3 2 1 6 1 4 2 5 5 6 5 2 
550 5 6 5 5 5 5 4 3 2 1 6 1 4 2 5 5 6 5 5 
535 5 6 5 5 5 5 4 3 2 1 6 1 4 2 5 5 5 5 1 4 
530 5 6 5 5 5 5 4 3 2 1 6 1 4 2 5 5 6 3 1 5 
525 5 6 5 5 5 5 4 3 2 1 6 1 4 2 5 5 6 5 1 
525 5 6 5 5 5 5 4 3 2 1 6 1 4 2 5 5 6 5 1 
525 5 6 5 5 5 5 4 3 2 1 6 1 4 2 5 5 6 5 1 
525 5 6 5 5 5 5 4 3 2 1 6 1 4 2 5 5 6 5 1 
525 5 6 5 5 5 5 4 3 2 1 6 1 4 2 5 5 6 5 1 
525 5 6 5 5 5 5 4 3 2 1 6 1 4 2 5 5 6 5 1 
525 5 6 5 5 5 5 4 3 2 1 6 1 4 2 5 5 6 5 1 
525 5 6 5 5 5 5 4 3 2 1 6 1 4 2 5 5 6 4 4 4 
525 5 6 5 5 5 5 4 3 2 1 6 1 4 2 5 5 6 5 1 
525 5 6 5 5 5 5 4 3 2 1 6 1 4 2 5 5 6 3 6 3 
515 5 6 5 5 5 5 4 3 2 1 6 1 4 2 5 5 6 6 
515 5 6 5 5 5 5 4 3 2 1 6 1 4 2 5 5 6 6 
515 5 6 5 5 5 5 4 3 2 1 6 1 4 2 5 5 6 6 
515 5 6 5 5 5 5 4 3 2 1 6 1 4 2 5 5 6 6 
515 5 6 5 5 5 5 4 3 2 1 6 1 4 2 5 5 6 6 
515 5 6 5 5 5 5 4 3 2 1 6 1 4 2 5 5 6 6 
515 5 6 5 5 5 5 4 3 2 1 6 1 4 2 5 5 6 6 
515 5 6 5 5 5 5 4 3 2 1 6 1 4 2 5 5 6 6 
515 5 6 5 5 5 5 4 3 2 1 6 1 4 2 5 5 6 6 
515 5 6 5 5 5 5 4 3 2 1 6 1 4 2 5 5 6 6 
510 5 6 5 5 5 5 4 3 2 1 6 1 4 2 5 5 6 3 3 2 
505 5 6 5 5 5 5 4 3 2 1 6 1 4 2 5 5 6 4 1 3 
505 5 6 5 5 5 5 4 3 2 1 6 1 4 2 5 5 6 5 3 
505 5 6 5 5 5 5 4 3 2 1 6 1 4 2 5 5 6 5 3 
505 5 6 5 5 5 5 4 3 2 1 6 1 4 2 5 5 6 5 3 
505 5 6 5 5 5 5 4 3 2 1 6 1 4 2 5 5 6 3 5 
505 5 6 5 5 5 5 4 3 2 1 6 1 4 2 5 5 6 5 3 
505 5 6 5 5 5 5 4 3 2 1 6 1 4 2 5 5 6 5 3 
505 5 6 5 5 5 5 4 3 2 1 6 1 4 2 5 5 6 5 3 
500 5 6 5 5 5 5 4 3 2 1 6 1 4 2 5 5 6 2 
500 5 6 5 5 5 5 4 3 2 1 6 1 4 2 5 5 6 2 
500 5 6 5 5 5 5 4 3 2 1 6 1 4 2 5 5 6 2 
500 5 6 5 5 5 5 4 3 2 1 6 1 4 2 5 5 6 2 
500 5 6 5 5 5 5 4 3 2 1 6 1 4 2 5 5 6 2 
500 5 6 5 5 5 5 4 3 2 1 6 1 4 2 5 5 6 2 
500 5 6 5 5 5 5 4 3 2 1 6 1 4 2 5 5 6 2 
480 5 6 5 5 5 5 4 3 2 1 6 1 4 2 6 3 4 4 6 3 3 1 
475 5 6 5 5 5 5 4 3 2 1 6 1 4 2 5 5 6 1 
475 5 6 5 5 5 5 4 3 2 1 6 1 4 2 5 5 6 1 
475 5 6 5 5 5 5 4 3 2 1 6 1 4 2 5 5 6 1 
475 5 6 5 5 5 5 4 3 2 1 6 1 4 2 5 5 6 1 
475 5 6 5 5 5 5 4 3 2 1 6 1 4 2 5 5 6 1 
475 5 6 5 5 5 5 4 3 2 1 6 1 4 2 5 5 6 1 
475 5 6 5 5 5 5 4 3 2 1 6 1 4 2 5 5 6 1 
475 5 6 5 5 5 5 4 3 2 1 6 1 4 2 5 5 6 1 
475 5 6 5 5 5 5 4 3 2 1 6 1 4 2 5 5 6 1 
475 5 6 5 5 5 5 4 3 2 1 6 1 4 2 5 5 6 1 
475 5 6 5 5 5 5 4 3 2 1 6 1 4 2 5 5 6 1 
470 5 6 5 5 5 5 4 3 2 1 6 1 4 2 5 5 3 4 3 2 
460 5 6 5 5 5 5 4 3 2 1 6 1 4 2 5 5 5 1 
460 5 6 5 5 5 5 4 3 2 1 6 1 4 2 5 5 5 1 
440 5 6 5 5 5 5 4 3 2 1 6 1 4 2 5 5 3 2 
440 5 6 5 5 5 5 4 3 2 1 6 1 4 2 5 5 3 4 4 
440 5 6 5 5 5 5 4 3 2 1 6 1 4 2 5 5 3 2 
440 5 6 5 5 5 5 4 3 2 1 6 1 4 2 5 5 3 5 
440 5 6 5 5 5 5 4 3 2 1 6 1 4 2 5 5 3 2 
435 5 6 5 5 5 5 4 3 2 1 6 1 4 2 5 5 2 
435 5 6 5 5 5 5 4 3 2 1 6 1 4 2 5 5 2 
435 5 6 5 5 5 5 4 3 2 1 6 1 4 2 5 5 2 
435 5 6 5 5 5 5 4 3 2 1 6 1 4 2 5 5 2 
435 5 6 5 5 5 5 4 3 2 1 6 1 4 2 5 5 2 
420 5 6 5 5 5 5 4 3 2 1 6 1 4 2 6 3 6 3 3 1 
420 5 6 5 5 5 5 4 3 2 1 6 1 4 2 6 3 6 3 
420 5 6 5 5 5 5 4 3 2 1 6 1 4 2 6 3 6 4 3 3 5 3 
420 5 6 5 5 5 5 4 3 2 1 6 1 4 2 6 3 6 5 5 2 
410 5 6 5 5 5 5 4 3 2 1 6 1 4 2 5 5 1 
410 5 6 5 5 5 5 4 3 2 1 6 1 4 2 5 5 1 
410 5 6 5 5 5 5 4 3 2 1 6 1 4 2 5 5 4 
410 5 6 5 5 5 5 4 3 2 1 6 1 4 2 5 5 4 
410 5 6 5 5 5 5 4 3 2 1 6 1 4 2 5 5 4 
410 5 6 5 5 5 5 4 3 2 1 6 1 4 2 5 5 1 
410 5 6 5 5 5 5 4 3 2 1 6 1 4 2 5 5 1 
410 5 6 5 5 5 5 4 3 2 1 6 1 4 2 5 5 4 
400 5 6 5 5 5 5 4 3 2 1 6 1 4 2 5 6 
360 5 6 5 5 5 5 4 3 2 1 6 1 4 2 6 3 3 3 4 3 4 
