375 4 5 5 5 5 3 5 1 4 2 2 4 6 3 
210 4 5 5 5 5 3 5 1 4 3 5 3 
180 4 5 5 5 5 3 5 1 4 4 3 3 
150 4 5 5 5 5 3 5 1 4 3 5 1 4 
125 4 5 5 5 5 3 5 1 4 3 2 5 6 
100 4 5 5 5 5 3 5 1 4 3 6 4 5 
-25 4 5 5 5 5 3 5 1 4 5 6 
-25 4 5 5 5 5 3 5 1 4 6 
-25 4 5 5 5 5 3 5 1 4 6 
-25 4 5 5 5 5 3 5 1 4 3 3 
-25 4 5 5 5 5 3 5 1 4 3 
-25 4 5 5 5 5 3 5 1 4 3 3 
-25 4 5 5 5 5 3 5 1 4 2 3 
-25 4 5 5 5 5 3 5 1 4 3 3 
-120 4 5 5 5 5 3 5 1 2 3 
-130 4 5 5 5 5 3 5 1 4 1 
-130 4 5 5 5 5 3 5 1 4 3 6 1 
-130 4 5 5 5 5 3 5 1 4 4 
-130 4 5 5 5 5 3 5 1 4 3 4 4 
-130 4 5 5 5 5 3 5 1 4 3 6 6 4 
-130 4 5 5 5 5 3 5 1 4 3 6 3 
-130 4 5 5 5 5 3 5 1 4 4 4 
-145 4 5 5 5 5 3 5 1 4 3 6 3 
-145 4 5 5 5 5 3 5 1 4 3 3 
-205 4 5 5 5 5 3 5 1 5 5 
-205 4 5 5 5 5 3 5 5 6 6 
-230 4 5 5 5 5 3 5 1 4 3 6 2 
-230 4 5 5 5 5 3 5 1 4 6 
-230 4 5 5 5 5 3 5 1 4 3 6 
-230 4 5 5 5 5 3 5 1 4 3 6 5 
-230 4 5 5 5 5 3 5 1 4 3 6 4 
-230 4 5 5 5 5 3 5 1 4 4 
-230 4 5 5 5 5 3 5 1 5 
-230 4 5 5 5 5 3 5 5 
-230 4 5 5 5 5 3 5 1 4 3 3 
-230 4 5 5 5 5 3 5 1 4 3 6 3 
-230 4 5 5 5 5 3 5 1 4 3 6 6 4 
-230 4 5 5 5 5 3 5 1 4 3 2 
-230 4 5 5 5 5 3 5 1 4 3 6 6 2 
-230 4 5 5 5 5 3 5 1 4 3 3 
-230 4 5 5 5 5 3 5 1 4 3 6 5 
-230 4 5 5 5 5 3 5 1 4 3 5 
-230 4 5 5 5 5 3 5 1 4 3 6 2 
-230 4 5 5 5 5 3 5 1 4 1 
-230 4 5 5 5 5 3 5 1 4 3 6 1 
-230 4 5 5 5 5 3 5 1 4 3 6 6 4 4 
-230 4 5 5 5 5 3 5 1 4 3 6 
-230 4 5 5 5 5 3 5 1 4 6 
