1000049 2 1 5 5 5 5 5 5 2 6 4 1 3 2 5 3 5 5 4 1 5 2 
1000049 2 1 5 5 5 5 5 5 2 6 4 1 3 2 5 3 1 5 5 4 5 2 
1000049 2 1 5 5 5 5 5 5 2 6 4 1 3 2 5 3 5 4 3 4 4 3 5 1 2 
595 2 1 5 5 5 5 5 5 2 6 4 1 3 2 5 3 5 5 4 3 5 6 
575 2 1 5 5 5 5 5 5 2 6 4 1 3 2 5 3 5 4 5 4 5 4 
555 2 1 5 5 5 5 5 5 2 6 4 1 3 2 5 3 5 4 6 3 6 1 3 6 4 
555 2 1 5 5 5 5 5 5 2 6 4 1 3 2 5 3 5 4 6 6 
555 2 1 5 5 5 5 5 5 2 6 4 1 3 2 5 3 5 4 6 6 
555 2 1 5 5 5 5 5 5 2 6 4 1 3 2 5 3 5 4 6 6 
555 2 1 5 5 5 5 5 5 2 6 4 1 3 2 5 3 5 4 6 6 
555 2 1 5 5 5 5 5 5 2 6 4 1 3 2 5 3 5 4 6 6 
555 2 1 5 5 5 5 5 5 2 6 4 1 3 2 5 3 5 4 6 6 
555 2 1 5 5 5 5 5 5 2 6 4 1 3 2 5 3 5 4 3 5 4 5 
550 2 1 5 5 5 5 5 5 2 6 4 1 3 2 5 3 3 6 4 3 1 4 2 
550 2 1 5 5 5 5 5 5 2 6 4 1 3 2 5 3 5 4 6 3 3 2 
550 2 1 5 5 5 5 5 5 2 6 4 1 3 2 5 4 6 6 2 
545 2 1 5 5 5 5 5 5 2 6 4 1 3 2 5 3 1 5 4 4 6 3 
545 2 1 5 5 5 5 5 5 2 6 4 1 3 2 5 3 5 4 6 3 2 
545 2 1 5 5 5 5 5 5 2 6 4 1 3 2 5 3 5 4 6 3 5 
540 2 1 5 5 5 5 5 5 2 6 4 1 3 2 5 3 5 4 6 2 
540 2 1 5 5 5 5 5 5 2 6 4 1 3 2 5 3 5 4 6 5 
540 2 1 5 5 5 5 5 5 2 6 4 1 3 2 5 3 5 4 6 5 
540 2 1 5 5 5 5 5 5 2 6 4 1 3 2 5 3 5 4 6 5 
540 2 1 5 5 5 5 5 5 2 6 4 1 3 2 5 3 5 4 6 2 
540 2 1 5 5 5 5 5 5 2 6 4 1 3 2 5 3 5 4 5 6 
540 2 1 5 5 5 5 5 5 2 6 4 1 3 2 5 3 5 4 6 2 
540 2 1 5 5 5 5 5 5 2 6 4 3 2 1 5 3 5 4 6 2 
540 2 1 5 5 5 5 5 5 2 6 4 1 3 2 5 3 5 4 6 2 
540 2 1 5 5 5 5 5 5 2 6 4 1 3 2 5 3 6 5 4 5 
540 2 1 5 5 5 5 5 5 2 6 4 1 3 2 5 3 5 4 6 5 
540 2 1 5 5 5 5 5 5 2 6 4 1 3 2 5 3 5 4 6 2 
540 2 1 5 5 5 5 5 5 2 6 4 1 3 2 5 3 5 4 6 2 
540 2 1 5 5 5 5 5 5 2 6 4 1 3 2 5 3 5 4 6 2 
540 2 1 5 5 5 5 5 5 2 6 4 1 3 2 5 3 5 4 5 6 
540 2 1 5 5 5 5 5 5 2 6 4 1 3 2 5 3 5 4 5 6 
535 2 1 5 5 5 5 5 5 2 6 4 1 3 2 5 3 5 4 5 3 3 2 
535 2 1 5 5 5 5 5 5 2 6 4 1 3 2 5 3 6 3 6 2 
535 2 1 5 5 5 5 5 5 2 6 4 1 3 2 5 3 6 3 6 5 
535 2 1 5 5 5 5 5 5 2 6 4 1 3 2 5 3 5 4 3 5 3 2 
530 2 1 5 5 5 5 5 5 2 6 4 1 3 2 5 3 5 4 3 5 2 
530 2 1 5 5 5 5 5 5 2 6 4 1 3 2 5 3 5 4 3 5 1 1 
525 2 1 5 5 5 5 5 5 2 6 4 1 3 2 5 3 5 4 5 5 
525 2 1 5 5 5 5 5 5 2 6 4 1 3 2 5 3 5 4 5 5 
525 2 1 5 5 5 5 5 5 2 6 4 1 3 2 5 3 5 4 5 2 
525 2 1 5 5 5 5 5 5 2 6 4 1 3 2 5 3 5 4 5 2 
525 2 1 5 5 5 5 5 5 2 6 4 1 3 2 5 3 5 5 4 4 6 2 4 
525 2 1 5 5 5 5 5 5 2 6 4 1 3 2 5 3 5 4 5 1 4 
525 2 1 5 5 5 5 5 5 2 6 4 1 3 2 5 3 5 5 5 1 
525 2 1 5 5 5 5 5 5 2 6 4 1 3 2 5 3 5 4 4 5 1 
525 2 1 5 5 5 5 5 5 2 6 4 1 3 2 5 3 5 4 5 5 
525 2 1 5 5 5 5 5 5 2 6 4 1 3 2 5 3 5 4 4 4 2 
525 2 1 5 5 5 5 5 5 2 6 4 1 3 2 5 3 5 5 5 4 
520 2 1 5 5 5 5 5 5 2 6 4 1 3 2 3 5 3 3 5 6 3 6 6 4 
520 2 1 5 5 5 5 5 5 2 6 4 1 3 2 5 3 5 4 6 3 6 5 2 
520 2 1 5 5 5 5 5 5 2 6 4 1 3 2 5 3 5 4 3 6 1 
515 2 1 5 5 5 5 5 5 2 6 4 1 3 2 5 3 5 4 4 6 
515 2 1 5 5 5 5 5 5 2 6 4 1 3 2 5 3 5 4 6 4 
515 2 1 5 5 5 5 5 5 2 6 4 1 3 2 5 3 5 4 6 1 
515 2 1 5 5 5 5 5 5 2 6 4 1 3 2 5 3 5 4 6 4 
515 2 1 5 5 5 5 5 5 2 6 4 1 3 2 5 3 5 6 1 4 
515 2 1 5 5 5 5 5 5 2 6 4 1 3 2 5 3 5 4 4 6 
515 2 1 5 5 5 5 5 5 2 6 4 1 3 2 5 3 5 4 6 1 
515 2 1 5 5 5 5 5 5 2 6 4 1 3 2 5 3 5 4 4 6 
515 2 1 5 5 5 5 5 5 2 6 4 1 3 2 5 3 5 4 6 4 
515 2 1 5 5 5 5 5 5 2 6 4 1 3 2 5 3 5 4 6 4 
515 2 1 5 5 5 5 5 5 2 6 4 1 3 2 5 3 5 4 6 4 
515 2 1 5 5 5 5 5 5 2 6 4 1 3 2 5 3 5 4 6 4 
515 2 1 5 5 5 5 5 5 2 6 4 1 3 2 6 4 6 6 
515 2 1 5 5 5 5 5 5 2 6 4 1 3 2 5 3 4 4 4 6 4 
515 2 1 5 5 5 5 5 5 2 6 4 1 3 2 5 3 1 5 4 6 
515 2 1 5 5 5 5 5 5 2 6 4 1 3 2 5 3 5 4 6 4 
515 2 1 5 5 5 5 5 5 2 6 4 1 3 2 5 3 5 4 6 4 
515 2 1 5 5 5 5 5 5 2 6 4 1 3 2 5 4 4 6 4 3 1 
510 2 1 5 5 5 5 5 5 2 6 4 1 3 2 5 3 5 4 5 4 3 3 
505 2 1 5 5 5 5 5 5 2 6 4 1 3 2 3 6 4 6 4 1 
505 2 1 5 5 5 5 5 5 2 6 4 1 3 2 5 3 6 6 1 
505 2 1 5 5 5 5 5 5 2 6 4 1 3 2 5 3 5 6 4 3 3 3 
505 2 1 5 5 5 5 5 5 2 6 4 1 3 2 5 3 5 4 4 3 2 
500 2 1 5 5 5 5 5 5 2 6 4 1 3 2 5 3 5 5 2 
500 2 1 5 5 5 5 5 5 2 6 4 1 3 2 5 3 5 5 2 
500 2 1 5 5 5 5 5 5 2 6 4 1 3 2 5 3 5 5 2 
490 2 1 5 5 5 5 5 5 2 6 4 1 3 2 5 3 4 6 2 
480 2 1 5 5 5 5 5 5 2 6 4 1 3 2 5 3 5 4 3 2 
480 2 1 5 5 5 5 5 5 2 6 4 1 3 2 5 3 5 4 3 2 
480 2 1 5 5 5 5 5 5 2 6 4 1 3 2 5 3 5 4 3 2 
480 2 1 5 5 5 5 5 5 2 6 4 1 3 2 5 3 5 4 3 2 
475 2 1 5 5 5 5 5 5 2 6 4 1 3 2 5 3 5 5 1 
475 2 1 5 5 5 5 5 5 2 6 4 1 3 2 5 3 5 4 2 
475 2 1 5 5 5 5 5 5 2 6 4 1 3 2 5 3 5 4 2 
475 2 1 5 5 5 5 5 5 2 6 4 1 3 2 5 3 5 4 2 
475 2 1 5 5 5 5 5 5 2 6 4 1 3 2 5 3 5 4 2 
475 2 1 5 5 5 5 5 5 2 6 4 1 3 2 5 3 5 4 4 1 
475 2 1 5 5 5 5 5 5 2 6 4 1 3 2 5 3 5 4 2 
475 2 1 5 5 5 5 5 5 2 6 4 1 3 2 5 3 5 5 1 
465 2 1 5 5 5 5 5 5 2 6 4 1 3 2 5 3 6 2 
465 2 1 5 5 5 5 5 5 2 6 4 1 3 2 5 3 6 2 
450 2 1 5 5 5 5 5 5 2 6 4 1 3 2 5 3 5 4 4 
450 2 1 5 5 5 5 5 5 2 6 4 1 3 2 5 3 5 4 1 
450 2 1 5 5 5 5 5 5 2 6 4 1 3 2 5 3 5 2 
450 2 1 5 5 5 5 5 5 2 6 4 1 3 2 5 3 5 4 1 
450 2 1 5 5 5 5 5 5 2 6 4 1 3 2 5 3 5 2 
450 2 1 5 5 5 5 5 5 2 6 4 1 3 2 5 3 5 4 1 
450 2 1 5 5 5 5 5 5 2 6 4 1 3 2 5 3 5 2 
450 2 1 5 5 5 5 5 5 2 6 4 1 3 2 5 3 5 2 
450 2 1 5 5 5 5 5 5 2 6 4 1 3 2 5 3 5 2 
450 2 1 5 5 5 5 5 5 2 6 4 1 3 2 5 3 5 4 1 
450 2 1 5 5 5 5 5 5 2 6 4 1 3 2 5 3 5 2 
450 2 1 5 5 5 5 5 5 2 6 4 1 3 2 5 3 5 2 
450 2 1 5 5 5 5 5 5 2 6 4 1 3 2 5 3 5 2 
450 2 1 5 5 5 5 5 5 2 6 4 1 3 2 5 3 5 2 
450 2 1 5 5 5 5 5 5 2 6 4 1 3 2 5 3 5 4 1 
450 2 1 5 5 5 5 5 5 2 6 4 1 3 2 5 3 5 2 
440 2 1 5 5 5 5 5 5 2 6 4 1 3 2 5 3 6 1 
440 2 1 5 5 5 5 5 5 2 6 4 1 3 2 5 3 6 1 
425 2 1 5 5 5 5 5 5 2 6 4 1 3 2 5 3 5 1 
425 2 1 5 5 5 5 5 5 2 6 4 1 3 2 5 3 5 1 
425 2 1 5 5 5 5 5 5 2 6 4 1 3 2 5 3 5 1 
425 2 1 5 5 5 5 5 5 2 6 4 1 3 2 5 3 5 1 
420 2 1 5 5 5 5 5 5 2 6 4 1 3 2 5 5 1 
405 2 1 5 5 5 5 5 5 2 6 4 1 3 2 5 3 5 3 
405 2 1 5 5 5 5 5 5 2 6 4 1 3 2 5 3 3 5 
405 2 1 5 5 5 5 5 5 2 6 4 1 3 2 5 3 5 3 
405 2 1 5 5 5 5 5 5 2 6 4 1 3 2 5 3 5 3 
400 2 1 5 5 5 5 5 5 2 6 4 1 3 2 5 3 2 
400 2 1 5 5 5 5 5 5 2 6 4 1 3 2 5 3 2 
400 2 1 5 5 5 5 5 5 2 6 4 1 3 2 5 3 2 
400 2 1 5 5 5 5 5 5 2 6 4 1 3 2 5 3 2 
395 2 1 5 5 5 5 5 5 2 6 4 1 3 2 5 2 
