1000064 2 4 5 5 5 6 4 4 6 6 5 5 6 3 3 5 5 2 3 2 2 1 1 2 2 5 6 1 4 4 6 1 6 
999999 2 4 5 5 5 6 4 4 6 6 5 5 6 3 3 5 5 2 3 2 2 1 1 2 2 5 6 6 4 3 4 4 6 1 
999999 2 4 5 5 5 6 4 4 6 6 5 5 6 3 3 5 5 2 3 2 2 1 1 2 2 5 6 1 4 4 6 1 4 2 
999999 2 4 5 5 5 6 4 4 6 6 5 5 6 3 3 5 5 2 3 2 2 1 1 2 2 5 6 5 3 4 4 5 6 1 
1070 2 4 5 5 5 6 4 4 6 6 5 5 6 3 3 5 5 2 3 2 2 1 1 2 2 5 6 6 6 4 2 
1070 2 4 5 5 5 6 4 4 6 6 5 5 6 3 3 5 5 2 3 2 2 1 1 2 2 5 6 6 6 1 2 
1070 2 4 5 5 5 6 4 4 6 6 5 5 6 3 3 5 5 2 3 2 2 1 1 2 2 5 6 6 6 4 2 
1050 2 4 5 5 5 6 4 4 6 6 5 5 6 3 3 5 5 2 3 2 2 1 1 2 2 5 6 3 6 5 6 
1045 2 4 5 5 5 6 4 4 6 6 5 5 6 3 3 5 5 2 3 2 2 1 1 2 2 5 6 6 6 2 
1045 2 4 5 5 5 6 4 4 6 6 5 5 6 3 3 5 5 2 3 2 2 1 1 2 2 5 6 5 4 3 4 5 1 1 
1045 2 4 5 5 5 6 4 4 6 6 5 5 6 3 3 5 5 2 3 2 2 1 1 2 2 5 6 1 3 5 4 5 1 2 
1040 2 4 5 5 5 6 4 4 6 6 5 5 6 3 3 5 5 2 3 2 2 1 1 2 2 5 6 3 6 4 3 1 2 
1025 2 4 5 5 5 6 4 4 6 6 5 5 6 3 3 5 5 2 3 2 2 1 1 2 2 5 6 6 6 4 3 
1020 2 4 5 5 5 6 4 4 6 6 5 5 6 3 3 5 5 2 3 2 2 1 1 2 2 5 6 1 4 3 4 1 2 
1020 2 4 5 5 5 6 4 4 6 6 5 5 6 3 3 5 5 2 3 2 2 1 1 2 2 5 6 1 3 5 1 2 
1020 2 4 5 5 5 6 4 4 6 6 5 5 6 3 3 5 5 2 3 2 2 1 1 2 2 5 6 1 3 5 5 4 
1010 2 4 5 5 5 6 4 4 6 6 5 5 6 3 3 5 5 2 3 2 2 1 1 2 2 3 6 6 4 4 4 2 
1010 2 4 5 5 5 6 4 4 6 6 5 5 6 3 3 5 5 2 3 2 2 1 1 2 2 5 6 1 4 4 3 6 
1010 2 4 5 5 5 6 4 4 6 6 5 5 6 3 3 5 5 2 3 2 2 1 1 2 2 5 6 6 3 1 2 
1005 2 4 5 5 5 6 4 4 6 6 5 5 6 3 3 5 5 2 3 2 2 1 1 2 2 5 6 1 4 3 4 6 4 
1005 2 4 5 5 5 6 4 4 6 6 5 5 6 3 3 5 5 2 3 2 2 1 1 2 2 5 6 6 5 4 
1000 2 4 5 5 5 6 4 4 6 6 5 5 6 3 3 5 5 2 3 2 2 1 1 2 2 5 6 6 6 3 
995 2 4 5 5 5 6 4 4 6 6 5 5 6 3 3 5 5 2 3 2 2 1 1 2 2 5 6 1 3 5 2 
990 2 4 5 5 5 6 4 4 6 6 5 5 6 3 3 5 5 2 3 2 2 1 1 2 2 5 6 1 4 4 4 4 
980 2 4 5 5 5 6 4 4 6 6 5 5 6 3 3 5 5 2 3 2 2 1 1 2 2 5 6 1 4 6 
980 2 4 5 5 5 6 4 4 6 6 5 5 6 3 3 5 5 2 3 2 2 1 1 2 2 5 6 1 4 6 
980 2 4 5 5 5 6 4 4 6 6 5 5 6 3 3 5 5 2 3 2 2 1 1 2 2 5 6 5 6 
975 2 4 5 5 5 6 4 4 6 6 5 5 6 3 3 5 5 2 3 2 2 1 1 2 2 5 6 4 4 3 3 2 
975 2 4 5 5 5 6 4 4 6 6 5 5 6 3 3 5 5 2 3 2 2 1 1 2 2 5 6 1 4 4 3 1 3 
970 2 4 5 5 5 6 4 4 6 6 5 5 6 3 3 5 5 2 3 2 2 1 1 2 2 5 6 5 3 5 
970 2 4 5 5 5 6 4 4 6 6 5 5 6 3 3 5 5 2 3 2 2 1 1 2 2 5 6 1 4 3 2 
970 2 4 5 5 5 6 4 4 6 6 5 5 6 3 3 5 5 2 3 2 2 1 1 2 2 5 6 5 3 5 
965 2 4 5 5 5 6 4 4 6 6 5 5 6 3 3 5 5 2 3 2 2 1 1 2 2 5 6 1 4 4 1 4 3 5 
965 2 4 5 5 5 6 4 4 6 6 5 5 6 3 3 5 5 2 3 2 2 1 1 2 2 5 6 1 4 4 1 4 3 3 
965 2 4 5 5 5 6 4 4 6 6 5 5 6 3 3 5 5 2 3 2 2 1 1 2 2 5 6 1 4 4 1 4 3 6 
965 2 4 5 5 5 6 4 4 6 6 5 5 6 3 3 5 5 2 3 2 2 1 1 2 2 5 6 1 4 4 1 4 3 4 
965 2 4 5 5 5 6 4 4 6 6 5 5 6 3 3 5 5 2 3 2 2 1 1 2 2 5 6 1 4 4 1 4 3 6 
965 2 4 5 5 5 6 4 4 6 6 5 5 6 3 3 5 5 2 3 2 2 1 1 2 2 5 6 1 4 4 1 4 3 1 
965 2 4 5 5 5 6 4 4 6 6 5 5 6 3 3 5 5 2 3 2 2 1 1 2 2 5 6 1 4 4 1 4 3 1 
965 2 4 5 5 5 6 4 4 6 6 5 5 6 3 3 5 5 2 3 2 2 1 1 2 2 5 6 1 4 4 1 4 3 1 
965 2 4 5 5 5 6 4 4 6 6 5 5 6 3 3 5 5 2 3 2 2 1 1 2 2 5 6 1 4 4 1 4 3 2 
965 2 4 5 5 5 6 4 4 6 6 5 5 6 3 3 5 5 2 3 2 2 1 1 2 2 5 6 1 4 4 1 4 3 6 
965 2 4 5 5 5 6 4 4 6 6 5 5 6 3 3 5 5 2 3 2 2 1 1 2 2 5 6 1 4 4 1 4 3 1 
965 2 4 5 5 5 6 4 4 6 6 5 5 6 3 3 5 5 2 3 2 2 1 1 2 2 5 6 1 4 4 1 4 3 1 
965 2 4 5 5 5 6 4 4 6 6 5 5 6 3 3 5 5 2 3 2 2 1 1 2 2 5 6 1 4 4 1 4 3 1 
965 2 4 5 5 5 6 4 4 6 6 5 5 6 3 3 5 5 2 3 2 2 1 1 2 2 5 6 1 4 4 1 4 3 6 
965 2 4 5 5 5 6 4 4 6 6 5 5 6 3 3 5 5 2 3 2 2 1 1 2 2 5 6 1 4 4 1 4 3 1 
965 2 4 5 5 5 6 4 4 6 6 5 5 6 3 3 5 5 2 3 2 2 1 1 2 2 5 6 1 4 4 1 4 3 1 
965 2 4 5 5 5 6 4 4 6 6 5 5 6 3 3 5 5 2 3 2 2 1 1 2 2 5 6 1 4 4 1 4 3 5 
965 2 4 5 5 5 6 4 4 6 6 5 5 6 3 3 5 5 2 3 2 2 1 1 2 2 5 6 1 4 4 1 4 3 1 
965 2 4 5 5 5 6 4 4 6 6 5 5 6 3 3 5 5 2 3 2 2 1 1 2 2 5 6 1 4 4 1 4 3 1 
965 2 4 5 5 5 6 4 4 6 6 5 5 6 3 3 5 5 2 3 2 2 1 1 2 2 5 6 1 4 4 1 4 3 1 
965 2 4 5 5 5 6 4 4 6 6 5 5 6 3 3 5 5 2 3 2 2 1 1 2 2 5 5 6 5 
965 2 4 5 5 5 6 4 4 6 6 5 5 6 3 3 5 5 2 3 2 2 1 1 2 2 5 6 1 4 4 1 4 3 1 
965 2 4 5 5 5 6 4 4 6 6 5 5 6 3 3 5 5 2 3 2 2 1 1 2 2 5 6 1 4 4 1 4 3 1 
965 2 4 5 5 5 6 4 4 6 6 5 5 6 3 3 5 5 2 3 2 2 1 1 2 2 5 6 1 4 4 1 4 3 1 
965 2 4 5 5 5 6 4 4 6 6 5 5 6 3 3 5 5 2 3 2 2 1 1 2 2 5 6 1 4 4 1 4 3 1 
965 2 4 5 5 5 6 4 4 6 6 5 5 6 3 3 5 5 2 3 2 2 1 1 2 2 5 6 1 4 4 1 4 3 1 
965 2 4 5 5 5 6 4 4 6 6 5 5 6 3 3 5 5 2 3 2 2 1 1 2 2 5 6 1 4 4 1 4 3 1 
965 2 4 5 5 5 6 4 4 6 6 5 5 6 3 3 5 5 2 3 2 2 1 1 2 2 5 6 1 4 4 1 4 3 1 
965 2 4 5 5 5 6 4 4 6 6 5 5 6 3 3 5 5 2 3 2 2 1 1 2 2 5 6 1 4 4 1 4 3 1 
965 2 4 5 5 5 6 4 4 6 6 5 5 6 3 3 5 5 2 3 2 2 1 1 2 2 5 6 1 4 4 1 4 3 1 
965 2 4 5 5 5 6 4 4 6 6 5 5 6 3 3 5 5 2 3 2 2 1 1 2 2 5 6 1 4 4 1 4 3 5 
965 2 4 5 5 5 6 4 4 6 6 5 5 6 3 3 5 5 2 3 2 2 1 1 2 2 5 6 1 4 4 1 4 3 6 
965 2 4 5 5 5 6 4 4 6 6 5 5 6 3 3 5 5 2 3 2 2 1 1 2 2 5 6 1 4 4 1 4 3 6 
965 2 4 5 5 5 6 4 4 6 6 5 5 6 3 3 5 5 2 3 2 2 1 1 2 2 5 6 1 4 4 1 4 3 1 
965 2 4 5 5 5 6 4 4 6 6 5 5 6 3 3 5 5 2 3 2 2 1 1 2 2 5 6 1 4 4 1 4 3 5 
965 2 4 5 5 5 6 4 4 6 6 5 5 6 3 3 5 5 2 3 2 2 1 1 2 2 5 6 1 4 4 1 4 3 1 
965 2 4 5 5 5 6 4 4 6 6 5 5 6 3 3 5 5 2 3 2 2 1 1 2 2 5 6 1 4 4 1 4 3 1 
965 2 4 5 5 5 6 4 4 6 6 5 5 6 3 3 5 5 2 3 2 2 1 1 2 2 5 6 1 4 4 1 4 3 1 
965 2 4 5 5 5 6 4 4 6 6 5 5 6 3 3 5 5 2 3 2 2 1 1 2 2 5 6 1 4 4 1 4 3 1 
965 2 4 5 5 5 6 4 4 6 6 5 5 6 3 3 5 5 2 3 2 2 1 1 2 2 5 6 1 4 4 1 4 3 1 
965 2 4 5 5 5 6 4 4 6 6 5 5 6 3 3 5 5 2 3 2 2 1 1 2 2 5 6 1 4 4 1 4 3 5 
965 2 4 5 5 5 6 4 4 6 6 5 5 6 3 3 5 5 2 3 2 2 1 1 2 2 5 6 1 4 4 1 4 3 1 
965 2 4 5 5 5 6 4 4 6 6 5 5 6 3 3 5 5 2 3 2 2 1 1 2 2 5 6 1 4 4 1 4 3 4 
965 2 4 5 5 5 6 4 4 6 6 5 5 6 3 3 5 5 2 3 2 2 1 1 2 2 5 6 1 4 4 1 4 3 1 
965 2 4 5 5 5 6 4 4 6 6 5 5 6 3 3 5 5 2 3 2 2 1 1 2 2 5 6 1 4 4 1 4 3 2 
965 2 4 5 5 5 6 4 4 6 6 5 5 6 3 3 5 5 2 3 2 2 1 1 2 2 5 6 1 4 4 1 4 3 2 
965 2 4 5 5 5 6 4 4 6 6 5 5 6 3 3 5 5 2 3 2 2 1 1 2 2 5 6 1 4 4 1 4 3 2 
965 2 4 5 5 5 6 4 4 6 6 5 5 6 3 3 5 5 2 3 2 2 1 1 2 2 5 6 5 4 1 
965 2 4 5 5 5 6 4 4 6 6 5 5 6 3 3 5 5 2 3 2 2 1 1 2 2 5 6 1 4 4 1 4 3 3 
965 2 4 5 5 5 6 4 4 6 6 5 5 6 3 3 5 5 2 3 2 2 1 1 2 2 5 6 1 4 4 1 4 3 4 
965 2 4 5 5 5 6 4 4 6 6 5 5 6 3 3 5 5 2 3 2 2 1 1 2 2 5 6 1 4 4 1 4 3 4 
965 2 4 5 5 5 6 4 4 6 6 5 5 6 3 3 5 5 2 3 2 2 1 1 2 2 5 6 1 4 4 1 4 3 3 
965 2 4 5 5 5 6 4 4 6 6 5 5 6 3 3 5 5 2 3 2 2 1 1 2 2 5 6 1 4 4 1 4 3 2 
965 2 4 5 5 5 6 4 4 6 6 5 5 6 3 3 5 5 2 3 2 2 1 1 2 2 5 6 1 4 4 1 4 3 1 
965 2 4 5 5 5 6 4 4 6 6 5 5 6 3 3 5 5 2 3 2 2 1 1 2 2 5 6 5 5 
965 2 4 5 5 5 6 4 4 6 6 5 5 6 3 3 5 5 2 3 2 2 1 1 2 2 5 6 1 4 5 
965 2 4 5 5 5 6 4 4 6 6 5 5 6 3 3 5 5 2 3 2 2 1 1 2 2 5 6 1 4 4 1 4 3 1 
965 2 4 5 5 5 6 4 4 6 6 5 5 6 3 3 5 5 2 3 2 2 1 1 2 2 5 6 1 4 4 1 4 3 1 
965 2 4 5 5 5 6 4 4 6 6 5 5 6 3 3 5 5 2 3 2 2 1 1 2 2 5 6 1 4 4 1 4 3 6 
965 2 4 5 5 5 6 4 4 6 6 5 5 6 3 3 5 5 2 3 2 2 1 1 2 2 5 6 1 4 4 1 4 3 1 
965 2 4 5 5 5 6 4 4 6 6 5 5 6 3 3 5 5 2 3 2 2 1 1 2 2 5 6 1 4 4 1 4 3 3 
965 2 4 5 5 5 6 4 4 6 6 5 5 6 3 3 5 5 2 3 2 2 1 1 2 2 5 6 1 4 4 1 4 3 3 
965 2 4 5 5 5 6 4 4 6 6 5 5 6 3 3 5 5 2 3 2 2 1 1 2 2 5 6 1 4 2 
965 2 4 5 5 5 6 4 4 6 6 5 5 6 3 3 5 5 2 3 2 2 1 1 2 2 5 6 1 4 4 1 4 3 1 
965 2 4 5 5 5 6 4 4 6 6 5 5 6 3 3 5 5 2 3 2 2 1 1 2 2 5 6 1 4 4 1 4 3 1 
965 2 4 5 5 5 6 4 4 6 6 5 5 6 3 3 5 5 2 3 2 2 1 1 2 2 5 6 1 4 4 1 4 3 6 
965 2 4 5 5 5 6 4 4 6 6 5 5 6 3 3 5 5 2 3 2 2 1 1 2 2 5 6 1 4 4 1 4 3 1 
965 2 4 5 5 5 6 4 4 6 6 5 5 6 3 3 5 5 2 3 2 2 1 1 2 2 5 6 1 4 4 1 4 3 1 
965 2 4 5 5 5 6 4 4 6 6 5 5 6 3 3 5 5 2 3 2 2 1 1 2 2 5 6 1 4 4 1 4 3 6 
965 2 4 5 5 5 6 4 4 6 6 5 5 6 3 3 5 5 2 3 2 2 1 1 2 2 5 6 1 4 4 1 4 3 1 
965 2 4 5 5 5 6 4 4 6 6 5 5 6 3 3 5 5 2 3 2 2 1 1 2 2 5 6 1 4 4 1 4 3 1 
965 2 4 5 5 5 6 4 4 6 6 5 5 6 3 3 5 5 2 3 2 2 1 1 2 2 5 6 1 4 4 1 4 3 3 
965 2 4 5 5 5 6 4 4 6 6 5 5 6 3 3 5 5 2 3 2 2 1 1 2 2 5 6 1 4 4 1 
965 2 4 5 5 5 6 4 4 6 6 5 5 6 3 3 5 5 2 3 2 2 1 1 2 2 5 6 5 4 1 
965 2 4 5 5 5 6 4 4 6 6 5 5 6 3 3 5 5 2 3 2 2 1 1 2 2 5 6 1 4 4 1 4 3 2 
965 2 4 5 5 5 6 4 4 6 6 5 5 6 3 3 5 5 2 3 2 2 1 1 2 2 5 6 1 4 4 1 4 3 1 
965 2 4 5 5 5 6 4 4 6 6 5 5 6 3 3 5 5 2 3 2 2 1 1 2 2 5 6 1 4 4 1 4 3 2 
965 2 4 5 5 5 6 4 4 6 6 5 5 6 3 3 5 5 2 3 2 2 1 1 2 2 5 5 6 2 
965 2 4 5 5 5 6 4 4 6 6 5 5 6 3 3 5 5 2 3 2 2 1 1 2 2 5 6 1 4 2 
965 2 4 5 5 5 6 4 4 6 6 5 5 6 3 3 5 5 2 3 2 2 1 1 2 2 5 6 1 4 4 1 4 3 1 
965 2 4 5 5 5 6 4 4 6 6 5 5 6 3 3 5 5 2 3 2 2 1 1 2 2 5 6 1 4 4 1 4 3 2 
965 2 4 5 5 5 6 4 4 6 6 5 5 6 3 3 5 5 2 3 2 2 1 1 2 2 5 2 6 5 
965 2 4 5 5 5 6 4 4 6 6 5 5 6 3 3 5 5 2 3 2 2 1 1 2 2 5 6 1 4 4 1 4 3 3 
965 2 4 5 5 5 6 4 4 6 6 5 5 6 3 3 5 5 2 3 2 2 1 1 2 2 5 6 1 4 4 1 4 3 1 
965 2 4 5 5 5 6 4 4 6 6 5 5 6 3 3 5 5 2 3 2 2 1 1 2 2 5 6 1 4 4 1 4 3 3 
965 2 4 5 5 5 6 4 4 6 6 5 5 6 3 3 5 5 2 3 2 2 1 1 2 2 5 6 1 4 4 1 4 3 1 
965 2 4 5 5 5 6 4 4 6 6 5 5 6 3 3 5 5 2 3 2 2 1 1 2 2 5 6 1 4 4 1 4 3 4 
965 2 4 5 5 5 6 4 4 6 6 5 5 6 3 3 5 5 2 3 2 2 1 1 2 2 5 6 1 4 4 1 4 3 1 
965 2 4 5 5 5 6 4 4 6 6 5 5 6 3 3 5 5 2 3 2 2 1 1 2 2 5 6 1 4 4 1 4 3 5 
965 2 4 5 5 5 6 4 4 6 6 5 5 6 3 3 5 5 2 3 2 2 1 1 2 2 5 6 1 4 4 1 4 3 1 
965 2 4 5 5 5 6 4 4 6 6 5 5 6 3 3 5 5 2 3 2 2 1 1 2 2 5 6 1 4 4 1 4 3 1 
965 2 4 5 5 5 6 4 4 6 6 5 5 6 3 3 5 5 2 3 2 2 1 1 2 2 5 6 1 4 4 1 4 3 6 
965 2 4 5 5 5 6 4 4 6 6 5 5 6 3 3 5 5 2 3 2 2 1 1 2 2 5 6 1 4 4 1 4 3 3 
965 2 4 5 5 5 6 4 4 6 6 5 5 6 3 3 5 5 2 3 2 2 1 1 2 2 5 6 1 4 4 1 4 3 1 
965 2 4 5 5 5 6 4 4 6 6 5 5 6 3 3 5 5 2 3 2 2 1 1 2 2 5 6 1 4 4 1 4 3 4 
965 2 4 5 5 5 6 4 4 6 6 5 5 6 3 3 5 5 2 3 2 2 1 1 2 2 5 6 1 4 4 1 4 3 1 
965 2 4 5 5 5 6 4 4 6 6 5 5 6 3 3 5 5 2 3 2 2 1 1 2 2 5 6 1 4 4 1 4 3 1 
965 2 4 5 5 5 6 4 4 6 6 5 5 6 3 3 5 5 2 3 2 2 1 1 2 2 5 6 4 4 4 1 
965 2 4 5 5 5 6 4 4 6 6 5 5 6 3 3 5 5 2 3 2 2 1 1 2 2 5 6 1 4 4 1 4 3 3 
965 2 4 5 5 5 6 4 4 6 6 5 5 6 3 3 5 5 2 3 2 2 1 1 2 2 5 6 1 4 4 1 4 3 1 
965 2 4 5 5 5 6 4 4 6 6 5 5 6 3 3 5 5 2 3 2 2 1 1 2 2 5 6 1 4 4 1 4 3 1 
965 2 4 5 5 5 6 4 4 6 6 5 5 6 3 3 5 5 2 3 2 2 1 1 2 2 5 6 1 4 4 1 4 3 4 
965 2 4 5 5 5 6 4 4 6 6 5 5 6 3 3 5 5 2 3 2 2 1 1 2 2 5 6 1 4 4 1 4 3 1 
965 2 4 5 5 5 6 4 4 6 6 5 5 6 3 3 5 5 2 3 2 2 1 1 2 2 5 6 1 4 4 1 4 3 4 
965 2 4 5 5 5 6 4 4 6 6 5 5 6 3 3 5 5 2 3 2 2 1 1 2 2 5 6 1 4 4 1 4 3 6 
965 2 4 5 5 5 6 4 4 6 6 5 5 6 3 3 5 5 2 3 2 2 1 1 2 2 5 6 1 4 4 1 4 3 1 
965 2 4 5 5 5 6 4 4 6 6 5 5 6 3 3 5 5 2 3 2 2 1 1 2 2 5 6 1 4 4 1 4 3 6 
965 2 4 5 5 5 6 4 4 6 6 5 5 6 3 3 5 5 2 3 2 2 1 1 2 2 5 6 1 4 4 1 4 3 1 
965 2 4 5 5 5 6 4 4 6 6 5 5 6 3 3 5 5 2 3 2 2 1 1 2 2 5 6 1 4 4 1 4 3 1 
965 2 4 5 5 5 6 4 4 6 6 5 5 6 3 3 5 5 2 3 2 2 1 1 2 2 5 6 1 4 4 1 4 3 1 
965 2 4 5 5 5 6 4 4 6 6 5 5 6 3 3 5 5 2 3 2 2 1 1 2 2 5 6 1 4 4 1 4 3 3 
960 2 4 5 5 5 6 4 4 6 6 5 5 6 3 3 5 5 2 3 2 2 1 1 2 2 5 6 1 4 4 1 4 1 
960 2 4 5 5 5 6 4 4 6 6 5 5 6 3 3 5 5 2 3 2 2 1 1 2 2 5 6 1 4 4 1 4 4 
960 2 4 5 5 5 6 4 4 6 6 5 5 6 3 3 5 5 2 3 2 2 1 1 2 2 5 6 1 4 4 1 4 2 
960 2 4 5 5 5 6 4 4 6 6 5 5 6 3 3 5 5 2 3 2 2 1 1 2 2 5 6 1 4 4 1 4 5 
960 2 4 5 5 5 6 4 4 6 6 5 5 6 3 3 5 5 2 3 2 2 1 1 2 2 5 6 1 4 4 1 4 6 
960 2 4 5 5 5 6 4 4 6 6 5 5 6 3 3 5 5 2 3 2 2 1 1 2 2 5 6 1 4 4 1 4 2 
960 2 4 5 5 5 6 4 4 6 6 5 5 6 3 3 5 5 2 3 2 2 1 1 2 2 5 6 1 4 4 1 4 2 
960 2 4 5 5 5 6 4 4 6 6 5 5 6 3 3 5 5 2 3 2 2 1 1 2 2 5 6 1 4 4 1 4 6 
960 2 4 5 5 5 6 4 4 6 6 5 5 6 3 3 5 5 2 3 2 2 1 1 2 2 5 6 1 4 4 1 4 2 
960 2 4 5 5 5 6 4 4 6 6 5 5 6 3 3 5 5 2 3 2 2 1 1 2 2 5 6 1 4 4 1 4 4 
960 2 4 5 5 5 6 4 4 6 6 5 5 6 3 3 5 5 2 3 2 2 1 1 2 2 5 6 1 4 4 1 4 4 
960 2 4 5 5 5 6 4 4 6 6 5 5 6 3 3 5 5 2 3 2 2 1 1 2 2 5 6 1 4 4 1 4 6 
960 2 4 5 5 5 6 4 4 6 6 5 5 6 3 3 5 5 2 3 2 2 1 1 2 2 5 6 1 4 4 1 4 2 
960 2 4 5 5 5 6 4 4 6 6 5 5 6 3 3 5 5 2 3 2 2 1 1 2 2 5 6 1 4 4 1 4 6 
960 2 4 5 5 5 6 4 4 6 6 5 5 6 3 3 5 5 2 3 2 2 1 1 2 2 5 6 1 4 4 1 4 3 
960 2 4 5 5 5 6 4 4 6 6 5 5 6 3 3 5 5 2 3 2 2 1 1 2 2 5 6 1 4 4 1 4 5 
960 2 4 5 5 5 6 4 4 6 6 5 5 6 3 3 5 5 2 3 2 2 1 1 2 2 5 6 1 4 4 1 4 1 
960 2 4 5 5 5 6 4 4 6 6 5 5 6 3 3 5 5 2 3 2 2 1 1 2 2 5 6 1 4 4 1 4 2 
960 2 4 5 5 5 6 4 4 6 6 5 5 6 3 3 5 5 2 3 2 2 1 1 2 2 5 6 1 3 6 
960 2 4 5 5 5 6 4 4 6 6 5 5 6 3 3 5 5 2 3 2 2 1 1 2 2 5 6 1 3 6 
960 2 4 5 5 5 6 4 4 6 6 5 5 6 3 3 5 5 2 3 2 2 1 1 2 2 5 6 1 3 6 
955 2 4 5 5 5 6 4 4 6 6 5 5 6 3 3 5 5 2 3 2 2 1 1 2 2 5 6 1 6 
955 2 4 5 5 5 6 4 4 6 6 5 5 6 3 3 5 5 2 3 2 2 1 1 2 2 5 6 1 6 
955 2 4 5 5 5 6 4 4 6 6 5 5 6 3 3 5 5 2 3 2 2 1 1 2 2 5 6 1 6 
955 2 4 5 5 5 6 4 4 6 6 5 5 6 3 3 5 5 2 3 2 2 1 1 2 2 5 5 5 3 4 1 
955 2 4 5 5 5 6 4 4 6 6 5 5 6 3 3 5 5 2 3 2 2 1 1 2 2 5 6 6 1 
955 2 4 5 5 5 6 4 4 6 6 5 5 6 3 3 5 5 2 3 2 2 1 1 2 2 5 6 1 6 
955 2 4 5 5 5 6 4 4 6 6 5 5 6 3 3 5 5 2 3 2 2 1 1 2 2 5 6 1 6 
955 2 4 5 5 5 6 4 4 6 6 5 5 6 3 3 5 5 2 3 2 2 1 1 2 2 5 6 1 6 
955 2 4 5 5 5 6 4 4 6 6 5 5 6 3 3 5 5 2 3 2 2 1 1 2 2 5 6 4 6 
955 2 4 5 5 5 6 4 4 6 6 5 5 6 3 3 5 5 2 3 2 2 1 1 2 2 5 6 1 3 4 3 3 4 2 
955 2 4 5 5 5 6 4 4 6 6 5 5 6 3 3 5 5 2 3 2 2 1 1 2 2 5 6 1 6 
950 2 4 5 5 5 6 4 4 6 6 5 5 6 3 3 5 5 2 3 2 2 1 1 2 2 5 5 5 2 
950 2 4 5 5 5 6 4 4 6 6 5 5 6 3 3 5 5 2 3 2 2 1 1 2 2 5 5 4 5 1 
950 2 4 5 5 5 6 4 4 6 6 5 5 6 3 3 5 5 2 3 2 2 1 1 2 2 5 6 1 3 5 3 
950 2 4 5 5 5 6 4 4 6 6 5 5 6 3 3 5 5 2 3 2 2 1 1 2 2 5 6 1 3 5 3 
950 2 4 5 5 5 6 4 4 6 6 5 5 6 3 3 5 5 2 3 2 2 1 1 2 2 5 6 4 6 3 
945 2 4 5 5 5 6 4 4 6 6 5 5 6 3 3 5 5 2 3 2 2 1 1 2 2 5 6 1 4 3 1 
945 2 4 5 5 5 6 4 4 6 6 5 5 6 3 3 5 5 2 3 2 2 1 1 2 2 5 6 1 4 3 1 
945 2 4 5 5 5 6 4 4 6 6 5 5 6 3 3 5 5 2 3 2 2 1 1 2 2 5 6 1 3 2 
945 2 4 5 5 5 6 4 4 6 6 5 5 6 3 3 5 5 2 3 2 2 1 1 2 2 5 6 3 1 5 
945 2 4 5 5 5 6 4 4 6 6 5 5 6 3 3 5 5 2 3 2 2 1 1 2 2 5 6 5 3 1 
940 2 4 5 5 5 6 4 4 6 6 5 5 6 3 3 5 5 2 3 2 2 1 1 2 2 5 6 1 4 1 
940 2 4 5 5 5 6 4 4 6 6 5 5 6 3 3 5 5 2 3 2 2 1 1 2 2 5 6 4 2 
940 2 4 5 5 5 6 4 4 6 6 5 5 6 3 3 5 5 2 3 2 2 1 1 2 2 5 6 5 1 
940 2 4 5 5 5 6 4 4 6 6 5 5 6 3 3 5 5 2 3 2 2 1 1 2 2 5 3 6 1 5 1 
940 2 4 5 5 5 6 4 4 6 6 5 5 6 3 3 5 5 2 3 2 2 1 1 2 2 5 6 1 4 1 
940 2 4 5 5 5 6 4 4 6 6 5 5 6 3 3 5 5 2 3 2 2 1 1 2 2 5 6 1 5 
940 2 4 5 5 5 6 4 4 6 6 5 5 6 3 3 5 5 2 3 2 2 1 1 2 2 5 6 1 5 
940 2 4 5 5 5 6 4 4 6 6 5 5 6 3 3 5 5 2 3 2 2 1 1 2 2 5 6 3 6 3 
940 2 4 5 5 5 6 4 4 6 6 5 5 6 3 3 5 5 2 3 2 2 1 1 2 2 5 6 1 2 
940 2 4 5 5 5 6 4 4 6 6 5 5 6 3 3 5 5 2 3 2 2 1 1 2 2 5 6 1 5 
940 2 4 5 5 5 6 4 4 6 6 5 5 6 3 3 5 5 2 3 2 2 1 1 2 2 5 6 1 5 
940 2 4 5 5 5 6 4 4 6 6 5 5 6 3 3 5 5 2 3 2 2 1 1 2 2 5 6 1 4 1 
940 2 4 5 5 5 6 4 4 6 6 5 5 6 3 3 5 5 2 3 2 2 1 1 2 2 5 6 1 4 1 
940 2 4 5 5 5 6 4 4 6 6 5 5 6 3 3 5 5 2 3 2 2 1 1 2 2 5 6 5 1 
940 2 4 5 5 5 6 4 4 6 6 5 5 6 3 3 5 5 2 3 2 2 1 1 2 2 5 6 1 4 1 
940 2 4 5 5 5 6 4 4 6 6 5 5 6 3 3 5 5 2 3 2 2 1 1 2 2 5 6 1 5 
940 2 4 5 5 5 6 4 4 6 6 5 5 6 3 3 5 5 2 3 2 2 1 1 2 2 5 6 1 2 
940 2 4 5 5 5 6 4 4 6 6 5 5 6 3 3 5 5 2 3 2 2 1 1 2 2 5 6 4 5 
940 2 4 5 5 5 6 4 4 6 6 5 5 6 3 3 5 5 2 3 2 2 1 1 2 2 5 6 1 4 1 
940 2 4 5 5 5 6 4 4 6 6 5 5 6 3 3 5 5 2 3 2 2 1 1 2 2 5 6 1 2 
940 2 4 5 5 5 6 4 4 6 6 5 5 6 3 3 5 5 2 3 2 2 1 1 2 2 5 6 1 4 1 
940 2 4 5 5 5 6 4 4 6 6 5 5 6 3 3 5 5 2 3 2 2 1 1 2 2 5 6 1 5 
935 2 4 5 5 5 6 4 4 6 6 5 5 6 3 3 5 5 2 3 2 2 1 1 2 2 5 6 4 5 5 6 
925 2 4 5 5 5 6 4 4 6 6 5 5 6 3 3 5 5 2 3 2 2 1 1 2 2 5 2 5 1 
920 2 4 5 5 5 6 4 4 6 6 5 5 6 3 3 5 5 2 3 2 2 1 1 2 2 5 6 1 3 1 
915 2 4 5 5 5 6 4 4 6 6 5 5 6 3 3 5 5 2 3 2 2 1 1 2 2 5 6 2 
915 2 4 5 5 5 6 4 4 6 6 5 5 6 3 3 5 5 2 3 2 2 1 1 2 2 5 6 2 
915 2 4 5 5 5 6 4 4 6 6 5 5 6 3 3 5 5 2 3 2 2 1 1 2 2 5 6 1 1 
915 2 4 5 5 5 6 4 4 6 6 5 5 6 3 3 5 5 2 3 2 2 1 1 2 2 5 6 1 1 
915 2 4 5 5 5 6 4 4 6 6 5 5 6 3 3 5 5 2 3 2 2 1 1 2 2 5 6 1 1 
915 2 4 5 5 5 6 4 4 6 6 5 5 6 3 3 5 5 2 3 2 2 1 1 2 2 5 6 1 1 
915 2 4 5 5 5 6 4 4 6 6 5 5 6 3 3 5 5 2 3 2 2 1 1 2 2 5 6 2 
915 2 4 5 5 5 6 4 4 6 6 5 5 6 3 3 5 5 2 3 2 2 1 1 2 2 5 6 2 
915 2 4 5 5 5 6 4 4 6 6 5 5 6 3 3 5 5 2 3 2 2 1 1 2 2 5 6 1 1 
915 2 4 5 5 5 6 4 4 6 6 5 5 6 3 3 5 5 2 3 2 2 1 1 2 2 5 6 1 1 
915 2 4 5 5 5 6 4 4 6 6 5 5 6 3 3 5 5 2 3 2 2 1 1 2 2 5 6 2 
915 2 4 5 5 5 6 4 4 6 6 5 5 6 3 3 5 5 2 3 2 2 1 1 2 2 5 6 2 
915 2 4 5 5 5 6 4 4 6 6 5 5 6 3 3 5 5 2 3 2 2 1 1 2 2 5 6 2 
915 2 4 5 5 5 6 4 4 6 6 5 5 6 3 3 5 5 2 3 2 2 1 1 2 2 5 6 1 1 
915 2 4 5 5 5 6 4 4 6 6 5 5 6 3 3 5 5 2 3 2 2 1 1 2 2 5 6 2 
915 2 4 5 5 5 6 4 4 6 6 5 5 6 3 3 5 5 2 3 2 2 1 1 2 2 5 6 1 1 
915 2 4 5 5 5 6 4 4 6 6 5 5 6 3 3 5 5 2 3 2 2 1 1 2 2 5 6 1 1 
915 2 4 5 5 5 6 4 4 6 6 5 5 6 3 3 5 5 2 3 2 2 1 1 2 2 5 6 1 1 
915 2 4 5 5 5 6 4 4 6 6 5 5 6 3 3 5 5 2 3 2 2 1 1 2 2 5 6 1 1 
915 2 4 5 5 5 6 4 4 6 6 5 5 6 3 3 5 5 2 3 2 2 1 1 2 2 5 6 2 
915 2 4 5 5 5 6 4 4 6 6 5 5 6 3 3 5 5 2 3 2 2 1 1 2 2 5 6 4 1 
910 2 4 5 5 5 6 4 4 6 6 5 5 6 3 3 5 5 2 3 2 2 1 1 2 2 5 3 1 5 3 1 
900 2 4 5 5 5 6 4 4 6 6 5 5 6 3 3 5 5 2 3 2 2 1 1 2 2 5 6 3 3 1 
900 2 4 5 5 5 6 4 4 6 6 5 5 6 3 3 5 5 2 3 2 2 1 1 2 2 5 6 1 3 3 
900 2 4 5 5 5 6 4 4 6 6 5 5 6 3 3 5 5 2 3 2 2 1 1 2 2 5 6 1 3 3 
900 2 4 5 5 5 6 4 4 6 6 5 5 6 3 3 5 5 2 3 2 2 1 1 2 2 5 6 3 1 3 
900 2 4 5 5 5 6 4 4 6 6 5 5 6 3 3 5 5 2 3 2 2 1 1 2 2 5 6 1 3 3 
875 2 4 5 5 5 6 4 4 6 6 5 5 6 3 3 5 5 2 3 2 2 1 1 2 2 5 5 1 
875 2 4 5 5 5 6 4 4 6 6 5 5 6 3 3 5 5 2 3 2 2 1 1 2 2 5 2 1 
855 2 4 5 5 5 6 4 4 6 6 5 5 6 3 3 5 5 2 3 2 2 1 1 2 2 5 5 3 
855 2 4 5 5 5 6 4 4 6 6 5 5 6 3 3 5 5 2 3 2 2 1 1 2 2 5 3 5 
855 2 4 5 5 5 6 4 4 6 6 5 5 6 3 3 5 5 2 3 2 2 1 1 2 2 5 5 3 
855 2 4 5 5 5 6 4 4 6 6 5 5 6 3 3 5 5 2 3 2 2 1 1 2 2 5 3 4 1 
845 2 4 5 5 5 6 4 4 6 6 5 5 6 3 3 5 5 2 3 2 2 1 1 2 2 4 6 3 
825 2 4 5 5 5 6 4 4 6 6 5 5 6 3 3 5 5 2 3 2 2 1 1 2 2 5 4 
825 2 4 5 5 5 6 4 4 6 6 5 5 6 3 3 5 5 2 3 2 2 1 1 2 2 5 1 
825 2 4 5 5 5 6 4 4 6 6 5 5 6 3 3 5 5 2 3 2 2 1 1 2 2 5 4 
825 2 4 5 5 5 6 4 4 6 6 5 5 6 3 3 5 5 2 3 2 2 1 1 2 2 5 4 
825 2 4 5 5 5 6 4 4 6 6 5 5 6 3 3 5 5 2 3 2 2 1 1 2 2 5 1 
825 2 4 5 5 5 6 4 4 6 6 5 5 6 3 3 5 5 2 3 2 2 1 1 2 2 5 1 
825 2 4 5 5 5 6 4 4 6 6 5 5 6 3 3 5 5 2 3 2 2 1 1 2 2 5 4 
825 2 4 5 5 5 6 4 4 6 6 5 5 6 3 3 5 5 2 3 2 2 1 1 2 2 5 1 
825 2 4 5 5 5 6 4 4 6 6 5 5 6 3 3 5 5 2 3 2 2 1 1 2 2 5 1 
780 2 4 5 5 5 6 4 4 6 6 5 5 6 3 3 5 5 2 3 2 2 1 1 2 2 1 3 
585 2 4 5 5 5 6 4 4 6 6 5 5 6 3 3 5 5 2 3 2 2 1 1 2 2 5 6 1 4 4 1 
585 2 4 5 5 5 6 4 4 6 6 5 5 6 3 3 5 5 2 3 2 2 1 1 2 2 5 6 1 4 4 1 
585 2 4 5 5 5 6 4 4 6 6 5 5 6 3 3 5 5 2 3 2 2 1 1 2 2 5 6 1 4 4 1 
585 2 4 5 5 5 6 4 4 6 6 5 5 6 3 3 5 5 2 3 2 2 1 1 2 2 5 6 1 4 4 1 
585 2 4 5 5 5 6 4 4 6 6 5 5 6 3 3 5 5 2 3 2 2 1 1 2 2 5 6 1 4 4 1 
585 2 4 5 5 5 6 4 4 6 6 5 5 6 3 3 5 5 2 3 2 2 1 1 2 2 5 6 1 4 4 1 
585 2 4 5 5 5 6 4 4 6 6 5 5 6 3 3 5 5 2 3 2 2 1 1 2 2 5 6 1 4 4 1 
585 2 4 5 5 5 6 4 4 6 6 5 5 6 3 3 5 5 2 3 2 2 1 1 2 2 5 6 1 4 4 1 
585 2 4 5 5 5 6 4 4 6 6 5 5 6 3 3 5 5 2 3 2 2 1 1 2 2 5 6 1 4 4 1 
585 2 4 5 5 5 6 4 4 6 6 5 5 6 3 3 5 5 2 3 2 2 1 1 2 2 5 6 1 4 4 1 
585 2 4 5 5 5 6 4 4 6 6 5 5 6 3 3 5 5 2 3 2 2 1 1 2 2 5 6 1 4 4 1 
585 2 4 5 5 5 6 4 4 6 6 5 5 6 3 3 5 5 2 3 2 2 1 1 2 2 5 6 1 4 4 1 
585 2 4 5 5 5 6 4 4 6 6 5 5 6 3 3 5 5 2 3 2 2 1 1 2 2 5 6 1 4 4 1 
585 2 4 5 5 5 6 4 4 6 6 5 5 6 3 3 5 5 2 3 2 2 1 1 2 2 5 6 1 4 4 1 
585 2 4 5 5 5 6 4 4 6 6 5 5 6 3 3 5 5 2 3 2 2 1 1 2 2 5 6 1 4 4 1 
585 2 4 5 5 5 6 4 4 6 6 5 5 6 3 3 5 5 2 3 2 2 1 1 2 2 5 6 1 4 4 1 
585 2 4 5 5 5 6 4 4 6 6 5 5 6 3 3 5 5 2 3 2 2 1 1 2 2 5 6 1 4 4 1 
585 2 4 5 5 5 6 4 4 6 6 5 5 6 3 3 5 5 2 3 2 2 1 1 2 2 5 6 1 4 4 1 
585 2 4 5 5 5 6 4 4 6 6 5 5 6 3 3 5 5 2 3 2 2 1 1 2 2 5 6 1 4 4 1 
585 2 4 5 5 5 6 4 4 6 6 5 5 6 3 3 5 5 2 3 2 2 1 1 2 2 5 6 1 4 4 1 
585 2 4 5 5 5 6 4 4 6 6 5 5 6 3 3 5 5 2 3 2 2 1 1 2 2 5 6 1 4 4 1 
585 2 4 5 5 5 6 4 4 6 6 5 5 6 3 3 5 5 2 3 2 2 1 1 2 2 5 6 1 4 4 1 
585 2 4 5 5 5 6 4 4 6 6 5 5 6 3 3 5 5 2 3 2 2 1 1 2 2 5 6 1 4 4 1 
585 2 4 5 5 5 6 4 4 6 6 5 5 6 3 3 5 5 2 3 2 2 1 1 2 2 5 6 1 4 4 1 
585 2 4 5 5 5 6 4 4 6 6 5 5 6 3 3 5 5 2 3 2 2 1 1 2 2 5 6 1 4 4 1 
585 2 4 5 5 5 6 4 4 6 6 5 5 6 3 3 5 5 2 3 2 2 1 1 2 2 5 6 1 4 4 1 
585 2 4 5 5 5 6 4 4 6 6 5 5 6 3 3 5 5 2 3 2 2 1 1 2 2 5 6 1 4 
585 2 4 5 5 5 6 4 4 6 6 5 5 6 3 3 5 5 2 3 2 2 1 1 2 2 5 6 1 4 
585 2 4 5 5 5 6 4 4 6 6 5 5 6 3 3 5 5 2 3 2 2 1 1 2 2 5 6 1 4 
585 2 4 5 5 5 6 4 4 6 6 5 5 6 3 3 5 5 2 3 2 2 1 1 2 2 5 6 1 4 4 1 
585 2 4 5 5 5 6 4 4 6 6 5 5 6 3 3 5 5 2 3 2 2 1 1 2 2 5 6 1 4 4 1 
585 2 4 5 5 5 6 4 4 6 6 5 5 6 3 3 5 5 2 3 2 2 1 1 2 2 5 6 1 4 4 1 
585 2 4 5 5 5 6 4 4 6 6 5 5 6 3 3 5 5 2 3 2 2 1 1 2 2 5 6 1 4 4 1 
585 2 4 5 5 5 6 4 4 6 6 5 5 6 3 3 5 5 2 3 2 2 1 1 2 2 5 6 1 4 4 1 
585 2 4 5 5 5 6 4 4 6 6 5 5 6 3 3 5 5 2 3 2 2 1 1 2 2 5 6 1 4 4 1 
580 2 4 5 5 5 6 4 4 6 6 5 5 6 3 3 5 5 2 3 2 2 1 1 2 2 5 6 1 3 
575 2 4 5 5 5 6 4 4 6 6 5 5 6 3 3 5 5 2 3 2 2 1 1 2 2 5 6 1 
575 2 4 5 5 5 6 4 4 6 6 5 5 6 3 3 5 5 2 3 2 2 1 1 2 2 5 6 1 
560 2 4 5 5 5 6 4 4 6 6 5 5 6 3 3 5 5 2 3 2 2 1 1 2 2 5 6 1 
560 2 4 5 5 5 6 4 4 6 6 5 5 6 3 3 5 5 2 3 2 2 1 1 2 2 5 6 1 
560 2 4 5 5 5 6 4 4 6 6 5 5 6 3 3 5 5 2 3 2 2 1 1 2 2 5 6 1 
535 2 4 5 5 5 6 4 4 6 6 5 5 6 3 3 5 5 2 3 2 2 1 1 2 2 5 6 1 
535 2 4 5 5 5 6 4 4 6 6 5 5 6 3 3 5 5 2 3 2 2 1 1 2 2 5 6 
535 2 4 5 5 5 6 4 4 6 6 5 5 6 3 3 5 5 2 3 2 2 1 1 2 2 5 6 1 
515 2 4 5 5 5 6 4 4 6 6 5 5 6 3 3 5 5 2 3 2 2 1 1 2 2 5 6 1 3 
-155 2 4 5 5 5 6 4 4 6 6 5 5 6 3 3 5 5 2 3 2 2 1 1 2 2 5 6 1 4 4 1 4 5 1 1 
