625 4 1 6 5 5 5 5 5 6 1 6 5 6 5 6 5 4 2 5 
605 4 1 6 5 5 6 4 4 6 2 2 6 3 5 5 5 5 2 1 6 4 
545 4 1 6 5 5 6 4 4 6 2 2 6 6 1 5 6 5 1 3 
470 4 1 6 5 5 6 4 4 6 2 2 6 3 6 4 6 2 
460 4 1 6 5 5 6 4 4 6 2 2 6 3 5 3 4 6 2 
425 4 1 6 5 5 6 4 4 6 2 2 6 3 6 6 3 1 
425 4 1 6 5 5 6 4 4 6 2 2 6 3 5 1 3 5 3 1 
420 4 1 6 5 5 6 4 4 6 2 2 6 3 6 6 1 
405 4 1 6 5 5 6 4 4 6 2 2 6 3 6 4 2 
395 4 1 6 5 5 6 4 4 6 2 2 6 3 5 1 3 2 
385 4 1 6 5 5 6 4 4 6 2 2 6 3 6 3 2 
380 4 1 6 5 5 6 4 4 6 2 2 6 3 6 4 1 
380 4 1 6 5 5 6 4 4 6 2 2 6 3 6 2 
380 4 1 6 5 5 6 4 4 6 2 2 6 3 6 5 
375 4 1 6 5 5 6 4 4 6 2 2 6 6 4 1 
375 4 1 6 5 5 6 4 4 6 2 2 6 3 5 3 3 5 
375 4 1 6 5 5 6 4 4 6 2 2 6 6 2 
375 4 1 6 5 5 6 4 4 6 2 2 6 6 4 4 
355 4 1 6 5 5 6 4 4 6 2 2 6 3 6 1 
345 4 1 6 5 5 6 4 4 6 2 3 1 1 3 5 3 5 1 3 3 
340 4 1 6 5 5 6 4 4 6 2 2 6 3 6 3 3 
315 4 1 6 5 5 6 4 4 6 2 3 4 4 6 2 
315 4 1 6 5 5 6 4 4 6 2 2 6 3 2 
310 4 1 6 5 5 6 4 4 6 2 2 6 5 
310 4 1 6 5 5 6 4 4 6 2 2 6 2 
310 4 1 6 5 5 6 4 4 6 2 2 6 5 
300 4 1 6 5 5 6 4 4 6 2 3 1 1 5 2 
300 4 1 6 5 5 6 4 4 6 2 1 1 3 5 2 
300 4 1 6 5 5 6 4 4 6 2 3 1 4 5 4 1 
290 4 1 6 5 5 6 4 4 6 2 2 6 3 4 
290 4 1 6 5 5 6 4 4 6 2 2 6 3 1 
290 4 1 6 5 5 6 4 4 6 2 2 6 3 1 
290 4 1 6 5 5 6 4 4 6 2 2 6 3 4 
290 4 1 6 5 5 6 4 4 6 2 2 6 3 1 
290 4 1 6 5 5 6 4 4 6 2 2 6 3 1 
290 4 1 6 5 5 6 4 4 6 2 2 6 3 1 
290 4 1 6 5 5 6 4 4 6 2 2 6 3 1 
290 4 1 6 5 5 6 4 4 6 2 3 1 4 6 1 
285 4 1 6 5 5 6 4 4 6 2 5 6 4 
275 4 1 6 5 5 6 4 4 6 2 3 1 4 4 2 
270 4 1 6 5 5 6 4 4 6 2 4 3 4 3 6 
270 4 1 6 5 5 6 4 4 6 2 3 3 5 6 
270 4 1 6 5 5 6 4 4 6 2 1 4 4 2 
270 4 1 6 5 5 6 4 4 6 2 2 6 3 3 
270 4 1 6 5 5 6 4 4 6 2 2 6 3 3 
265 4 1 6 5 5 6 4 4 6 2 3 5 6 
250 4 1 6 5 5 6 4 4 6 2 3 1 2 1 
250 4 1 6 5 5 6 4 4 6 2 3 2 2 
250 4 1 6 5 5 6 4 4 6 2 3 5 4 4 
250 4 1 6 5 5 6 4 5 6 3 1 4 5 4 
245 4 1 6 5 5 6 4 4 6 2 5 2 
245 4 1 6 5 5 6 4 4 6 2 4 1 5 
245 4 1 6 5 5 6 4 4 6 2 4 1 4 4 
240 4 1 6 5 5 6 4 4 6 2 4 3 6 
240 4 1 6 5 5 6 4 4 6 2 3 1 6 
240 4 1 6 5 5 6 4 4 6 2 3 6 1 
235 4 1 6 5 5 6 4 4 6 4 2 6 
230 4 1 6 5 5 6 4 4 6 2 3 1 3 1 1 
230 4 1 6 5 5 6 4 4 6 2 3 1 1 1 3 
215 4 1 6 5 5 6 4 4 6 2 3 4 3 3 3 1 
0 4 1 6 5 5 6 4 5 5 3 2 2 4 6 
-25 4 1 6 5 5 6 4 4 6 2 3 1 5 5 
-25 4 1 6 5 5 6 4 4 6 2 3 1 2 5 
-80 4 1 6 5 5 6 4 4 6 2 3 6 3 
