290 5 6 5 5 5 4 4 4 1 5 4 1 3 2 2 4 5 3 3 3 6 5 2 1 5 
90 5 6 5 5 5 4 2 5 
90 5 6 5 5 5 5 5 1 5 2 
65 5 6 5 5 5 4 4 4 1 5 4 1 3 2 2 
65 5 6 5 5 5 4 4 4 1 5 4 1 3 2 2 4 
65 5 6 5 5 5 4 4 4 1 5 4 1 3 2 2 4 5 
65 5 6 5 5 5 4 4 4 1 5 4 1 3 2 2 
65 5 6 5 5 5 4 4 4 1 5 4 1 3 2 2 
65 5 6 5 5 5 4 4 4 1 5 4 1 3 2 2 4 5 
65 5 6 5 5 5 4 4 4 1 5 4 1 3 2 2 
65 5 6 5 5 5 4 4 4 1 5 4 1 3 2 2 4 
65 5 6 5 5 5 4 4 4 1 5 4 1 3 2 2 4 
65 5 6 5 5 5 4 4 4 1 5 4 1 3 2 2 4 
65 5 6 5 5 5 4 4 4 1 5 4 1 3 2 2 
65 5 6 5 5 5 4 4 4 1 5 4 1 3 2 2 4 5 
65 5 6 5 5 5 4 4 4 1 5 4 1 3 2 2 4 
65 5 6 5 5 5 4 4 4 1 5 4 1 3 2 2 
65 5 6 5 5 5 4 4 4 1 5 4 1 3 2 2 
65 5 6 5 5 5 4 4 4 1 5 4 1 3 2 2 4 5 
65 5 6 5 5 5 4 4 4 1 5 4 1 3 2 2 4 
65 5 6 5 5 5 4 4 4 1 5 4 1 3 2 2 4 5 
65 5 6 5 5 5 4 4 4 1 5 4 1 3 2 2 4 5 
65 5 6 5 5 5 4 4 4 1 5 4 1 3 2 2 4 
65 5 6 5 5 5 4 4 4 1 5 4 1 3 2 2 4 
65 5 6 5 5 5 4 4 4 1 5 4 1 3 2 2 4 5 
65 5 6 5 5 5 4 4 4 1 5 4 1 2 2 1 
65 5 6 5 5 5 4 4 4 1 5 4 1 
65 5 6 5 5 5 4 4 4 1 5 4 1 
65 5 6 5 5 5 4 4 4 1 5 4 1 2 2 
65 5 6 5 5 5 4 4 4 1 5 4 1 2 4 4 
65 5 6 5 5 5 4 4 4 1 5 4 1 2 2 
65 5 6 5 5 5 4 4 4 1 5 4 1 2 3 
65 5 6 5 5 5 4 4 4 1 5 4 1 2 2 
65 5 6 5 5 5 4 4 4 1 5 4 1 2 
65 5 6 5 5 5 4 4 4 1 5 4 1 2 2 1 
65 5 6 5 5 5 4 4 4 1 5 4 1 2 2 
65 5 6 5 5 5 4 4 4 1 5 4 1 2 2 
65 5 6 5 5 5 4 4 4 1 5 4 1 
65 5 6 5 5 5 4 4 4 1 5 4 1 2 3 4 
65 5 6 5 5 5 4 4 4 1 5 4 1 1 2 
65 5 6 5 5 5 4 4 4 1 5 4 1 2 1 
65 5 6 5 5 5 4 4 4 1 5 4 1 2 
65 5 6 5 5 5 4 4 4 1 5 4 1 5 3 
65 5 6 5 5 5 4 4 4 1 5 4 1 2 
65 5 6 5 5 5 4 4 4 1 5 4 1 2 
65 5 6 5 5 5 4 4 4 1 5 4 1 3 2 2 4 
65 5 6 5 5 5 4 4 4 1 5 4 1 3 2 2 4 5 
45 5 6 5 5 5 4 3 1 4 1 
