160 4 5 5 5 5 3 5 1 4 3 4 2 6 4 5 4 
95 4 5 5 5 5 3 5 1 4 3 6 5 2 3 
85 4 5 5 5 5 3 5 1 5 3 5 
15 4 5 5 5 5 3 5 1 4 2 2 4 6 2 3 1 3 
-5 4 5 5 5 5 3 5 1 4 2 2 4 6 1 3 1 
-55 4 5 5 5 5 3 5 1 4 2 2 4 6 6 2 3 
-75 4 5 5 5 5 3 5 1 5 4 3 6 
-85 4 5 5 5 5 3 5 1 4 3 2 6 4 
-85 4 5 5 5 5 3 5 1 4 3 6 2 6 
-110 4 5 5 5 5 3 5 1 4 2 2 4 6 2 1 
-130 4 5 5 5 5 3 5 1 4 2 2 4 6 2 2 4 
-155 4 5 5 5 5 3 5 1 4 2 2 4 3 
-155 4 5 5 5 5 3 5 1 4 2 2 1 2 
-160 4 5 5 5 5 3 5 1 4 6 3 6 
-160 4 5 5 5 5 3 5 1 4 2 2 1 3 6 
-165 4 5 5 5 5 3 5 1 4 2 2 4 6 
-165 4 5 5 5 5 3 5 1 4 2 2 4 6 3 2 
-165 4 5 5 5 5 3 5 1 4 2 2 4 6 3 
-165 4 5 5 5 5 3 5 1 4 2 2 3 3 
-165 4 5 5 5 5 3 5 1 4 2 2 4 3 6 
-165 4 5 5 5 5 3 5 1 4 2 2 4 6 5 
-165 4 5 5 5 5 3 5 1 4 2 2 4 6 4 2 
-165 4 5 5 5 5 3 5 1 4 3 6 6 4 
-170 4 5 5 5 5 3 5 1 4 2 2 4 4 3 
-175 4 5 5 5 5 3 5 1 3 3 
-180 4 5 5 5 5 3 5 1 4 3 4 
-195 4 5 5 5 5 3 5 1 4 3 6 4 4 4 
-195 4 5 5 5 5 3 5 1 4 3 6 3 
-195 4 5 5 5 5 3 5 1 4 3 3 
-195 4 5 5 5 5 3 5 1 4 3 2 6 
-195 4 5 5 5 5 3 5 1 4 2 2 4 5 3 1 
-195 4 5 5 5 5 3 5 1 2 3 3 
-200 4 5 5 5 5 3 5 1 4 4 4 2 
-225 4 5 5 5 5 3 5 1 4 2 2 
-235 4 5 5 5 5 3 5 1 4 1 6 6 
-455 4 5 5 5 5 3 5 1 4 2 2 
-495 4 5 5 5 5 3 5 1 4 2 2 4 
-495 4 5 5 5 5 3 5 1 4 2 2 4 
-495 4 5 5 5 5 3 5 1 4 2 2 4 
-520 4 5 5 5 5 3 5 1 4 5 
-525 4 5 5 5 5 3 5 1 4 3 
-525 4 5 5 5 5 3 5 1 4 3 
-525 4 5 5 5 5 3 5 1 4 2 2 4 
-525 4 5 5 5 5 3 5 1 4 2 2 4 
-540 4 5 5 5 5 3 5 1 4 2 2 4 
-555 4 5 5 5 5 3 5 1 
-580 4 5 5 5 5 3 5 
-580 4 5 5 5 5 3 5 1 4 2 2 
