800 4 4 6 5 5 6 4 5 5 1 2 1 3 5 3 6 4 5 6 4 6 1 2 1 2 1 6 
770 4 4 6 5 5 6 4 5 5 1 2 1 3 5 3 6 4 5 6 4 6 1 2 1 1 2 1 3 3 5 
740 4 4 6 5 5 6 4 5 5 1 2 1 3 5 3 6 4 5 6 4 6 1 2 1 1 2 3 
735 4 4 6 5 5 6 4 5 5 1 2 1 3 5 3 6 4 5 6 4 6 1 2 1 2 4 
725 4 4 6 5 5 6 4 5 5 1 2 1 3 5 3 6 4 5 6 4 6 1 2 1 6 
725 4 4 6 5 5 6 4 5 5 1 2 1 3 5 3 6 4 5 6 4 6 1 2 1 6 
715 4 4 6 5 5 6 4 5 5 1 2 1 3 5 3 6 4 5 6 4 6 1 2 1 2 3 
710 4 4 6 5 5 6 4 5 5 1 2 1 3 5 3 6 4 5 6 4 6 1 2 1 5 
710 4 4 6 5 5 6 4 5 5 1 2 1 3 5 3 6 4 5 6 4 6 1 2 1 5 
710 4 4 6 5 5 6 4 5 5 1 2 1 3 5 3 6 4 5 6 4 6 1 2 2 4 
710 4 4 6 5 5 6 4 5 5 1 2 1 3 5 3 6 4 5 6 4 6 1 2 1 5 
700 4 4 6 5 5 6 4 5 5 1 2 1 3 5 3 6 4 5 6 4 6 1 1 1 6 
700 4 4 6 5 5 6 4 5 5 1 2 1 3 5 3 6 4 5 6 4 6 1 2 6 
685 4 4 6 5 5 6 4 5 5 1 2 1 3 5 3 6 4 5 6 4 6 1 2 5 
685 4 4 6 5 5 6 4 5 5 1 2 1 3 5 3 6 4 5 6 4 6 1 2 5 
685 4 4 6 5 5 6 4 5 5 1 2 1 3 5 3 6 4 5 6 4 6 1 2 5 
665 4 4 6 5 5 6 4 5 5 1 2 1 3 5 3 6 4 5 6 4 6 1 2 1 3 
665 4 4 6 5 5 6 4 5 5 1 2 1 3 5 3 6 4 5 6 4 6 1 2 1 3 
660 4 4 6 5 5 6 4 5 5 1 2 1 3 5 3 6 4 5 6 4 6 1 1 5 
660 4 4 6 5 5 6 4 5 5 1 2 1 3 5 3 6 4 5 6 4 6 1 2 4 
660 4 4 6 5 5 6 4 5 5 1 2 1 3 5 3 6 4 5 6 4 6 1 2 4 
650 4 4 6 5 5 6 4 5 5 1 2 1 3 5 3 6 4 5 6 4 6 1 6 
650 4 4 6 5 5 6 4 5 5 1 2 1 3 5 3 6 4 5 6 4 6 1 6 
640 4 4 6 5 5 6 4 5 5 1 2 1 3 5 3 6 4 5 6 4 6 1 2 3 
640 4 4 6 5 5 6 4 5 5 1 2 1 3 5 3 6 4 5 6 4 6 1 2 3 
635 4 4 6 5 5 6 4 5 5 1 2 1 3 5 3 6 4 5 6 4 6 1 5 
635 4 4 6 5 5 6 4 5 5 1 2 1 3 5 3 6 4 5 6 4 6 1 5 
590 4 4 6 5 5 6 4 5 5 1 2 1 3 5 3 6 4 5 6 4 6 1 3 
590 4 4 6 5 5 6 4 5 5 1 2 1 3 5 3 6 4 5 6 4 6 1 3 
590 4 4 6 5 5 6 4 5 5 1 2 1 3 5 3 6 4 5 6 4 6 1 3 
