125 4 2 5 5 5 5 5 5 5 
125 4 2 5 5 5 5 5 5 2 
125 4 2 5 5 5 5 5 5 2 
115 4 2 5 5 5 5 5 1 6 
115 4 2 5 5 5 5 4 6 2 
115 4 2 5 5 5 5 4 6 5 
115 4 2 5 5 5 5 4 2 6 
115 4 2 5 5 5 5 5 1 6 
105 4 2 5 5 5 6 2 6 
100 4 2 5 5 5 5 5 4 5 
100 4 2 5 5 5 5 5 2 4 
100 4 2 5 5 5 5 5 5 1 
100 4 2 5 5 5 5 5 5 1 
100 4 2 5 5 5 5 5 2 4 
100 4 2 5 5 5 5 5 2 1 
100 4 2 5 5 5 5 5 5 4 
100 4 2 5 5 5 5 5 5 1 
90 4 2 5 5 5 5 6 2 
90 4 2 5 5 5 5 6 2 
90 4 2 5 5 5 5 5 6 
90 4 2 5 5 5 6 5 2 
90 4 2 5 5 5 5 6 5 
90 4 2 5 5 5 5 5 6 
90 4 2 5 5 5 6 2 2 
90 4 2 5 5 5 6 2 5 
80 4 2 5 5 5 5 5 5 3 
80 4 2 5 5 5 5 5 3 2 3 
80 4 2 5 5 5 6 6 1 
75 4 2 5 5 5 5 5 1 4 
75 4 2 5 5 5 5 5 1 4 
70 4 2 5 5 5 5 4 6 3 
65 4 2 5 5 5 5 6 1 
55 4 2 5 5 5 5 5 3 1 1 
55 4 2 5 5 5 5 5 3 1 5 
55 4 2 5 5 5 5 5 1 3 
55 4 2 5 5 5 5 5 3 1 3 
55 4 2 5 5 5 5 5 3 4 6 
55 4 2 5 5 5 5 5 3 1 6 
25 4 2 5 5 5 5 2 
25 4 2 5 5 5 5 2 
0 4 2 5 5 5 5 1 
0 4 2 5 5 5 5 1 
-5 4 2 5 5 5 6 3 
-20 4 2 5 5 5 5 3 
-20 4 2 5 5 5 5 3 
-20 4 2 5 5 5 5 3 
-20 4 2 5 5 5 5 3 
-20 4 2 5 5 5 5 3 
