1000049 5 6 5 5 3 4 6 4 6 3 1 3 1 2 5 6 6 6 2 3 6 2 2 2 2 2 3 6 6 4 6 6 2 3 1 4 6 6 6 6 1 6 3 1 6 2 
1000049 5 6 5 5 3 4 6 4 6 3 1 3 1 2 5 6 6 6 2 3 6 2 2 2 2 2 3 6 6 4 6 6 2 3 1 4 6 6 6 6 4 6 1 6 1 2 
1000049 5 6 5 5 3 4 6 4 6 3 1 3 1 2 5 6 6 6 2 3 6 2 2 2 2 2 3 6 6 4 6 6 2 3 1 4 6 6 6 6 4 6 2 3 3 5 5 
1000049 5 6 5 5 3 4 6 4 6 3 1 3 1 2 5 6 6 6 2 3 6 2 2 2 2 2 3 6 6 4 6 6 2 3 1 4 6 6 6 6 4 6 5 6 2 
1000024 5 6 5 5 3 4 6 4 6 3 1 3 1 2 5 6 6 6 2 3 6 2 2 2 2 2 3 6 6 4 6 6 2 3 1 4 6 6 6 6 4 6 1 5 6 4 
1000024 5 6 5 5 3 4 6 4 6 3 1 3 1 2 5 6 6 6 2 3 6 2 2 2 2 2 3 6 6 4 6 6 2 3 1 4 6 6 6 6 4 6 1 4 6 4 
1000024 5 6 5 5 3 4 6 4 6 3 1 3 1 2 5 6 6 6 2 3 6 2 2 2 2 2 3 6 6 4 6 6 2 3 1 4 6 6 6 6 4 6 3 2 5 1 1 
1000024 5 6 5 5 3 4 6 4 6 3 1 3 1 2 5 6 6 6 2 3 6 2 2 2 2 2 3 6 6 4 6 6 2 3 1 4 6 6 6 6 4 3 6 5 5 1 4 
1000024 5 6 5 5 3 4 6 4 6 3 1 3 1 2 5 6 6 6 2 3 6 2 2 2 2 2 3 6 6 4 6 6 2 3 1 4 6 6 6 6 4 6 5 1 6 1 
999999 5 6 5 5 3 4 6 4 6 3 1 3 1 2 5 6 6 6 2 3 6 2 2 2 2 2 3 6 6 4 6 6 2 3 1 4 6 6 6 6 4 6 3 4 5 3 1 5 
999999 5 6 5 5 3 4 6 4 6 3 1 3 1 2 5 6 6 6 2 3 6 2 2 2 2 2 3 6 6 4 6 6 2 3 1 4 6 6 6 6 4 3 6 5 5 3 3 5 
1545 5 6 5 5 3 4 6 4 6 3 1 3 1 2 5 6 6 6 2 3 6 2 2 2 2 2 3 6 6 4 6 6 2 3 1 4 6 5 2 3 1 5 5 6 1 3 3 
1530 5 6 5 5 3 4 6 4 6 3 1 3 1 2 5 6 6 6 2 3 6 2 2 2 2 2 3 6 6 4 6 6 2 3 1 4 6 6 6 6 4 3 2 
1525 5 6 5 5 3 4 6 4 6 3 1 3 1 2 5 6 6 6 2 3 6 2 2 2 2 2 3 6 6 4 6 6 2 3 1 4 6 6 6 6 4 2 
1525 5 6 5 5 3 4 6 4 6 3 1 3 1 2 5 6 6 6 2 3 6 2 2 2 2 2 3 6 6 4 6 6 2 3 1 4 6 6 6 6 4 2 
1525 5 6 5 5 3 4 6 4 6 3 1 3 1 2 5 6 6 6 2 3 6 2 2 2 2 2 3 6 6 4 6 6 2 3 1 4 6 6 6 6 4 2 
1525 5 6 5 5 3 4 6 4 6 3 1 3 1 2 5 6 6 6 2 3 6 2 2 2 2 2 3 6 6 4 6 6 2 3 1 4 6 6 6 6 1 2 
1525 5 6 5 5 3 4 6 4 6 3 1 3 1 2 5 6 6 6 2 3 6 2 2 2 2 2 3 6 6 4 6 6 2 3 1 4 6 6 6 6 4 5 
1525 5 6 5 5 3 4 6 4 6 3 1 3 1 2 5 6 6 6 2 3 6 2 2 2 2 2 3 6 6 4 6 6 2 3 1 4 6 6 6 6 4 5 
1525 5 6 5 5 3 4 6 4 6 3 1 3 1 2 5 6 6 6 2 3 6 2 2 2 2 2 3 6 6 4 6 6 2 3 1 4 6 6 6 6 4 5 
1525 5 6 5 5 3 4 6 4 6 3 1 3 1 2 5 6 6 6 2 3 6 2 2 2 2 2 3 6 6 4 6 6 2 3 1 4 6 6 6 6 4 5 
1525 5 6 5 5 3 4 6 4 6 3 1 3 1 2 5 6 6 6 2 3 6 2 2 2 2 2 3 6 6 4 6 6 2 3 1 4 6 6 6 6 4 5 
1525 5 6 5 5 3 4 6 4 6 3 1 3 1 2 5 6 6 6 2 3 6 2 2 2 2 2 3 6 6 4 6 6 2 3 1 4 6 6 6 6 4 2 
1525 5 6 5 5 3 4 6 4 6 3 1 3 1 2 5 6 6 6 2 3 6 2 2 2 2 2 3 6 6 4 6 6 2 3 1 4 6 6 6 6 4 2 
1525 5 6 5 5 3 4 6 4 6 3 1 3 1 2 5 6 6 6 2 3 6 2 2 2 2 2 3 6 6 4 6 6 2 3 1 4 6 6 6 6 4 2 
1525 5 6 5 5 3 4 6 4 6 3 1 3 1 2 5 6 6 6 2 3 6 2 2 2 2 2 3 6 6 4 6 6 2 3 1 4 6 6 6 6 4 2 
1525 5 6 5 5 3 4 6 4 6 3 1 3 1 2 5 6 6 6 2 3 6 2 2 2 2 2 3 6 6 4 6 6 2 3 1 4 6 6 6 6 4 5 
1525 5 6 5 5 3 4 6 4 6 3 1 3 1 2 5 6 6 6 2 3 6 2 2 2 2 2 3 6 6 4 6 6 2 3 1 4 6 6 6 6 4 2 
1525 5 6 5 5 3 4 6 4 6 3 1 3 1 2 5 6 6 6 2 3 6 2 2 2 2 2 3 6 6 4 6 6 2 3 1 4 6 6 6 6 4 5 
1525 5 6 5 5 3 4 6 4 6 3 1 3 1 2 5 6 6 6 2 3 6 2 2 2 2 2 3 6 6 4 6 6 2 3 1 4 6 6 6 6 4 2 
1525 5 6 5 5 3 4 6 4 6 3 1 3 1 2 5 6 6 6 2 3 6 2 2 2 2 2 3 6 6 4 6 6 2 3 1 4 6 6 6 6 4 2 
1525 5 6 5 5 3 4 6 4 6 3 1 3 1 2 5 6 6 6 2 3 6 2 2 2 2 2 3 6 6 4 6 6 2 3 1 4 6 6 6 6 4 2 
1515 5 6 5 5 3 4 6 4 6 3 1 3 1 2 5 6 6 6 2 3 6 2 2 2 2 2 3 6 6 4 6 6 2 3 1 4 6 6 6 6 6 
1515 5 6 5 5 3 4 6 4 6 3 1 3 1 2 5 6 6 6 2 3 6 2 2 2 2 2 3 6 6 4 6 6 2 3 1 4 6 6 6 6 6 
1515 5 6 5 5 3 4 6 4 6 3 1 3 1 2 5 6 6 6 2 3 6 2 2 2 2 2 3 6 6 4 6 6 2 3 1 4 6 6 6 6 6 
1515 5 6 5 5 3 4 6 4 6 3 1 3 1 2 5 6 6 6 2 3 6 2 2 2 2 2 3 6 6 4 6 6 2 3 1 4 6 6 6 6 6 
1515 5 6 5 5 3 4 6 4 6 3 1 3 1 2 5 6 6 6 2 3 6 2 2 2 2 2 3 6 6 4 6 6 2 3 1 4 6 6 6 6 6 
1515 5 6 5 5 3 4 6 4 6 3 1 3 1 2 5 6 6 6 2 3 6 2 2 2 2 2 3 6 6 4 6 6 2 3 1 4 6 6 6 6 6 
1515 5 6 5 5 3 4 6 4 6 3 1 3 1 2 5 6 6 6 2 3 6 2 2 2 2 2 3 6 6 4 6 6 2 3 1 4 6 6 6 6 6 
1515 5 6 5 5 3 4 6 4 6 3 1 3 1 2 5 6 6 6 2 3 6 2 2 2 2 2 3 6 6 4 6 6 2 3 1 4 6 6 6 6 6 
1515 5 6 5 5 3 4 6 4 6 3 1 3 1 2 5 6 6 6 2 3 6 2 2 2 2 2 3 6 6 4 6 6 2 3 1 4 6 6 6 6 6 
1515 5 6 5 5 3 4 6 4 6 3 1 3 1 2 5 6 6 6 2 3 6 2 2 2 2 2 3 6 6 4 6 6 2 3 1 4 6 6 4 5 6 1 3 4 
1515 5 6 5 5 3 4 6 4 6 3 1 3 1 2 5 6 6 6 2 3 6 2 2 2 2 2 3 6 6 4 6 6 2 3 1 4 6 6 6 6 6 
1515 5 6 5 5 3 4 6 4 6 3 1 3 1 2 5 6 6 6 2 3 6 2 2 2 2 2 3 6 6 4 6 6 2 3 1 4 6 6 6 6 6 
1515 5 6 5 5 3 4 6 4 6 3 1 3 1 2 5 6 6 6 2 3 6 2 2 2 2 2 3 6 6 4 6 6 2 3 1 4 6 6 6 6 6 
1505 5 6 5 5 3 4 6 4 6 3 1 3 1 2 5 6 6 6 2 3 6 2 2 2 2 2 3 6 6 4 6 6 2 3 1 4 6 6 6 6 4 3 1 
1505 5 6 5 5 3 4 6 4 6 3 1 3 1 2 5 6 6 6 2 3 6 2 2 2 2 2 3 6 6 4 6 6 2 3 1 4 6 6 6 6 4 3 4 
1505 5 6 5 5 3 4 6 4 6 3 1 3 1 2 5 6 6 6 2 3 6 2 2 2 2 2 3 6 6 4 6 6 2 3 1 4 6 6 6 6 4 3 1 
1500 5 6 5 5 3 4 6 4 6 3 1 3 1 2 5 6 6 6 2 3 6 2 2 2 2 2 3 6 6 4 6 6 2 3 1 4 6 6 6 6 5 
1500 5 6 5 5 3 4 6 4 6 3 1 3 1 2 5 6 6 6 2 3 6 2 2 2 2 2 3 6 6 4 6 6 2 3 1 4 6 6 6 6 1 4 
1500 5 6 5 5 3 4 6 4 6 3 1 3 1 2 5 6 6 6 2 3 6 2 2 2 2 2 3 6 6 4 6 6 2 3 1 4 6 6 6 6 4 1 
1500 5 6 5 5 3 4 6 4 6 3 1 3 1 2 5 6 6 6 2 3 6 2 2 2 2 2 3 6 6 4 6 6 2 3 1 4 6 6 6 6 4 1 
1500 5 6 5 5 3 4 6 4 6 3 1 3 1 2 5 6 6 6 2 3 6 2 2 2 2 2 3 6 6 4 6 6 2 3 1 4 6 6 6 6 2 
1500 5 6 5 5 3 4 6 4 6 3 1 3 1 2 5 6 6 6 2 3 6 2 2 2 2 2 3 6 6 4 6 6 2 3 1 4 6 6 6 6 1 1 
1500 5 6 5 5 3 4 6 4 6 3 1 3 1 2 5 6 6 6 2 3 6 2 2 2 2 2 3 6 6 4 6 6 2 3 1 4 6 6 6 6 5 
1500 5 6 5 5 3 4 6 4 6 3 1 3 1 2 5 6 6 6 2 3 6 2 2 2 2 2 3 6 6 4 6 6 2 3 1 4 6 6 6 6 5 
1500 5 6 5 5 3 4 6 4 6 3 1 3 1 2 5 6 6 6 2 3 6 2 2 2 2 2 3 6 6 4 6 6 2 3 1 4 6 6 6 6 5 
1500 5 6 5 5 3 4 6 4 6 3 1 3 1 2 5 6 6 6 2 3 6 2 2 2 2 2 3 6 6 4 6 6 2 3 1 4 6 6 6 6 5 
1500 5 6 5 5 3 4 6 4 6 3 1 3 1 2 5 6 6 6 2 3 6 2 2 2 2 2 3 6 6 4 6 6 2 3 1 4 6 6 6 6 5 
1500 5 6 5 5 3 4 6 4 6 3 1 3 1 2 5 6 6 6 2 3 6 2 2 2 2 2 3 6 6 4 6 6 2 3 1 4 6 6 6 6 4 4 
1500 5 6 5 5 3 4 6 4 6 3 1 3 1 2 5 6 6 6 2 3 6 2 2 2 2 2 3 6 6 4 6 6 2 3 1 4 6 6 6 6 2 
1500 5 6 5 5 3 4 6 4 6 3 1 3 1 2 5 6 6 6 2 3 6 2 2 2 2 2 3 6 6 4 6 6 2 3 1 4 6 6 6 6 5 
1500 5 6 5 5 3 4 6 4 6 3 1 3 1 2 5 6 6 6 2 3 6 2 2 2 2 2 3 6 6 4 6 6 2 3 1 4 6 6 6 6 5 
1500 5 6 5 5 3 4 6 4 6 3 1 3 1 2 5 6 6 6 2 3 6 2 2 2 2 2 3 6 6 4 6 6 2 3 1 4 6 6 6 6 2 
1500 5 6 5 5 3 4 6 4 6 3 1 3 1 2 5 6 6 6 2 3 6 2 2 2 2 2 3 6 6 4 6 6 2 3 1 4 6 6 6 6 5 
1500 5 6 5 5 3 4 6 4 6 3 1 3 1 2 5 6 6 6 2 3 6 2 2 2 2 2 3 6 6 4 6 6 2 3 1 4 6 6 6 6 1 1 
1500 5 6 5 5 3 4 6 4 6 3 1 3 1 2 5 6 6 6 2 3 6 2 2 2 2 2 3 6 6 4 6 6 2 3 1 4 6 6 6 6 4 1 
1500 5 6 5 5 3 4 6 4 6 3 1 3 1 2 5 6 6 6 2 3 6 2 2 2 2 2 3 6 6 4 6 6 2 3 1 4 6 6 6 6 4 1 
1500 5 6 5 5 3 4 6 4 6 3 1 3 1 2 5 6 6 6 2 3 6 2 2 2 2 2 3 6 6 4 6 6 2 3 1 4 6 6 6 6 2 
1500 5 6 5 5 3 4 6 4 6 3 1 3 1 2 5 6 6 6 2 3 6 2 2 2 2 2 3 6 6 4 6 6 2 3 1 4 6 6 6 6 5 
1500 5 6 5 5 3 4 6 4 6 3 1 3 1 2 5 6 6 6 2 3 6 2 2 2 2 2 3 6 6 4 6 6 2 3 1 4 6 6 6 6 5 
1500 5 6 5 5 3 4 6 4 6 3 1 3 1 2 5 6 6 6 2 3 6 2 2 2 2 2 3 6 6 4 6 6 2 3 1 4 6 6 6 6 2 
1500 5 6 5 5 3 4 6 4 6 3 1 3 1 2 5 6 6 6 2 3 6 2 2 2 2 2 3 6 6 4 6 6 2 3 1 4 6 6 6 6 4 4 
1500 5 6 5 5 3 4 6 4 6 3 1 3 1 2 5 6 6 6 2 3 6 2 2 2 2 2 3 6 6 4 6 6 2 3 1 4 6 6 6 6 1 1 
1500 5 6 5 5 3 4 6 4 6 3 1 3 1 2 5 6 6 6 2 3 6 2 2 2 2 2 3 6 6 4 6 6 2 3 1 4 6 6 6 6 5 
1500 5 6 5 5 3 4 6 4 6 3 1 3 1 2 5 6 6 6 2 3 6 2 2 2 2 2 3 6 6 4 6 6 2 3 1 4 6 6 6 6 4 4 
1500 5 6 5 5 3 4 6 4 6 3 1 3 1 2 5 6 6 6 2 3 6 2 2 2 2 2 3 6 6 4 6 6 2 3 1 4 6 6 6 6 5 
1500 5 6 5 5 3 4 6 4 6 3 1 3 1 2 5 6 6 6 2 3 6 2 2 2 2 2 3 6 6 4 6 6 2 3 1 4 6 6 6 6 4 1 
1500 5 6 5 5 3 4 6 4 6 3 1 3 1 2 5 6 6 6 2 3 6 2 2 2 2 2 3 6 6 4 6 6 2 3 1 4 6 6 6 6 5 
1500 5 6 5 5 3 4 6 4 6 3 1 3 1 2 5 6 6 6 2 3 6 2 2 2 2 2 3 6 6 4 6 6 2 3 1 4 6 6 6 6 2 
1500 5 6 5 5 3 4 6 4 6 3 1 3 1 2 5 6 6 6 2 3 6 2 2 2 2 2 3 6 6 4 6 6 2 3 1 4 6 6 6 6 2 
1500 5 6 5 5 3 4 6 4 6 3 1 3 1 2 5 6 6 6 2 3 6 2 2 2 2 2 3 6 6 4 6 6 2 3 1 4 6 6 6 6 4 1 
1500 5 6 5 5 3 4 6 4 6 3 1 3 1 2 5 6 6 6 2 3 6 2 2 2 2 2 3 6 6 4 6 6 2 3 1 4 6 6 6 6 4 1 
1500 5 6 5 5 3 4 6 4 6 3 1 3 1 2 5 6 6 6 2 3 6 2 2 2 2 2 3 6 6 4 6 6 2 3 1 4 6 6 6 6 2 
1500 5 6 5 5 3 4 6 4 6 3 1 3 1 2 5 6 6 6 2 3 6 2 2 2 2 2 3 6 6 4 6 6 2 3 1 4 6 6 6 6 5 
1480 5 6 5 5 3 4 6 4 6 3 1 3 1 2 5 6 6 6 2 3 6 2 2 2 2 2 3 6 6 4 6 6 2 3 1 4 6 5 1 5 2 2 
1475 5 6 5 5 3 4 6 4 6 3 1 3 1 2 5 6 6 6 2 3 6 2 2 2 2 2 3 6 6 4 6 6 2 3 1 4 6 6 3 4 5 4 2 
1465 5 6 5 5 3 4 6 4 6 3 1 3 1 2 5 6 6 6 2 3 6 2 2 2 2 2 3 6 6 4 6 6 2 3 1 4 6 6 3 4 5 6 
1455 5 6 5 5 3 4 6 4 6 3 1 3 1 2 5 6 6 6 2 3 6 2 2 2 2 2 3 6 6 4 6 6 2 3 1 4 6 6 6 6 3 
1455 5 6 5 5 3 4 6 4 6 3 1 3 1 2 5 6 6 6 2 3 6 2 2 2 2 2 3 6 6 4 6 6 2 3 1 4 6 6 6 6 3 
1455 5 6 5 5 3 4 6 4 6 3 1 3 1 2 5 6 6 6 2 3 6 2 2 2 2 2 3 6 6 4 6 6 2 3 1 4 6 6 6 6 3 
1455 5 6 5 5 3 4 6 4 6 3 1 3 1 2 5 6 6 6 2 3 6 2 2 2 2 2 3 6 6 4 6 6 2 3 1 4 6 6 6 3 6 
1455 5 6 5 5 3 4 6 4 6 3 1 3 1 2 5 6 6 6 2 3 6 2 2 2 2 2 3 6 6 4 6 6 2 3 1 4 6 6 6 3 6 
1455 5 6 5 5 3 4 6 4 6 3 1 3 1 2 5 6 6 6 2 3 6 2 2 2 2 2 3 6 6 4 6 6 2 3 1 4 6 6 6 6 3 
1455 5 6 5 5 3 4 6 4 6 3 1 3 1 2 5 6 6 6 2 3 6 2 2 2 2 2 3 6 6 4 6 6 2 3 1 4 6 6 6 6 3 
1455 5 6 5 5 3 4 6 4 6 3 1 3 1 2 5 6 6 6 2 3 6 2 2 2 2 2 3 6 6 4 6 6 2 3 1 4 6 6 6 6 3 
1455 5 6 5 5 3 4 6 4 6 3 1 3 1 2 5 6 6 6 2 3 6 2 2 2 2 2 3 6 6 4 6 6 2 3 1 4 6 6 6 6 3 
1455 5 6 5 5 3 4 6 4 6 3 1 3 1 2 5 6 6 6 2 3 6 2 2 2 2 2 3 6 6 4 6 6 2 3 1 4 6 6 6 6 3 
1455 5 6 5 5 3 4 6 4 6 3 1 3 1 2 5 6 6 6 2 3 6 2 2 2 2 2 3 6 6 4 6 6 2 3 1 4 6 6 6 6 3 
1455 5 6 5 5 3 4 6 4 6 3 1 3 1 2 5 6 6 6 2 3 6 2 2 2 2 2 3 6 6 4 6 6 2 3 1 4 6 6 6 3 6 
1455 5 6 5 5 3 4 6 4 6 3 1 3 1 2 5 6 6 6 2 3 6 2 2 2 2 2 3 6 6 4 6 6 2 3 1 4 6 6 6 6 3 
1450 5 6 5 5 3 4 6 4 6 3 1 3 1 2 5 6 6 6 2 3 6 2 2 2 2 2 3 6 6 4 6 6 2 3 1 4 6 6 4 3 5 2 
1445 5 6 5 5 3 4 6 4 6 3 1 3 1 2 5 6 6 6 2 3 6 2 2 2 2 2 3 6 6 4 6 6 2 3 1 4 6 6 3 3 5 6 
1445 5 6 5 5 3 4 6 4 6 3 1 3 1 2 5 6 6 6 2 3 6 2 2 2 2 2 3 6 6 4 6 6 2 3 1 4 6 6 4 2 5 
1445 5 6 5 5 3 4 6 4 6 3 1 3 1 2 5 6 6 6 2 3 6 2 2 2 2 2 3 6 6 4 6 6 2 3 1 4 6 6 4 5 5 
1440 5 6 5 5 3 4 6 4 6 3 1 3 1 2 5 6 6 6 2 3 6 2 2 2 2 2 3 6 6 4 6 6 2 3 1 4 6 6 6 3 2 
1440 5 6 5 5 3 4 6 4 6 3 1 3 1 2 5 6 6 6 2 3 6 2 2 2 2 2 3 6 6 4 6 6 2 3 1 4 6 6 6 3 2 
1440 5 6 5 5 3 4 6 4 6 3 1 3 1 2 5 6 6 6 2 3 6 2 2 2 2 2 3 6 6 4 6 6 2 3 1 4 6 6 6 3 5 
1440 5 6 5 5 3 4 6 4 6 3 1 3 1 2 5 6 6 6 2 3 6 2 2 2 2 2 3 6 6 4 6 6 2 3 1 4 6 6 6 3 5 
1440 5 6 5 5 3 4 6 4 6 3 1 3 1 2 5 6 6 6 2 3 6 2 2 2 2 2 3 6 6 4 6 6 2 3 1 4 6 6 6 3 5 
1440 5 6 5 5 3 4 6 4 6 3 1 3 1 2 5 6 6 6 2 3 6 2 2 2 2 2 3 6 6 4 6 6 2 3 1 4 6 6 6 3 5 
1440 5 6 5 5 3 4 6 4 6 3 1 3 1 2 5 6 6 6 2 3 6 2 2 2 2 2 3 6 6 4 6 6 2 3 1 4 6 6 6 3 4 4 
1440 5 6 5 5 3 4 6 4 6 3 1 3 1 2 5 6 6 6 2 3 6 2 2 2 2 2 3 6 6 4 6 6 2 3 1 4 6 6 6 3 5 
1440 5 6 5 5 3 4 6 4 6 3 1 3 1 2 5 6 6 6 2 3 6 2 2 2 2 2 3 6 6 4 6 6 2 3 1 4 6 6 6 3 4 4 
1435 5 6 5 5 3 4 6 4 6 3 1 3 1 2 5 6 6 6 2 3 6 2 2 2 2 2 3 6 6 4 6 6 2 3 1 4 6 6 6 5 
1435 5 6 5 5 3 4 6 4 6 3 1 3 1 2 5 6 6 6 2 3 6 2 2 2 2 2 3 6 6 4 6 6 2 3 1 4 6 6 6 5 
1435 5 6 5 5 3 4 6 4 6 3 1 3 1 2 5 6 6 6 2 3 6 2 2 2 2 2 3 6 6 4 6 6 2 3 1 4 6 6 6 5 
1435 5 6 5 5 3 4 6 4 6 3 1 3 1 2 5 6 6 6 2 3 6 2 2 2 2 2 3 6 6 4 6 6 2 3 1 4 6 6 6 2 
1435 5 6 5 5 3 4 6 4 6 3 1 3 1 2 5 6 6 6 2 3 6 2 2 2 2 2 3 6 6 4 6 6 2 3 1 4 6 6 6 5 
1435 5 6 5 5 3 4 6 4 6 3 1 3 1 2 5 6 6 6 2 3 6 2 2 2 2 2 3 6 6 4 6 6 2 3 1 4 6 6 6 2 
1435 5 6 5 5 3 4 6 4 6 3 1 3 1 2 5 6 6 6 2 3 6 2 2 2 2 2 3 6 6 4 6 6 2 3 1 4 6 6 6 2 
1435 5 6 5 5 3 4 6 4 6 3 1 3 1 2 5 6 6 6 2 3 6 2 2 2 2 2 3 6 6 4 6 6 2 3 1 4 6 6 6 2 
1435 5 6 5 5 3 4 6 4 6 3 1 3 1 2 5 6 6 6 2 3 6 2 2 2 2 2 3 6 6 4 6 6 2 3 1 4 6 6 6 2 
1435 5 6 5 5 3 4 6 4 6 3 1 3 1 2 5 6 6 6 2 3 6 2 2 2 2 2 3 6 6 4 6 6 2 3 1 4 6 6 6 2 
1435 5 6 5 5 3 4 6 4 6 3 1 3 1 2 5 6 6 6 2 3 6 2 2 2 2 2 3 6 6 4 6 6 2 3 1 4 6 6 6 2 
1435 5 6 5 5 3 4 6 4 6 3 1 3 1 2 5 6 6 6 2 3 6 2 2 2 2 2 3 6 6 4 6 6 2 3 1 4 6 6 6 2 
1435 5 6 5 5 3 4 6 4 6 3 1 3 1 2 5 6 6 6 2 3 6 2 2 2 2 2 3 6 6 4 6 6 2 3 1 4 6 6 6 2 
1435 5 6 5 5 3 4 6 4 6 3 1 3 1 2 5 6 6 6 2 3 6 2 2 2 2 2 3 6 6 4 6 6 2 3 1 4 6 6 6 5 
1435 5 6 5 5 3 4 6 4 6 3 1 3 1 2 5 6 6 6 2 3 6 2 2 2 2 2 3 6 6 4 6 6 2 3 1 4 6 6 6 5 
1435 5 6 5 5 3 4 6 4 6 3 1 3 1 2 5 6 6 6 2 3 6 2 2 2 2 2 3 6 6 4 6 6 2 3 1 4 6 6 6 5 
1435 5 6 5 5 3 4 6 4 6 3 1 3 1 2 5 6 6 6 2 3 6 2 2 2 2 2 3 6 6 4 6 6 2 3 1 4 6 6 6 5 
1435 5 6 5 5 3 4 6 4 6 3 1 3 1 2 5 6 6 6 2 3 6 2 2 2 2 2 3 6 6 4 6 6 2 3 1 4 6 6 6 5 
1435 5 6 5 5 3 4 6 4 6 3 1 3 1 2 5 6 6 6 2 3 6 2 2 2 2 2 3 6 6 4 6 6 2 3 1 4 6 6 6 5 
1435 5 6 5 5 3 4 6 4 6 3 1 3 1 2 5 6 6 6 2 3 6 2 2 2 2 2 3 6 6 4 6 6 2 3 1 4 6 6 6 5 
1435 5 6 5 5 3 4 6 4 6 3 1 3 1 2 5 6 6 6 2 3 6 2 2 2 2 2 3 6 6 4 6 6 2 3 1 4 6 6 6 5 
1435 5 6 5 5 3 4 6 4 6 3 1 3 1 2 5 6 6 6 2 3 6 2 2 2 2 2 3 6 6 4 6 6 2 3 1 4 6 6 6 2 
1435 5 6 5 5 3 4 6 4 6 3 1 3 1 2 5 6 6 6 2 3 6 2 2 2 2 2 3 6 6 4 6 6 2 3 1 4 6 6 6 5 
1435 5 6 5 5 3 4 6 4 6 3 1 3 1 2 5 6 6 6 2 3 6 2 2 2 2 2 3 6 6 4 6 6 2 3 1 4 6 6 6 2 
1435 5 6 5 5 3 4 6 4 6 3 1 3 1 2 5 6 6 6 2 3 6 2 2 2 2 2 3 6 6 4 6 6 2 3 1 4 6 6 6 5 
1435 5 6 5 5 3 4 6 4 6 3 1 3 1 2 5 6 6 6 2 3 6 2 2 2 2 2 3 6 6 4 6 6 2 3 1 4 6 6 6 2 
1435 5 6 5 5 3 4 6 4 6 3 1 3 1 2 5 6 6 6 2 3 6 2 2 2 2 2 3 6 6 4 6 6 2 3 1 4 6 6 6 5 
1430 5 6 5 5 3 4 6 4 6 3 1 3 1 2 5 6 6 6 2 3 6 2 2 2 2 2 3 6 6 4 6 6 2 3 1 4 6 5 4 4 5 1 
1420 5 6 5 5 3 4 6 4 6 3 1 3 1 2 5 6 6 6 2 3 6 2 2 2 2 2 3 6 6 4 6 6 2 3 1 4 6 6 4 2 1 
1415 5 6 5 5 3 4 6 4 6 3 1 3 1 2 5 6 6 6 2 3 6 2 2 2 2 2 3 6 6 4 6 6 2 3 1 4 6 6 6 3 1 
1415 5 6 5 5 3 4 6 4 6 3 1 3 1 2 5 6 6 6 2 3 6 2 2 2 2 2 3 6 6 4 6 6 2 3 1 4 6 6 6 3 1 
1415 5 6 5 5 3 4 6 4 6 3 1 3 1 2 5 6 6 6 2 3 6 2 2 2 2 2 3 6 6 4 6 6 2 3 1 4 6 6 3 6 1 
1415 5 6 5 5 3 4 6 4 6 3 1 3 1 2 5 6 6 6 2 3 6 2 2 2 2 2 3 6 6 4 6 6 2 3 1 4 6 6 6 3 1 
1410 5 6 5 5 3 4 6 4 6 3 1 3 1 2 5 6 6 6 2 3 6 2 2 2 2 2 3 6 6 4 6 6 2 3 1 4 6 6 6 4 
1410 5 6 5 5 3 4 6 4 6 3 1 3 1 2 5 6 6 6 2 3 6 2 2 2 2 2 3 6 6 4 6 6 2 3 1 4 6 6 6 1 
1410 5 6 5 5 3 4 6 4 6 3 1 3 1 2 5 6 6 6 2 3 6 2 2 2 2 2 3 6 6 4 6 6 2 3 1 4 6 6 6 4 
1410 5 6 5 5 3 4 6 4 6 3 1 3 1 2 5 6 6 6 2 3 6 2 2 2 2 2 3 6 6 4 6 6 2 3 1 4 6 6 6 1 
1410 5 6 5 5 3 4 6 4 6 3 1 3 1 2 5 6 6 6 2 3 6 2 2 2 2 2 3 6 6 4 6 6 2 3 1 4 6 6 4 6 
1410 5 6 5 5 3 4 6 4 6 3 1 3 1 2 5 6 6 6 2 3 6 2 2 2 2 2 3 6 6 4 6 6 2 3 1 4 6 6 6 1 
1410 5 6 5 5 3 4 6 4 6 3 1 3 1 2 5 6 6 6 2 3 6 2 2 2 2 2 3 6 6 4 6 6 2 3 1 4 6 6 6 1 
1410 5 6 5 5 3 4 6 4 6 3 1 3 1 2 5 6 6 6 2 3 6 2 2 2 2 2 3 6 6 4 6 6 2 3 1 4 6 6 6 4 
1410 5 6 5 5 3 4 6 4 6 3 1 3 1 2 5 6 6 6 2 3 6 2 2 2 2 2 3 6 6 4 6 6 2 3 1 4 6 6 6 4 
1410 5 6 5 5 3 4 6 4 6 3 1 3 1 2 5 6 6 6 2 3 6 2 2 2 2 2 3 6 6 4 6 6 2 3 1 4 6 6 6 1 
1410 5 6 5 5 3 4 6 4 6 3 1 3 1 2 5 6 6 6 2 3 6 2 2 2 2 2 3 6 6 4 6 6 2 3 1 4 6 6 4 6 
1410 5 6 5 5 3 4 6 4 6 3 1 3 1 2 5 6 6 6 2 3 6 2 2 2 2 2 3 6 6 4 6 6 2 3 1 4 6 6 6 1 
1410 5 6 5 5 3 4 6 4 6 3 1 3 1 2 5 6 6 6 2 3 6 2 2 2 2 2 3 6 6 4 6 6 2 3 1 4 6 6 4 6 
1410 5 6 5 5 3 4 6 4 6 3 1 3 1 2 5 6 6 6 2 3 6 2 2 2 2 2 3 6 6 4 6 6 2 3 1 4 6 6 6 4 
1410 5 6 5 5 3 4 6 4 6 3 1 3 1 2 5 6 6 6 2 3 6 2 2 2 2 2 3 6 6 4 6 6 2 3 1 4 6 6 6 1 
1410 5 6 5 5 3 4 6 4 6 3 1 3 1 2 5 6 6 6 2 3 6 2 2 2 2 2 3 6 6 4 6 6 2 3 1 4 6 6 6 1 
1410 5 6 5 5 3 4 6 4 6 3 1 3 1 2 5 6 6 6 2 3 6 2 2 2 2 2 3 6 6 4 6 6 2 3 1 4 6 6 6 1 
1410 5 6 5 5 3 4 6 4 6 3 1 3 1 2 5 6 6 6 2 3 6 2 2 2 2 2 3 6 6 4 6 6 2 3 1 4 6 6 6 4 
1410 5 6 5 5 3 4 6 4 6 3 1 3 1 2 5 6 6 6 2 3 6 2 2 2 2 2 3 6 6 4 6 6 2 3 1 4 6 6 6 4 
1410 5 6 5 5 3 4 6 4 6 3 1 3 1 2 5 6 6 6 2 3 6 2 2 2 2 2 3 6 6 4 6 6 2 3 1 4 6 6 6 4 
1410 5 6 5 5 3 4 6 4 6 3 1 3 1 2 5 6 6 6 2 3 6 2 2 2 2 2 3 6 6 4 6 6 2 3 1 4 6 6 6 1 
1410 5 6 5 5 3 4 6 4 6 3 1 3 1 2 5 6 6 6 2 3 6 2 2 2 2 2 3 6 6 4 6 6 2 3 1 4 6 6 6 1 
1410 5 6 5 5 3 4 6 4 6 3 1 3 1 2 5 6 6 6 2 3 6 2 2 2 2 2 3 6 6 4 6 6 2 3 1 4 6 6 6 4 
1410 5 6 5 5 3 4 6 4 6 3 1 3 1 2 5 6 6 6 2 3 6 2 2 2 2 2 3 6 6 4 6 6 2 3 1 4 6 6 6 4 
1410 5 6 5 5 3 4 6 4 6 3 1 3 1 2 5 6 6 6 2 3 6 2 2 2 2 2 3 6 6 4 6 6 2 3 1 4 6 6 6 4 
1410 5 6 5 5 3 4 6 4 6 3 1 3 1 2 5 6 6 6 2 3 6 2 2 2 2 2 3 6 6 4 6 6 2 3 1 4 6 6 4 6 
1410 5 6 5 5 3 4 6 4 6 3 1 3 1 2 5 6 6 6 2 3 6 2 2 2 2 2 3 6 6 4 6 6 2 3 1 4 6 6 6 1 
1410 5 6 5 5 3 4 6 4 6 3 1 3 1 2 5 6 6 6 2 3 6 2 2 2 2 2 3 6 6 4 6 6 2 3 1 4 6 6 6 4 
1400 5 6 5 5 3 4 6 4 6 3 1 3 1 2 5 6 6 6 2 3 6 2 2 2 2 2 3 6 6 4 6 6 2 3 1 4 6 6 4 3 2 
1395 5 6 5 5 3 4 6 4 6 3 1 3 1 2 5 6 6 6 2 3 6 2 2 2 2 2 3 6 6 4 6 6 2 3 1 4 6 6 6 3 3 
1395 5 6 5 5 3 4 6 4 6 3 1 3 1 2 5 6 6 6 2 3 6 2 2 2 2 2 3 6 6 4 6 6 2 3 1 4 6 6 6 3 3 
1390 5 6 5 5 3 4 6 4 6 3 1 3 1 2 5 6 6 6 2 3 6 2 2 2 2 2 3 6 6 4 6 6 2 3 1 4 6 5 1 3 6 
1380 5 6 5 5 3 4 6 4 6 3 1 3 1 2 5 6 6 6 2 3 6 2 2 2 2 2 3 6 6 4 6 6 2 3 1 4 6 5 4 5 
1380 5 6 5 5 3 4 6 4 6 3 1 3 1 2 5 6 6 6 2 3 6 2 2 2 2 2 3 6 6 4 6 5 1 4 1 4 6 6 5 
1375 5 6 5 5 3 4 6 4 6 3 1 3 1 2 5 6 6 6 2 3 6 2 2 2 2 2 3 6 6 4 6 6 2 3 1 4 6 6 4 3 1 
1370 5 6 5 5 3 4 6 4 6 3 1 3 1 2 5 6 6 6 2 3 6 2 2 2 2 2 3 6 6 4 6 6 2 3 1 4 6 6 2 
1370 5 6 5 5 3 4 6 4 6 3 1 3 1 2 5 6 6 6 2 3 6 2 2 2 2 2 3 6 6 4 6 6 2 3 1 4 6 6 5 
1370 5 6 5 5 3 4 6 4 6 3 1 3 1 2 5 6 6 6 2 3 6 2 2 2 2 2 3 6 6 4 6 6 2 4 6 6 5 
1370 5 6 5 5 3 4 6 4 6 3 1 3 1 2 5 6 6 6 2 3 6 2 2 2 2 2 3 6 6 4 6 6 2 3 1 4 6 6 2 
1370 5 6 5 5 3 4 6 4 6 3 1 3 1 2 5 6 6 6 2 3 6 2 2 2 2 2 3 6 6 4 6 6 2 3 1 4 6 6 5 
1370 5 6 5 5 3 4 6 4 6 3 1 3 1 2 5 6 6 6 2 3 6 2 2 2 2 2 3 6 6 4 6 6 2 3 1 4 6 6 2 
1370 5 6 5 5 3 4 6 4 6 3 1 3 1 2 5 6 6 6 2 3 6 2 2 2 2 2 3 6 6 4 6 6 2 3 1 4 6 6 2 
1370 5 6 5 5 3 4 6 4 6 3 1 3 1 2 5 6 6 6 2 3 6 2 2 2 2 2 3 6 6 4 6 6 2 3 1 4 6 6 4 1 
1370 5 6 5 5 3 4 6 4 6 3 1 3 1 2 5 6 6 6 2 3 6 2 2 2 2 2 3 6 6 4 6 6 2 3 1 4 6 6 4 1 
1370 5 6 5 5 3 4 6 4 6 3 1 3 1 2 5 6 6 6 2 3 6 2 2 2 2 2 3 6 6 4 6 6 2 3 1 4 6 6 5 
1370 5 6 5 5 3 4 6 4 6 3 1 3 1 2 5 6 6 6 2 3 6 2 2 2 2 2 3 6 6 4 6 6 2 3 1 4 6 6 2 
1370 5 6 5 5 3 4 6 4 6 3 1 3 1 2 5 6 6 6 2 3 6 2 2 2 2 2 3 6 6 4 6 6 2 3 1 4 6 6 5 
1370 5 6 5 5 3 4 6 4 6 3 1 3 1 2 5 6 6 6 2 3 6 2 2 2 2 2 3 6 6 4 6 6 2 3 1 4 6 6 4 1 
1370 5 6 5 5 3 4 6 4 6 3 1 3 1 2 5 6 6 6 2 3 6 2 2 2 2 2 3 6 6 4 6 6 2 3 1 4 6 6 5 
1365 5 6 5 5 3 4 6 4 6 3 1 3 1 2 5 6 6 6 2 3 6 2 2 2 2 2 3 6 6 4 6 6 2 3 1 4 6 5 3 3 5 
1360 5 6 5 5 3 4 6 4 6 3 1 3 1 2 5 6 6 6 2 3 6 2 2 2 2 2 3 6 6 4 6 6 2 3 1 4 6 5 3 3 5 6 
1360 5 6 5 5 3 4 6 4 6 3 1 3 1 2 5 6 6 6 2 3 6 2 2 2 2 2 3 6 6 4 6 6 2 3 1 4 6 5 3 3 5 2 
1355 5 6 5 5 3 4 6 4 6 3 1 3 1 2 5 6 6 6 2 3 6 2 2 2 2 2 3 6 6 4 6 6 2 3 1 4 6 5 3 2 2 5 2 1 
1355 5 6 5 5 3 4 6 4 6 3 1 3 1 2 5 6 6 6 2 3 6 2 2 2 2 2 3 6 6 4 6 6 2 3 1 4 6 6 3 4 3 
1355 5 6 5 5 3 4 6 4 6 3 1 3 1 2 5 6 6 6 2 3 6 2 2 2 2 2 3 6 6 4 6 6 5 6 5 5 4 
1345 5 6 5 5 3 4 6 4 6 3 1 3 1 2 5 6 6 6 2 3 6 2 2 2 2 2 3 6 6 4 6 6 2 3 1 4 6 6 1 
1345 5 6 5 5 3 4 6 4 6 3 1 3 1 2 5 6 6 6 2 3 6 2 2 2 2 2 3 6 6 4 6 6 2 3 1 4 6 6 1 
1345 5 6 5 5 3 4 6 4 6 3 1 3 1 2 5 6 6 6 2 3 6 2 2 2 2 2 3 6 6 4 6 6 2 3 1 4 6 6 1 
1345 5 6 5 5 3 4 6 4 6 3 1 3 1 2 5 6 6 6 2 3 6 2 2 2 2 2 3 6 6 4 6 6 2 3 1 4 6 6 1 
1335 5 6 5 5 3 4 6 4 6 3 1 3 1 2 5 6 6 6 2 3 6 2 2 2 2 2 3 6 6 4 6 6 2 3 1 4 6 5 4 3 
1335 5 6 5 5 3 4 6 4 6 3 1 3 1 2 5 6 6 6 2 3 6 2 2 2 2 2 3 6 6 4 6 6 2 3 1 4 6 5 4 3 
1320 5 6 5 5 3 4 6 4 6 3 1 3 1 2 5 6 6 6 2 3 6 2 2 2 2 2 3 6 6 4 6 6 4 3 4 6 5 3 4 3 
1315 5 6 5 5 3 4 6 4 6 3 1 3 1 2 5 6 6 6 2 3 6 2 2 2 2 2 3 6 6 4 6 6 2 3 1 4 6 3 5 3 3 1 6 
1310 5 6 5 5 3 4 6 4 6 3 1 3 1 2 5 6 6 6 2 3 6 2 2 2 2 2 3 6 6 4 6 6 2 3 1 4 6 3 2 
1305 5 6 5 5 3 4 6 4 6 3 1 3 1 2 5 6 6 6 2 3 6 2 2 2 2 2 3 6 6 4 6 6 2 3 1 4 6 2 
1305 5 6 5 5 3 4 6 4 6 3 1 3 1 2 5 6 6 6 2 3 6 2 2 2 2 2 3 6 6 4 6 6 2 3 1 4 6 2 
1305 5 6 5 5 3 4 6 4 6 3 1 3 1 2 5 6 6 6 2 3 6 2 2 2 2 2 3 6 6 4 6 6 2 3 1 4 6 2 
1305 5 6 5 5 3 4 6 4 6 3 1 3 1 2 5 6 6 6 2 3 6 2 2 2 2 2 3 6 6 4 6 6 2 3 1 4 6 2 
1305 5 6 5 5 3 4 6 4 6 3 1 3 1 2 5 6 6 6 2 3 6 2 2 2 2 2 3 6 6 4 6 6 2 3 1 4 6 2 
1305 5 6 5 5 3 4 6 4 6 3 1 3 1 2 5 6 6 6 2 3 6 2 2 2 2 2 3 6 6 4 6 6 1 3 4 6 3 6 
1305 5 6 5 5 3 4 6 4 6 3 1 3 1 2 5 6 6 6 2 3 6 2 2 2 2 2 3 6 6 4 6 6 2 3 1 4 6 2 
1300 5 6 5 5 3 4 6 4 6 3 1 3 1 2 5 6 6 6 2 3 6 2 2 2 2 2 3 6 6 4 6 6 3 3 3 2 3 3 4 6 3 4 
1290 5 6 5 5 3 4 6 4 6 3 1 3 1 2 5 6 6 6 2 3 6 2 2 2 2 2 3 6 6 4 6 6 2 3 1 4 6 3 3 1 
1285 5 6 5 5 3 4 6 4 6 3 1 3 1 2 5 6 6 6 2 3 6 2 2 2 2 2 3 6 6 4 6 6 2 4 6 3 4 
1285 5 6 5 5 3 4 6 4 6 3 1 3 1 2 5 6 6 6 2 3 6 2 2 2 2 2 3 6 6 4 6 6 2 3 1 4 6 3 4 
1285 5 6 5 5 3 4 6 4 6 3 1 3 1 2 5 6 6 6 2 3 6 2 2 2 2 2 3 6 6 4 6 6 2 3 1 4 6 3 1 
1285 5 6 5 5 3 4 6 4 6 3 1 3 1 2 5 6 6 6 2 3 6 2 2 2 2 2 3 6 6 4 6 6 2 3 1 4 6 3 1 
1280 5 6 5 5 3 4 6 4 6 3 1 3 1 2 5 6 6 6 2 3 6 2 2 2 2 2 3 6 6 4 6 6 2 3 1 4 6 1 
1280 5 6 5 5 3 4 6 4 6 3 1 3 1 2 5 6 6 6 2 3 6 2 2 2 2 2 3 6 6 4 6 6 2 3 1 4 6 1 
1280 5 6 5 5 3 4 6 4 6 3 1 3 1 2 5 6 6 6 2 3 6 2 2 2 2 2 3 6 6 4 6 6 2 3 1 4 6 1 
1280 5 6 5 5 3 4 6 4 6 3 1 3 1 2 5 6 6 6 2 3 6 2 2 2 2 2 3 6 6 4 6 6 2 3 1 4 6 4 
1280 5 6 5 5 3 4 6 4 6 3 1 3 1 2 5 6 6 6 2 3 6 2 2 2 2 2 3 6 6 4 6 6 2 3 1 4 6 1 
1280 5 6 5 5 3 4 6 4 6 3 1 3 1 2 5 6 6 6 2 3 6 2 2 2 2 2 3 6 6 4 6 6 2 3 1 4 6 4 
1280 5 6 5 5 3 4 6 4 6 3 1 3 1 2 5 6 6 6 2 3 6 2 2 2 2 2 3 6 6 4 6 6 2 3 1 4 6 1 
1280 5 6 5 5 3 4 6 4 6 3 1 3 1 2 5 6 6 6 2 3 6 2 2 2 2 2 3 6 6 4 6 6 2 3 1 4 6 4 
1280 5 6 5 5 3 4 6 4 6 3 1 3 1 2 5 6 6 6 2 3 6 2 2 2 2 2 3 6 6 4 6 6 2 3 1 4 6 1 
1280 5 6 5 5 3 4 6 4 6 3 1 3 1 2 5 6 6 6 2 3 6 2 2 2 2 2 3 6 6 4 6 6 2 3 1 4 6 4 
1280 5 6 5 5 3 4 6 4 6 3 1 3 1 2 5 6 6 6 2 3 6 2 2 2 2 2 3 6 6 4 6 6 2 3 1 4 6 4 
1280 5 6 5 5 3 4 6 4 6 3 1 3 1 2 5 6 6 6 2 3 6 2 2 2 2 2 3 6 6 4 6 6 2 3 1 4 6 1 
1275 5 6 5 5 3 4 6 4 6 3 1 3 1 2 5 6 6 6 2 3 6 2 2 2 2 2 3 6 6 4 6 6 2 4 6 1 5 2 
1245 5 6 5 5 3 4 6 4 6 3 1 3 1 2 5 6 6 6 2 3 6 2 2 2 2 2 3 6 6 4 6 6 2 3 1 4 3 2 
1240 5 6 5 5 3 4 6 4 6 3 1 3 1 2 5 6 6 6 2 3 6 2 2 2 2 2 3 6 6 4 6 6 2 3 1 4 2 
1240 5 6 5 5 3 4 6 4 6 3 1 3 1 2 5 6 6 6 2 3 6 2 2 2 2 2 3 6 6 4 6 6 4 2 3 3 4 4 
1240 5 6 5 5 3 4 6 4 6 3 1 3 1 2 5 6 6 6 2 3 6 2 2 2 2 2 3 6 6 4 6 6 2 3 1 4 5 
1240 5 6 5 5 3 4 6 4 6 3 1 3 1 2 5 6 6 6 2 3 6 2 2 2 2 2 3 6 6 4 6 6 2 3 1 4 2 
1240 5 6 5 5 3 4 6 4 6 3 1 3 1 2 5 6 6 6 2 3 6 2 2 2 2 2 3 6 6 4 6 6 2 3 1 4 2 
1240 5 6 5 5 3 4 6 4 6 3 1 3 1 2 5 6 6 6 2 3 6 2 2 2 2 2 3 6 6 4 6 5 4 1 1 3 1 3 4 3 4 3 3 
1240 5 6 5 5 3 4 6 4 6 3 1 3 1 2 5 6 6 6 2 3 6 2 2 2 2 2 3 6 6 4 6 6 2 3 1 4 2 
1240 5 6 5 5 3 4 6 4 6 3 1 3 1 2 5 6 6 6 2 3 6 2 2 2 2 2 3 6 6 4 6 6 2 3 1 4 5 
1240 5 6 5 5 3 4 6 4 6 3 1 3 1 2 5 6 6 6 2 3 6 2 2 2 2 2 3 6 6 4 6 6 2 3 1 4 5 
1230 5 6 5 5 3 4 6 4 6 3 1 3 1 2 5 6 6 6 2 3 6 2 2 2 2 2 3 6 6 4 6 6 2 3 1 6 
1230 5 6 5 5 3 4 6 4 6 3 1 3 1 2 5 6 6 6 2 3 6 2 2 2 2 2 3 6 6 4 6 5 6 6 
1220 5 6 5 5 3 4 6 4 6 3 1 3 1 2 5 6 6 6 2 3 6 2 2 2 2 2 3 6 6 4 6 6 2 3 1 4 3 1 
1215 5 6 5 5 3 4 6 4 6 3 1 3 1 2 5 6 6 6 2 3 6 2 2 2 2 2 3 6 6 4 6 6 2 3 1 4 1 
1215 5 6 5 5 3 4 6 4 6 3 1 3 1 2 5 6 6 6 2 3 6 2 2 2 2 2 3 6 6 4 6 6 2 3 1 5 
1215 5 6 5 5 3 4 6 4 6 3 1 3 1 2 5 6 6 6 2 3 6 2 2 2 2 2 3 6 6 4 6 6 2 3 1 4 4 
1215 5 6 5 5 3 4 6 4 6 3 1 3 1 2 5 6 6 6 2 3 6 2 2 2 2 2 3 6 6 4 6 6 2 3 1 4 4 
1210 5 6 5 5 3 4 6 4 6 3 1 3 1 2 5 6 6 6 2 3 6 2 2 2 2 2 3 6 6 4 6 6 2 3 1 2 5 
1190 5 6 5 5 3 4 6 4 6 3 1 3 1 2 5 6 6 6 2 3 6 2 2 2 2 2 3 6 6 4 6 6 5 1 
