185 6 5 5 3 4 5 5 6 2 6 
145 6 5 5 6 4 5 3 2 6 1 
115 6 5 5 5 5 5 2 2 
95 6 5 5 5 3 4 5 2 2 
90 6 5 5 5 5 5 5 1 
80 6 5 5 5 5 6 2 
75 6 5 5 5 3 5 3 5 2 
70 6 5 5 5 5 4 3 5 1 
30 6 5 5 5 3 3 5 5 3 2 
25 6 5 5 5 5 4 3 1 3 2 
20 6 5 5 5 6 5 2 2 
15 6 5 5 5 5 2 
10 6 5 5 5 5 2 2 
5 6 5 5 5 6 1 
0 6 5 5 5 3 4 5 3 
-5 6 5 5 5 4 3 2 
-5 6 5 5 6 6 5 4 2 
-10 6 5 5 5 4 2 
-10 6 5 5 5 5 1 
-30 6 5 5 3 5 1 5 3 6 1 
-35 6 5 5 5 5 3 2 4 
-35 6 5 5 5 5 3 4 3 
-35 6 5 5 5 5 3 4 
-35 6 5 5 5 5 3 4 
-35 6 5 5 5 5 3 3 5 
-35 6 5 5 5 5 3 4 4 
-35 6 5 5 5 5 3 3 
-40 6 5 5 5 2 5 
-40 6 5 5 5 2 1 
-75 6 5 5 5 3 3 
-80 6 5 5 5 6 4 5 
-80 6 5 5 3 1 6 
-80 6 5 6 2 3 2 
-90 6 5 5 5 5 3 2 5 1 4 
-95 6 5 5 5 2 5 3 3 
-95 6 5 4 2 5 1 1 
-95 6 5 2 2 5 3 3 
-95 6 5 5 3 5 4 2 
-95 6 5 5 5 5 2 1 6 
-95 6 5 5 5 2 5 
-105 6 5 5 6 1 1 
-105 6 5 5 6 3 2 
-105 6 5 5 3 1 4 6 3 
-120 6 5 6 
-120 6 5 5 3 3 5 4 2 
-120 6 5 5 5 5 4 2 3 
-120 6 5 5 2 2 4 2 
-125 6 1 2 
-125 6 5 5 3 3 6 3 
-125 6 5 5 2 6 3 2 3 
-125 6 5 5 4 3 3 1 4 
-130 6 6 5 3 2 
-140 6 5 3 2 1 5 
-140 6 5 5 5 2 1 2 
-145 6 5 2 1 1 4 6 
-165 6 5 5 4 3 6 4 
-170 5 4 3 2 
-185 6 2 
-210 1 1 6 5 
-445 6 5 5 5 5 5 
-445 6 5 5 3 1 
-465 6 5 5 5 4 
-490 6 5 5 3 4 5 2 
-550 6 6 
