645 5 6 5 5 5 5 4 3 2 1 6 1 4 2 5 5 6 3 6 2 1 5 
640 5 6 5 5 5 5 4 3 2 1 6 1 4 2 5 5 6 5 4 2 6 
630 5 6 5 5 5 5 4 3 2 1 6 1 4 2 5 5 6 5 6 6 
630 5 6 5 5 5 5 4 3 2 1 6 1 4 2 5 5 6 5 6 6 
630 5 6 5 5 5 5 4 3 2 1 6 1 4 2 5 5 6 5 6 6 
630 5 6 5 5 5 5 4 3 2 1 6 1 4 2 5 5 6 5 6 6 
630 5 6 5 5 5 5 4 3 2 1 6 1 4 2 5 5 6 5 6 6 
625 5 6 5 5 5 5 4 3 2 1 6 1 4 2 5 5 6 5 4 1 1 2 6 
615 5 6 5 5 5 5 4 3 2 1 6 1 4 2 5 5 6 5 6 5 
615 5 6 5 5 5 5 4 3 2 1 6 1 4 2 5 5 6 5 6 2 
615 5 6 5 5 5 5 4 3 2 1 6 1 4 2 5 5 6 5 6 2 
615 5 6 5 5 5 5 4 3 2 1 6 1 4 2 5 5 6 5 6 5 
615 5 6 5 5 5 5 4 3 2 1 6 1 4 2 5 5 6 5 6 2 
615 5 6 5 5 5 5 4 3 2 1 6 1 4 2 5 5 6 5 6 2 
615 5 6 5 5 5 5 4 3 2 1 6 1 4 2 5 5 6 5 6 2 
615 5 6 5 5 5 5 4 3 2 1 6 1 4 2 5 5 6 5 6 2 
615 5 6 5 5 5 5 4 3 2 1 6 1 4 2 5 5 6 5 6 2 
615 5 6 5 5 5 5 4 3 2 1 6 1 4 2 5 5 6 5 6 2 
615 5 6 5 5 5 5 4 3 2 1 6 1 4 2 5 5 6 5 6 5 
600 5 6 5 5 5 5 4 3 2 1 6 1 4 2 5 5 6 4 5 1 5 
600 5 6 5 5 5 5 4 3 2 1 6 1 4 2 5 5 6 5 4 1 5 
590 5 6 5 5 5 5 4 3 2 1 6 1 4 2 5 5 6 5 4 6 
590 5 6 5 5 5 5 4 3 2 1 6 1 4 2 5 5 6 5 4 6 
590 5 6 5 5 5 5 4 3 2 1 6 1 4 2 5 5 6 5 6 4 
590 5 6 5 5 5 5 4 3 2 1 6 1 4 2 5 5 6 5 6 1 
590 5 6 5 5 5 5 4 3 2 1 6 1 4 2 5 5 6 5 6 4 
590 5 6 5 5 5 5 4 3 2 1 6 1 4 2 5 5 6 5 4 6 
590 5 6 5 5 5 5 4 3 2 1 6 1 4 2 5 5 6 5 6 4 
590 5 6 5 5 5 5 4 3 2 1 6 1 4 2 5 5 6 5 6 4 
590 5 6 5 5 5 5 4 3 2 1 6 1 4 2 5 5 6 5 6 4 
590 5 6 5 5 5 5 4 3 2 1 6 1 4 2 5 5 6 5 4 6 
590 5 6 5 5 5 5 4 3 2 1 6 1 4 2 5 5 6 5 6 4 
590 5 6 5 5 5 5 4 3 2 1 6 1 4 2 5 5 6 5 6 4 
590 5 6 5 5 5 5 4 3 2 1 6 1 4 2 5 5 6 5 4 6 
590 5 6 5 5 5 5 4 3 2 1 6 1 4 2 5 5 6 5 6 4 
590 5 6 5 5 5 5 4 3 2 1 6 1 4 2 5 5 6 5 6 1 
590 5 6 5 5 5 5 4 3 2 1 6 1 4 2 5 5 6 5 6 1 
590 5 6 5 5 5 5 4 3 2 1 6 1 4 2 5 5 6 5 6 1 
590 5 6 5 5 5 5 4 3 2 1 6 1 4 2 5 5 6 5 6 1 
590 5 6 5 5 5 5 4 3 2 1 6 1 4 2 5 5 6 5 6 1 
590 5 6 5 5 5 5 4 3 2 1 6 1 4 2 5 5 6 5 6 1 
590 5 6 5 5 5 5 4 3 2 1 6 1 4 2 5 5 6 5 4 6 
590 5 6 5 5 5 5 4 3 2 1 6 1 4 2 5 5 6 5 6 1 
575 5 6 5 5 5 5 4 3 2 1 6 1 4 2 5 5 6 5 4 5 
575 5 6 5 5 5 5 4 3 2 1 6 1 4 2 5 5 6 5 4 5 
575 5 6 5 5 5 5 4 3 2 1 6 1 4 2 5 5 6 5 4 5 
570 5 6 5 5 5 5 4 3 2 1 6 1 4 2 5 5 6 3 6 1 4 
570 5 6 5 5 5 5 4 3 2 1 6 1 4 2 5 5 6 5 6 3 
570 5 6 5 5 5 5 4 3 2 1 6 1 4 2 5 5 6 5 6 3 
570 5 6 5 5 5 5 4 3 2 1 6 1 4 2 5 5 6 5 6 3 
570 5 6 5 5 5 5 4 3 2 1 6 1 4 2 5 5 6 5 6 3 
550 5 6 5 5 5 5 4 3 2 1 6 1 4 2 5 5 6 5 4 4 
550 5 6 5 5 5 5 4 3 2 1 6 1 4 2 5 5 6 5 5 
550 5 6 5 5 5 5 4 3 2 1 6 1 4 2 5 5 6 5 5 
550 5 6 5 5 5 5 4 3 2 1 6 1 4 2 5 5 6 5 2 
550 5 6 5 5 5 5 4 3 2 1 6 1 4 2 5 5 6 5 5 
550 5 6 5 5 5 5 4 3 2 1 6 1 4 2 5 5 6 5 2 
550 5 6 5 5 5 5 4 3 2 1 6 1 4 2 5 5 6 5 5 
550 5 6 5 5 5 5 4 3 2 1 6 1 4 2 5 5 6 5 5 
550 5 6 5 5 5 5 4 3 2 1 6 1 4 2 5 5 6 5 2 
550 5 6 5 5 5 5 4 3 2 1 6 1 4 2 5 5 6 5 2 
550 5 6 5 5 5 5 4 3 2 1 6 1 4 2 5 5 6 5 5 
550 5 6 5 5 5 5 4 3 2 1 6 1 4 2 5 5 6 5 2 
550 5 6 5 5 5 5 4 3 2 1 6 1 4 2 5 5 6 5 5 
550 5 6 5 5 5 5 4 3 2 1 6 1 4 2 5 5 6 5 2 
550 5 6 5 5 5 5 4 3 2 1 6 1 4 2 5 5 6 5 4 4 
550 5 6 5 5 5 5 4 3 2 1 6 1 4 2 5 5 6 5 5 
550 5 6 5 5 5 5 4 3 2 1 6 1 4 2 5 5 6 5 5 
550 5 6 5 5 5 5 4 3 2 1 6 1 4 2 5 5 6 5 2 
550 5 6 5 5 5 5 4 3 2 1 6 1 4 2 5 5 6 5 2 
550 5 6 5 5 5 5 4 3 2 1 6 1 4 2 5 5 5 6 5 
550 5 6 5 5 5 5 4 3 2 1 6 1 4 2 5 5 6 5 5 
550 5 6 5 5 5 5 4 3 2 1 6 1 4 2 5 5 6 5 2 
545 5 6 5 5 5 5 4 3 2 1 6 1 4 2 5 5 6 3 6 4 
540 5 6 5 5 5 5 4 3 2 1 6 1 4 2 5 5 6 3 3 3 4 5 
540 5 6 5 5 5 5 4 3 2 1 6 1 4 2 5 5 6 4 6 
535 5 6 5 5 5 5 4 3 2 1 6 1 4 2 5 5 6 5 4 3 3 
535 5 6 5 5 5 5 4 3 2 1 6 1 4 2 5 4 6 5 5 3 3 
530 5 6 5 5 5 5 4 3 2 1 6 1 4 2 5 5 6 4 3 5 
530 5 6 5 5 5 5 4 3 2 1 6 1 4 2 5 5 6 4 3 2 
530 5 6 5 5 5 5 4 3 2 1 6 1 4 2 5 5 6 3 4 2 
525 5 6 5 5 5 5 4 3 2 1 6 1 4 2 5 5 6 4 4 1 
525 5 6 5 5 5 5 4 3 2 1 6 1 4 2 5 5 6 5 1 
525 5 6 5 5 5 5 4 3 2 1 6 1 4 2 5 5 6 5 1 
525 5 6 5 5 5 5 4 3 2 1 6 1 4 2 5 5 6 5 1 
525 5 6 5 5 5 5 4 3 2 1 6 1 4 2 5 5 6 4 2 
515 5 6 5 5 5 5 4 3 2 1 6 1 4 2 5 5 6 6 
515 5 6 5 5 5 5 4 3 2 1 6 1 4 2 5 5 6 6 
515 5 6 5 5 5 5 4 3 2 1 6 1 4 2 5 5 6 6 
515 5 6 5 5 5 5 4 3 2 1 6 1 4 2 5 5 6 6 
515 5 6 5 5 5 5 4 3 2 1 6 1 4 2 5 5 6 6 
515 5 6 5 5 5 5 4 3 2 1 6 1 4 2 5 5 6 6 
515 5 6 5 5 5 5 4 3 2 1 6 1 4 2 5 5 6 6 
515 5 6 5 5 5 5 4 3 2 1 6 1 4 2 5 5 6 6 
505 5 6 5 5 5 5 4 3 2 1 6 1 4 2 5 5 6 5 3 
505 5 6 5 5 5 5 4 3 2 1 6 1 4 2 5 5 6 5 3 
505 5 6 5 5 5 5 4 3 2 1 6 1 4 2 5 5 6 3 5 
505 5 6 5 5 5 5 4 3 2 1 6 1 4 2 5 5 6 5 3 
505 5 6 5 5 5 5 4 3 2 1 6 1 4 2 5 5 6 4 3 1 
505 5 6 5 5 5 5 4 3 2 1 6 1 4 2 5 5 6 4 4 3 
505 5 6 5 5 5 5 4 3 2 1 6 1 4 2 5 5 6 5 3 
505 5 6 5 5 5 5 4 3 2 1 6 1 4 2 5 5 6 5 3 
505 5 6 5 5 5 5 4 3 2 1 6 1 4 2 5 5 6 3 5 
505 5 6 5 5 5 5 4 3 2 1 6 1 4 2 5 5 6 5 3 
505 5 6 5 5 5 5 4 3 2 1 6 1 4 2 5 5 6 5 3 
505 5 6 5 5 5 5 4 3 2 1 6 1 4 2 5 5 6 4 3 4 
505 5 6 5 5 5 5 4 3 2 1 6 1 4 2 5 5 6 3 1 1 
505 5 6 5 5 5 5 4 3 2 1 6 1 4 2 5 5 6 3 1 4 
505 5 6 5 5 5 5 4 3 2 1 6 1 4 2 5 5 6 5 3 
500 5 6 5 5 5 5 4 3 2 1 6 1 4 2 5 5 6 2 
500 5 6 5 5 5 5 4 3 2 1 6 1 4 2 5 5 6 2 
500 5 6 5 5 5 5 4 3 2 1 6 1 4 2 5 5 6 2 
500 5 6 5 5 5 5 4 3 2 1 6 1 4 2 5 5 6 2 
500 5 6 5 5 5 5 4 3 2 1 6 1 4 2 5 5 6 2 
500 5 6 5 5 5 5 4 3 2 1 6 1 4 2 5 5 6 2 
485 5 6 5 5 5 5 4 3 2 1 6 1 4 2 5 5 5 2 
485 5 6 5 5 5 5 4 3 2 1 6 1 4 2 5 5 5 2 
475 5 6 5 5 5 5 4 3 2 1 6 1 4 2 5 5 6 1 
475 5 6 5 5 5 5 4 3 2 1 6 1 4 2 5 5 6 1 
475 5 6 5 5 5 5 4 3 2 1 6 1 4 2 5 5 6 1 
475 5 6 5 5 5 5 4 3 2 1 6 1 4 2 5 5 6 1 
475 5 6 5 5 5 5 4 3 2 1 6 1 4 2 5 5 6 1 
475 5 6 5 5 5 5 4 3 2 1 6 1 4 2 5 5 6 1 
475 5 6 5 5 5 5 4 3 2 1 6 1 4 2 5 5 6 1 
475 5 6 5 5 5 5 4 3 2 1 6 1 4 2 5 5 6 1 
455 5 6 5 5 5 5 4 3 2 1 6 1 4 2 5 3 6 2 
435 5 6 5 5 5 5 4 3 2 1 6 1 4 2 5 5 2 
410 5 6 5 5 5 5 4 3 2 1 6 1 4 2 5 5 1 
